target_id,rank,funny,somewhat_funny,unfunny,count,score,precision,contest,caption
5504,1,63,53,116,232,1.771551724137931,0.055804354800416955,651,No need to panic: a reptile dysfunction is common for men of your age.
1032,2,70,48,127,245,1.7673469387755103,0.055439901952546146,651,I usually don't say this to men.....How far apart are the contractions?
483,3,58,60,117,235,1.748936170212766,0.05397244487035719,651,You have a reptile dysfunction.
8191,4,60,74,133,267,1.7265917602996255,0.04936035883280646,651,I’m afraid you have a reptile dysfunction.
3975,5,62,60,133,255,1.7215686274509805,0.05201384783561941,651,What we have here is a reptile dysfuntion.
6308,6,63,59,149,271,1.6826568265682658,0.050243154431612945,651,"Oh, a REPTILE dysfunction..."
2399,7,50,61,125,236,1.6822033898305084,0.05220787982807721,651,Reptile Disfunction is very common in men your age.
3539,8,63,41,142,246,1.6788617886178863,0.05459324853689085,651,I'm afraid it's a reptile dysfunction.
2092,9,44,53,112,209,1.674641148325359,0.05549398360020607,651,How long between contractions?
8528,10,57,63,147,267,1.6629213483146068,0.04944895318833087,651,Looks like a reptile dysfunction
4851,11,54,59,139,252,1.6626984126984128,0.05097068351508934,651,I’m afraid you’ve got reptile dysfunction.
7672,12,54,49,134,237,1.6624472573839661,0.05365090751835129,651,Not to worry. Reptile dysfunction is highly treatable.
5810,13,44,69,126,239,1.6569037656903767,0.04994038652671884,651,Okay. Now YOU stick out your tongue.
2086,14,50,62,135,247,1.6558704453441295,0.050628677879585346,651,"Unfortunately, your insurance doesn't cover reptile dysfunction."
8001,15,56,61,147,264,1.6553030303030303,0.049718729516341105,651,Reptile Dysfunction is common in men your age.
3261,16,42,54,115,211,1.6540284360189574,0.05452738526912515,651,"Relax, it's common for men of your age to have reptile dysfunction."
6176,17,52,78,152,282,1.6453900709219857,0.04611821625098228,651,Give the snake two viagra and it will straighten out in about fifteen minutes.
1129,18,60,55,159,274,1.6386861313868613,0.0494927515816482,651,Your wife was right. You have a reptile dysfunction.
7981,19,53,53,143,249,1.6385542168674698,0.05145094517115237,651,Oh! You're here to get treated for REPTILE dysfunction.
2480,20,53,62,149,264,1.6363636363636365,0.04905650153586725,651,I'll write you something for reptile dysfunction.
3651,21,49,45,131,225,1.6355555555555557,0.05457548208811272,651,I understand you have concerns about a reptile dysfunction.
262,22,45,56,131,232,1.6293103448275863,0.05185769193669755,651,Reptile dysfunction.
6195,23,47,57,136,240,1.6291666666666667,0.05113697410752822,651,How far apart are the contractions ?
8619,23,49,53,138,240,1.6291666666666667,0.05181433322785802,651,Just as I thought..you are suffering from a reptile dysfunction.
1954,25,45,66,138,249,1.6265060240963856,0.048999753496740676,651,"No, a heart attack feels more like an elephant sitting on your chest."
8738,26,51,49,143,243,1.6213991769547325,0.052025713852651374,651,It could be reptile dysfunction
1978,27,46,70,145,261,1.6206896551724137,0.04755257934403132,651,"Nice try, but I'm still going to check your prostate."
1362,28,44,55,132,231,1.619047619047619,0.05178467312915439,651,It’s a cute reptile dysfunction.  What did you think I said?
1623,29,57,59,164,280,1.6178571428571429,0.04801629618158692,651,You have symptoms of a reptile dysfunction.
4012,30,58,31,149,238,1.6176470588235294,0.05525369672927316,651,It appears that you're suffering from a reptile disfunction.
8972,31,42,80,144,266,1.6165413533834587,0.04564868249708702,651,I'm afraid there's nothing we can do.  It's endangered.
2668,32,39,57,123,219,1.6164383561643836,0.052138070612811456,651,You have an overactive adder.
7197,33,53,49,152,254,1.610236220472441,0.05088819063411777,651,It's just a reptile dysfunction.
6964,34,46,51,138,235,1.6085106382978724,0.051875706279954255,651,"""It's just reptile dysfunction. Nothing to be embarrassed about."""
200,35,39,59,128,226,1.6061946902654867,0.05094028884105386,651,Don’t tell me. You ordered from the wrong Amazon.
3907,36,45,53,138,236,1.6059322033898304,0.05136992664760461,651,The good news is we can safely remove the snake. The bad news is those aren't your legs.
4783,37,40,69,137,246,1.6056910569105691,0.0479809763544375,651,Release ten mice in your living room and call me in the morning.
8248,38,39,60,129,228,1.605263157894737,0.05059230369060225,651,Says here you’re covered by COBRA?
3191,39,48,54,146,248,1.6048387096774193,0.05034720015400115,651,I’ll give you something for a reptile dysfunction.
2617,40,39,59,129,227,1.60352422907489,0.050785644825454564,651,Worst case of Reptile Dysfunction I've come across.
9007,40,45,47,135,227,1.60352422907489,0.053038577749903566,651,You have a classic case of reptile dysfunction.
2525,42,39,70,137,246,1.6016260162601625,0.047670010405327874,651,How often are the contractions?
1865,43,41,76,146,263,1.6007604562737643,0.04588545324442146,651,It’s going around.
5450,44,45,67,150,262,1.599236641221374,0.04728909781045865,651,How frequent are the contractions?
3267,45,48,49,146,243,1.5967078189300412,0.05125327347549569,651,And how far apart are the contractions?
2982,46,39,65,136,240,1.5958333333333334,0.048656251870834485,651,Here’s a prescription for your reptile disfunction.
7900,47,37,71,136,244,1.5942622950819672,0.04733182523464618,651,Looks as if you may have picked up a little something during your trip to Florida.
3680,48,43,66,147,256,1.59375,0.04757443857663854,651,My bad. I meant to prescribe a vasoconstrictor.
5417,49,47,53,148,248,1.592741935483871,0.0501185312228129,651,"Luckily, you're covered by Cobra."
3499,50,36,68,133,237,1.590717299578059,0.04808043401654197,651,"Next time, try ordering from Amazon, not from THE Amazon."
4999,51,47,56,151,254,1.5905511811023623,0.04917819593648171,651,Nice try. I still have to do the prostate exam.”
7068,52,42,50,135,227,1.5903083700440528,0.052033364515923844,651,Come back when contractions are two minutes apart.
819,53,40,77,149,266,1.5902255639097744,0.045250298750870825,651,Last week it was a frog in your throat.
605,54,46,57,150,253,1.5889328063241106,0.049027337676702414,651,I’m writing you a prescription for reptile dysfunction.
5389,55,42,52,137,231,1.5887445887445888,0.05132000040686391,651,It's clearly Ereptile Disfunction.
1427,56,39,59,135,233,1.5879828326180256,0.04987151464195365,651,"Well, I’d say it’s quite likely you have irritable boa syndrome."
7267,57,44,63,150,257,1.5875486381322956,0.04779299795582672,651,It appears to be Reptile Dysfunction.
6065,58,50,55,159,264,1.5871212121212122,0.048600089705060835,651,I can see here that you’re covered by COBRA.
5236,59,39,53,132,224,1.5848214285714286,0.05148118255065048,651,I see that you're covered by COBRA.
8333,60,51,44,155,250,1.584,0.05112957003268175,651,"I believe that you suffer from a reptile dysfunction, Mr. Collins."
3226,61,45,64,156,265,1.5811320754716982,0.046994528527390285,651,"And now, how far apart are the contractions?"
8597,62,44,59,150,253,1.5810276679841897,0.04843833438513564,651,"You have a reptile dysfunction. Luckily, your COBRA covers it."
8376,63,40,60,141,241,1.5809128630705394,0.048964413780937535,651,Looks like irritable boa syndrome.
2141,64,41,48,135,224,1.5803571428571428,0.05228475663629778,651,"Your insurance only pays if the snake bites, so let’s give it ten more minutes."
5849,65,45,60,155,260,1.5769230769230769,0.04773788982621635,651,"So how far apart are the contractions, would you say?"
478,66,49,45,154,248,1.5766129032258065,0.050874607833318,651,I see here that you're covered by COBRA
6750,67,39,62,142,243,1.5761316872427984,0.04832703760966784,651,"The good news is they sometimes go months without eating."""
8453,68,40,68,149,257,1.575875486381323,0.0465835504957811,651,Which one of you is having difficulty swallowing?
4435,69,42,62,150,254,1.5748031496062993,0.04767781986231461,651,"So, it started with a frog in your throat ..."
7269,70,44,62,155,261,1.5747126436781609,0.04729542065295842,651,This is a classic case of a reptile disfunction.
1909,71,45,54,152,251,1.5737051792828685,0.049117544059070095,651,It was supposed to be a vasoconstrictor.  Sometimes they have problems with the handwriting.
5222,72,42,49,141,232,1.5732758620689655,0.05124846586470769,651,"Actually, I'd prefer that your lawyer wait outside."
2566,73,40,57,142,239,1.5732217573221758,0.04933876242718755,651,I see you have a pre-existing constriction...
6234,74,44,60,155,259,1.5714285714285714,0.04760408013553501,651,"You can go home for now, but come back when the contractions are less than a minute apart."
7598,75,50,50,163,263,1.570342205323194,0.04885248519045849,651,You have irritable Boa syndrome.
8484,76,41,73,158,272,1.5698529411764706,0.0449103721960834,651,The good news is you’re covered by COBRA.
9013,77,33,67,134,234,1.5683760683760684,0.04757537481667661,651,Sorry about your cat.
359,78,49,44,157,250,1.568,0.05059390251687995,651,I am going to write you a prescription for reptile dysfunction.
8294,79,38,44,130,212,1.5660377358490567,0.05350862903709735,651,"Unfortunately, this is not covered by your COBRA insurance."
509,80,40,62,149,251,1.5657370517928286,0.047514365811749205,651,Come back when constrictions are 2 to 3 minutes apart.
3067,80,32,78,141,251,1.5657370517928286,0.044750808694496755,651,The good news is that the hissing you’ve been hearing isn’t tinnitus.
816,82,44,55,154,253,1.565217391304348,0.04853295308377243,651,"Until you get swallowed, it's considered a pre-existing condition."
3503,83,33,84,149,266,1.5639097744360901,0.04317738058610099,651,You need to unwind.
2237,84,43,49,148,240,1.5625,0.05028900090748832,651,"Don't let this rattle you, but what you are experiencing is a reptile dysfunction."""
1695,85,44,57,157,258,1.562015503875969,0.047801443598540334,651,The X-rays are back and the good news is we've found your kids
9201,85,44,57,157,258,1.562015503875969,0.047801443598540334,651,Endangered species. My hands are tied.
3506,87,42,48,145,235,1.5617021276595744,0.05079032042989542,651,I see you're still covered by COBRA.
5457,88,40,57,147,244,1.5614754098360655,0.04860564525649699,651,Looks like a case of reptile dysfunction
7527,89,44,47,150,241,1.5601659751037344,0.05047793592483356,651,"I'm sorry, Mr. Jones.  It looks like you have a case of reptile dysfunction."
5995,90,43,63,160,266,1.5601503759398496,0.0463656591752823,651,"Nothing for you but, I'm prescribing a muscle relaxer for your friend."
4342,91,39,51,141,231,1.5584415584415585,0.05040043658839801,651,I’m afraid your insurance doesn’t cover reptile dysfunction!
8506,92,38,63,148,249,1.5582329317269077,0.04717117974328701,651,It's a classic case of ereptile dysfunction
1346,93,45,61,165,271,1.5571955719557196,0.046301427367081704,651,"Luckily, you're covered under COBRA."
7128,94,42,64,160,266,1.556390977443609,0.04607661918231763,651,"Sorry , you're not covered for prexisting constrictions."
5844,95,37,58,143,238,1.5546218487394958,0.04851989993190008,651,I’ll need you to hiss in this cup.
1848,96,36,56,139,231,1.5541125541125542,0.04928886209734396,651,"Hmm, unfortunately it looks like your insurance does not cover pre-existing constrictions."
2324,96,35,58,138,231,1.5541125541125542,0.0489055049145452,651,"It looks likes a snake, but I'm going to schedule a pet scan just to be sure."
75,98,41,57,153,251,1.5537848605577689,0.04790826299779256,651,"Don’t be ashamed, Ereptile Dysfunction is more common than you would think"
6218,99,39,53,145,237,1.5527426160337552,0.04941745988131087,651,I’m afraid we don’t cover pre-existing constrictions.
1322,100,35,56,137,228,1.5526315789473684,0.04941273894306318,651,Vick's Viper rub should do the trick.
8440,101,34,53,132,219,1.552511415525114,0.05058124694849869,651,It's completely normal Mr. Richards...lots of men your age suffer from reptile dysfunction.
2867,102,41,50,148,239,1.5523012552301256,0.04980469473546826,651,"Nice try, but I am still going to do your prostate exam."
4138,102,43,46,150,239,1.5523012552301256,0.050505728715945115,651,I see you’re covered under COBRA
1906,104,39,55,147,241,1.5518672199170125,0.04877504671876449,651,I see you're covered by COBRA.
4736,105,40,54,149,243,1.551440329218107,0.048811155729611685,651,It says here you are covered by Cobra.
9038,106,42,46,148,236,1.5508474576271187,0.05066984244892297,651,I thought a reptile dysfunction was misspelled.
5991,107,36,60,144,240,1.55,0.047862250041964156,651,"Actually, this is the one thing your plan does cover."
4472,108,39,53,147,239,1.5481171548117154,0.049111627782006534,651,Let's talk about your COBRA coverage.
1053,108,43,45,151,239,1.5481171548117154,0.05052320273170815,651,So I see you have cobra insurance.
5846,110,35,63,145,243,1.5473251028806585,0.04705483781078975,651,"As soon as she’s done taking your blood pressure, she’ll do the prostate check."
5848,111,31,76,146,253,1.5454545454545454,0.04423033025453101,651,"No, a heart attack feels more like an elephant on your chest."
5805,112,32,63,138,233,1.5450643776824033,0.04746356649252141,651,And when was his last meal?
2290,113,34,60,141,235,1.5446808510638297,0.04792111233226796,651,The pharmacist must have misread the type of vasoconstrictor I was prescribing.
8110,114,44,54,163,261,1.5440613026819923,0.04744321920277318,651,Not quite the COBRA coverage you expected from your former employer?
4614,115,39,60,155,254,1.5433070866141732,0.046845600838012424,651,Your insurance doesn't cover pre-existing constrictions.
8418,116,35,55,141,231,1.5411255411255411,0.048960454001937125,651,"Unfortunately, I see you only have COBRA insurance."
7100,117,28,74,140,242,1.537190082644628,0.0446294962485189,651,Have you tried vigorously twirling counterclockwise?
8061,118,36,53,144,233,1.536480686695279,0.04902858222659169,651,"Bad news, I'm afraid. Your insurance doesn't cover pre-existing constrictions."
6957,118,34,57,142,233,1.536480686695279,0.04826804884241503,651,And then she just left you two in the garden?
7928,120,38,57,153,248,1.5362903225806452,0.04740789601763295,651,The good news is that the frog in your throat is no longer a problem.
7498,121,31,73,148,252,1.5357142857142858,0.04439752675300195,651,"It's probably just an anaconda, but we'll want to run some tests."
4194,122,39,53,153,245,1.5346938775510204,0.048212460203244,651,"Well, Adam, your insurance says Original Sin is a preexisting condition."
6514,122,32,67,146,245,1.5346938775510204,0.045719244103316715,651,"Well, the tests confirmed you are suffering from Irritable Boa Syndrome."
498,124,34,49,136,219,1.5342465753424657,0.05065304971855624,651,Your snake's fine. I just want to remind you again that there is no need to take your clothes off at a veterinarian's office.
3819,125,32,54,135,221,1.5339366515837105,0.04947180390063716,651,Let me know when the contractions are a about a minute apart.
3175,126,40,57,160,257,1.5330739299610896,0.04677865773752758,651,It appears you have ereptile dysfunction.
2679,127,32,59,140,231,1.5324675324675325,0.04782223134065263,651,You say you're covered by COBRA?
5207,128,35,54,144,233,1.5321888412017168,0.04866285593381822,651,"So, which one of you is Howard?"
8856,129,38,50,149,237,1.5316455696202531,0.04913116582294138,651,I think you misunderstood when your employer told you that you were going to need COBRA coverage.
4680,130,40,64,167,271,1.5313653136531364,0.04489572977833731,651,Are you still covered by COBRA?
5977,131,38,61,159,258,1.5310077519379846,0.04599154730030601,651,"When the contractions are two minutes apart, you probably ought to go to the hospital."
6187,132,37,48,145,230,1.5304347826086957,0.04992627116208435,651,‘The good news is that you’re fully covered by your cobra plan.’
293,133,31,71,149,251,1.5298804780876494,0.04454746274348241,651,"First, let’s order a PET scan."
7488,134,30,78,153,261,1.528735632183908,0.04292476965191792,651,Is this new or a preexisting constriction?
5482,135,37,47,145,229,1.5283842794759825,0.0501024580708986,651,And I see you're now covered by COBRA.
6025,136,36,62,156,254,1.5275590551181102,0.04588631188297728,651,I see your COBRA's kicked in.
8338,137,37,61,158,256,1.52734375,0.04594603908064061,651,Let me know when the contractions come five minutes apart.
6516,138,36,60,155,251,1.5258964143426295,0.046311206650901646,651,I'm referring you to a mongoose.
3609,139,32,60,144,236,1.5254237288135593,0.047064467994677735,651,"Okay, let's go over it again: You swallowed a spider to catch the fly..."
3354,140,37,61,159,257,1.5252918287937742,0.045812886534305895,651,Just checking my records. Are you still covered by COBRA?
2401,141,38,39,142,219,1.5251141552511416,0.052304737040386226,651,I’m writing you a prescription for your ereptile dysfunction.
1288,142,33,60,147,240,1.525,0.04684055568525811,651,"I think we'll skip the prostate exam this time"""
8210,142,38,50,152,240,1.525,0.048665954982282204,651,"EREPTILE Dysfunction! Ha ha, get it? But seriously, get it off."
9170,142,36,54,150,240,1.525,0.04794413590173481,651,"It's nothing serious, just something that's going around."
7372,145,29,58,134,221,1.5248868778280542,0.04823352673221468,651,"It’s “Adam”, right?"
8895,146,41,45,156,242,1.524793388429752,0.04940426271765877,651,How much longer do you have Cobra coverage?
2349,147,37,55,154,246,1.524390243902439,0.04738974848809758,651,"Sarah, call Mrs. Blakely, tell her her snake is fine, and we found her husband."
2991,148,33,67,154,254,1.5236220472440944,0.04486627114920672,651,You definitely picked something up on your trip to South America.
6370,149,35,54,148,237,1.5232067510548524,0.04804747372036257,651,I'm not sure COBRA covers this.
7145,150,32,61,146,239,1.5230125523012552,0.04661900148246371,651,My hands are tied -  it’s a protected species.
1446,151,38,62,164,264,1.5227272727272727,0.045201797591747986,651,It's coilitis.
3244,152,30,75,154,259,1.5212355212355213,0.04318740863632905,651,I’m going to have you stand and turn counterclockwise 4 times as fast as you can
7023,152,43,49,167,259,1.5212355212355213,0.047478897176224465,651,I see that you’re fully covered by COBRA.
1997,154,38,47,151,236,1.521186440677966,0.049318117728938765,651,"I'm sorry, but your health plan doesn't cover reptile dysfunction."
5906,155,29,67,144,240,1.5208333333333333,0.0453361521295276,651,Sooo....what brings you in today?
723,155,31,63,146,240,1.5208333333333333,0.046098825330860335,651,I'm calling it 'constricted bowel' for insurance purposes.
8989,157,32,75,160,267,1.5205992509363295,0.042888035969205374,651,"Sorry to say, but I think it’s e-boa."
5374,158,29,56,134,219,1.5205479452054795,0.048576902267720615,651,Ereptile dysfunction is nothing to be ashamed about.
9157,159,44,62,183,289,1.519031141868512,0.04386437769228194,651,"You came to the right place, reptile dysfunction is my specialty."
7289,160,36,51,150,237,1.518987341772152,0.048425941587883735,651,"I’m sorry sir, but your insurance doesn’t cover pre-existing constrictions"
5828,161,36,65,163,264,1.518939393939394,0.044566717282009956,651,Please stick out your other tongue.
3378,162,32,60,147,239,1.5188284518828452,0.046626890038873686,651,I’m afraid there’s nothing we can do.  It’s on the endangered species list.
7971,163,44,51,173,268,1.5186567164179106,0.04652775483103554,651,"You have Reptile Dysfunction. I'm prescribing Snake Oil, which is covered by TrumpCare."
5052,164,36,63,162,261,1.5172413793103448,0.04496001658760448,651,"To my utter surprise, this IS actually covered under your plan."
1490,165,34,53,147,234,1.517094017094017,0.048155064498087166,651,"Ironically, your COBRA coverage just ran out."
2004,166,34,55,149,238,1.5168067226890756,0.04753110550640857,651,So the tests all came back positive. It is a snake.
109,167,39,48,157,244,1.5163934426229508,0.04840685707074066,651,What brings you in today?
3974,168,31,56,142,229,1.51528384279476,0.047780049891840724,651,Just a mild case of viper tension.
5533,169,35,54,152,241,1.5145228215767634,0.0474449470082923,651,Now let me get this straight: You were in this garden with a naked woman eating apples ....
3882,170,36,54,155,245,1.5142857142857142,0.04720349517257375,651,So I see you're here for ereptile disfunction
2758,171,36,56,157,249,1.5140562248995983,0.046617828906611605,651,I'm afraid your insurance doesn't cover pre-existing constrictions.
8741,171,37,54,158,249,1.5140562248995983,0.046963917925809236,651,"Yes, we've being seeing a lot of Irritable Boa Syndrome this season."
5409,173,30,61,145,236,1.5127118644067796,0.0463141767110335,651,"Sir, ereptile dysfunction is not my area of expertise"
1891,174,31,60,147,238,1.5126050420168067,0.04640426443540325,651,This thing has been going around.
7550,174,37,48,153,238,1.5126050420168067,0.048642564518834766,651,This isn’t covered under COBRA.
3883,176,34,55,151,240,1.5125,0.04723204905000042,651,Your insurance company is concerned that it may be a preexisting constriction.
8539,176,34,55,151,240,1.5125,0.04723204905000042,651,So it wasn't a typo.  You do have a large asp.
5712,178,36,52,154,242,1.512396694214876,0.047657447425805695,651,The good news is we’ve made great strides in treating A Reptile Dysfunction.
8348,179,36,53,155,244,1.5122950819672132,0.047355185278134836,651,"Ah, Mr. Smith.  I see you've met Victor.  Victor is the head of our billing department."
3055,180,36,54,156,246,1.5121951219512195,0.04705768088121013,651,"So, how long have you been experiencing ereptile dysfunction?"
8784,181,36,55,157,248,1.5120967741935485,0.04676481984676831,651,"Nice try, but I'm still going ahead with your colonoscopy."
3836,182,40,54,168,262,1.5114503816793894,0.04612212674537451,651,"Off hand, I'd say you are being suffocated by a snake, but just to make sure I'm going to order a bunch of tests."
5452,183,33,54,148,235,1.5106382978723405,0.047624685226685566,651,"I'm sorry, but this is a preexisting constriction ."
9238,184,34,53,150,237,1.510548523206751,0.04769289823309097,651,And after surgery you’ll have a super cute bag and matching shoes.
712,185,36,51,154,241,1.5103734439834025,0.04781246256564612,651,"Unfortunately, your insurance doesn't cover preexisting constrictions."
7396,185,31,61,149,241,1.5103734439834025,0.045968911707093996,651,The good news is that you no longer have that monkey on your back.
8671,185,32,59,150,241,1.5103734439834025,0.04634348918829856,651,"Nice try, Mr. Jones, but you can't avoid a prostate exam."
7946,188,33,64,158,255,1.5098039215686274,0.04475336667640326,651,The good news is that it’s covered by your COBRA benefits.
6669,189,34,63,160,257,1.509727626459144,0.04483027075172094,651,"So, you have no idea what happened to your therapy dog?"
354,190,39,55,167,261,1.5095785440613028,0.04594138515569886,651,Are you covered under COBRA?
4305,191,37,42,149,228,1.5087719298245614,0.05030674439838487,651,"Nice try, Mr Rosen, but there's no escaping your prostate exam."
8122,192,32,53,146,231,1.5064935064935066,0.04786821180980382,651,"As you, no doubt, surmised, you did not receive the placebo."
709,193,32,56,149,237,1.5063291139240507,0.04694037583032562,651,"Ironically, yes, I do believe this is covered under your COBRA."
6006,193,39,42,156,237,1.5063291139240507,0.049534864727698566,651,Don’t worry. Ereptile disfunction is very common for men your age.
9052,195,26,73,148,247,1.5060728744939271,0.043265555310907526,651,But many things can cause tightness in the chest.  Let's not jump to conclusions.
8930,196,38,53,164,255,1.5058823529411764,0.046448880274772154,651,So this is the only COBRA coverage you could afford?
2148,197,33,64,160,257,1.5058365758754864,0.04449259387560028,651,"I'm sorry, it's a pre-existing constriction."
5796,198,33,68,164,265,1.5056603773584907,0.04347694285749494,651,"'Looks like its just something that's going around.."""
1240,199,38,62,173,273,1.5054945054945055,0.04407372202935406,651,It's just something that's going around
265,200,49,41,185,275,1.5054545454545454,0.04704144330212622,651,It will continue to constrict you until you can no longer take a breath. But enough about your insurance company.
6869,201,27,55,134,216,1.5046296296296295,0.04822324859223337,651,Just to clarify...you say this started with a frog in your throat?
439,202,32,50,144,226,1.5044247787610618,0.04867882323241597,651,"""It's all in your mind. The condition is  called hypoanacondria."
9172,202,29,56,141,226,1.5044247787610618,0.047451382814390305,651,It's just a little something to help you both unwind.
1049,204,36,48,154,238,1.504201680672269,0.04828289326235892,651,"I'm so sorry, we only accept COBRA here."
9128,205,35,50,155,240,1.5,0.047606593310578024,651,So how long have you been covered by Cobra?
9084,205,25,63,138,226,1.5,0.04576456358620705,651,Any tightness or difficulty breathing?
8317,205,27,63,144,234,1.5,0.04542452263392873,651,I'm writing you a prescription for a mongoose.
7633,205,31,56,149,236,1.5,0.046709234788175825,651,Your insurance provider has denied coverage based on a pre-existing constriction.
6833,205,27,66,147,240,1.5,0.044580799664707335,651,"We got the monkey off your back, but you’ll need to see a specialist for this one."
335,205,29,66,153,248,1.5,0.044260499005711135,651,"This is why early detection is so important. Once they swallow you whole, our options are limited."
965,205,33,52,151,236,1.5,0.04747501098334506,651,Good news: it’s not poisonous. Bad news: it’s endangered.
9171,205,30,55,145,230,1.5,0.04723210204756298,651,I'm writing a prescription for something to help you unwind.
30,205,29,49,136,214,1.5,0.049458477742226344,651,"I'm sorry, but COBRA and BOA are actually two separate policies."
7830,205,39,39,156,234,1.5,0.05003575259663136,651,"So, cost was not what you meant when you said you were getting squeezed by COBRA."
4815,205,39,35,152,226,1.5,0.05142989806470473,651,"With your plan, it's the only way to measure your blood pressure.  Just wait until you see how we check your prostate."
3546,205,43,49,178,270,1.5,0.04597229319606028,651,"So where's the gerbil now?"""
7907,217,42,49,176,267,1.4981273408239701,0.046071341977213645,651,Unfortunately there’s no cure for e-reptile dysfunction.
7431,217,30,73,164,267,1.4981273408239701,0.04224505996261734,651,Give him two white mice and call me in the morning
3148,219,34,61,164,259,1.498069498069498,0.04457136667817475,651,I'm prescribing you an antihisstamine.
4723,220,30,68,159,257,1.4980544747081712,0.04345702124076487,651,I’m going to prescribe a laxative for the snake.  You should pass through in a day or two.
4666,220,36,56,165,257,1.4980544747081712,0.045507204827688975,651,"I'm prescribing you an oboe and a basket -- 
should work like a charm."
8877,222,33,61,161,255,1.4980392156862745,0.044757425141113305,651,"He just ate a whole pig, so you should be safe for the next month."
1544,223,36,52,161,249,1.497991967871486,0.04662619860575561,651,It looks like you’re covered under COBRA.
1464,224,33,56,156,245,1.4979591836734694,0.04613698376781525,651,So what are we seeing you for today?
9087,224,34,54,157,245,1.4979591836734694,0.04649814272145296,651,I’m afraid I will have to charge you for my missing receptionist.
2526,226,27,67,149,243,1.4979423868312758,0.04417367996738126,651,My first concern is the location of the tail.
2391,227,34,61,165,260,1.4961538461538462,0.04444091425263712,651,"No, you can leave the snake on."
9184,228,27,66,149,242,1.4958677685950412,0.04430764855019096,651,"Well, the test results finally came back, and you were right--it is a Burmese python."
5373,229,35,41,148,224,1.4955357142857142,0.05022282502162479,651,It looks like your cobra covers fifty percent
2431,230,36,57,168,261,1.4942528735632183,0.044971317333437746,651,What brought you here today?
6245,231,40,45,168,253,1.4940711462450593,0.04739945006252838,651,So now is probably a terrible time to tell you we no longer accept COBRA.
7639,232,35,52,160,247,1.4939271255060729,0.046563355297409195,651,I'm sorry but your policy does not cover pre-existing constrictions.
4609,233,28,61,148,237,1.4936708860759493,0.04539127735534473,651,There is nothing we can do about your snake but on the bright side I think we know where your hamster went
3382,234,33,45,147,225,1.4933333333333334,0.04924831799561104,651,"As your vet, I think the first thing to do is remove that man who's stuck in the middle of you"
6203,235,30,50,143,223,1.493273542600897,0.048351800637953066,651,"Well, if it was a COBRA, you’d be covered..."
9218,236,35,54,163,252,1.492063492063492,0.045852473881286604,651,I'll write the prescription more legibly this time.
9138,237,37,47,162,246,1.491869918699187,0.04741251492015126,651,It says on your insurance paperwork that you're covered by COBRA; is that correct?
5787,237,32,57,157,246,1.491869918699187,0.045629229058864906,651,You needn't have removed your socks.
4525,239,28,62,150,240,1.4916666666666667,0.04496692828849291,651,"... sorry, it says here you’re only covered if he actually bites you.”"
8729,240,29,49,140,218,1.4908256880733946,0.04876213675566353,651,It says here that this is a pre-existing constriction.
7066,241,33,65,169,267,1.4906367041198503,0.043229729915820615,651,And just what brings you in today?
2130,242,36,57,170,263,1.4904942965779469,0.044707441708432834,651,"Bad news, Harold. I’m afraid you have Ereptile Dysfunction."
6918,243,38,50,169,257,1.490272373540856,0.046166530153477055,651,About your insurance--it seems you have COBRA?
754,243,28,70,159,257,1.490272373540856,0.04274763361361254,651,COBRA plan?
674,245,35,51,161,247,1.4898785425101215,0.046560493294560835,651,So what brings you here?
1662,246,32,53,154,239,1.4895397489539748,0.04663793177621186,651,"Sorry, but this is a python and you have COBRA."
2606,247,37,42,158,237,1.489451476793249,0.04880456596701544,651,"While I would love to help out, he's endangered whereas you are merely screwed."
9230,248,30,54,149,233,1.4892703862660943,0.04676590661543975,651,Chest pain. Shortness of breath. Decreased mobility of the upper extremities. We're going to want to run some tests.
4965,249,37,50,167,254,1.4881889763779528,0.04625069521529254,651,"Here is your letter about your Emotional Support Snake, now you must convince the Airline ."
1387,250,31,61,160,252,1.4880952380952381,0.04444836848366326,651,'Looks like you got the full Monty python.'
3604,250,39,45,168,252,1.4880952380952381,0.04720819726609715,651,Your insurance form says you have COBRA coverage.
8991,252,33,56,161,250,1.488,0.045427730681373894,651,Well scaly dry skin is very common in the winter months.
7660,253,35,50,161,246,1.4878048780487805,0.04670376135396772,651,Let's have a follow-up appointment when the contractions are less than five minutes apart.
1974,254,32,52,154,238,1.4873949579831933,0.046784751561313856,651,No. I said use a vapor rub
3001,255,33,49,154,236,1.4872881355932204,0.04746776848008064,651,Unfortunately this isn't covered under your COBRA insurance.
4871,255,32,51,153,236,1.4872881355932204,0.04708637826158047,651,I'm afraid this won't be covered under your COBRA insurance.
1879,257,38,36,156,230,1.4869565217391305,0.05033792575978055,651,"Well, at least you’re covered by COBRA."
6872,258,32,47,149,228,1.486842105263158,0.04834387761701288,651,And remember this next time you promise to drain the swamp.
3422,259,37,55,173,265,1.4867924528301886,0.04476668656712643,651,You just need to go home and unwind.
7108,260,32,64,167,263,1.4866920152091254,0.04338575878603875,651,That’s going to make your prostate exam more challenging.
7611,261,31,46,145,222,1.4864864864864864,0.048929567268524515,651,"I can remove him, no problem, just be more careful around humans in the future.”"
8497,262,35,55,167,257,1.4863813229571985,0.04516411360992761,651,Do you hear a rattle when you cough?
9127,263,33,58,164,255,1.4862745098039216,0.04474930784361746,651,Would you prefer a gown?
7771,264,37,31,148,216,1.4861111111111112,0.05249140312151344,651,"Unfortunately, this won't be covered by Cobra."
6542,265,34,52,161,247,1.48582995951417,0.046201346796849875,651,So...what brings you here today Mr. Jones?
5088,266,35,49,161,245,1.4857142857142858,0.046847774239063195,651,"Honestly Dan, I think you need to reconsider your choice of a support animal."
5864,267,33,51,157,241,1.4854771784232366,0.046710456039274345,651,"So, tell me why you’re here."
3456,267,32,53,156,241,1.4854771784232366,0.04633884500918899,651,"Well...despite what WebMD says, the numbness in your legs isn't cancer."
8997,269,34,48,157,239,1.4853556485355648,0.0473811813963402,651,This is one time that I think snake oil will really work.
9059,269,37,42,160,239,1.4853556485355648,0.04848152095042078,651,"I'm sorry, but your COBRA doesn't cover everything."
2581,271,34,62,172,268,1.4850746268656716,0.04342579777115626,651,"Otherwise, it was a good vacation?"
8559,272,24,64,143,231,1.4848484848484849,0.04460272166490083,651,Any trouble swallowing?
1525,273,31,64,165,260,1.4846153846153847,0.043417024758545954,651,I'm going to prescribe a small goat to help relieve that tightness.
2587,274,28,69,161,258,1.4844961240310077,0.0426192030938791,651,"Your plan doesn't cover this, but I can refer you to a Pentecostal church."
7425,275,31,62,163,256,1.484375,0.043922541417907995,651,Have you considered a service dog?
327,276,32,44,147,223,1.484304932735426,0.049171018919841804,651,I don't think this is covered in your COBRA policy
6367,277,35,52,165,252,1.4841269841269842,0.04584426370355844,651,"I noticed that you answered ""no"" to the question ""Do you feel safe at home?"""
6236,277,31,60,161,252,1.4841269841269842,0.044443428090031364,651,"This should be quick. I’ll just need you to stand up, turn around and drop the snake to your ankles, please."
1085,279,38,43,165,246,1.483739837398374,0.04775270893237208,651,I see you have COBRA coverage.
6971,280,33,66,174,273,1.4835164835164836,0.04250806737630291,651,"Well, the good news is we were able to remove the mole.”"
5424,281,40,47,176,263,1.4828897338403042,0.04597915841737046,651,You may want to reconsider your choice of an Emotional Support Animal.
5068,281,33,61,169,263,1.4828897338403042,0.04371392991314043,651,Snake's date of birth?
8365,283,28,56,148,232,1.4827586206896552,0.04610744299458768,651,The good news is your cholesterol levels are fine. The bad news is your blood pressure is 650 over 400.
5230,284,27,55,144,226,1.4823008849557522,0.04660113467497906,651,And what seems to be the trouble today?
1804,285,31,60,162,253,1.482213438735178,0.04430875288748415,651,"It is going around, I can tell you thát."
4846,286,28,50,142,220,1.481818181818182,0.047982820176750964,651,"Yes, we do accept Cobra coverage."
8373,287,29,57,153,239,1.4811715481171548,0.04548170348111451,651,Let me explain again the difference between a restrictive diet and a constrictive diet.
6682,288,30,54,153,237,1.481012658227848,0.046157616749129785,651,I'm going to prescribe you a mongoose. Should clear that right up.
8419,289,37,48,169,254,1.4803149606299213,0.04624009698068611,651,Put two mice in the corner every four hours.
5432,290,29,51,147,227,1.4801762114537445,0.047275956270761935,651,"Sad to say, your COBRA doesn't even cover it."
5790,291,28,64,158,250,1.48,0.04361201706099494,651,"As a veterinarian, I don't see anything wrong with him."
7737,291,25,58,142,225,1.48,0.045894980186826605,651,It appears you are suffering from vipertension.
3777,293,28,62,156,246,1.4796747967479675,0.04413472706155633,651,"Well I've narrowed it down to workplace stress, or the snake."
5497,293,33,52,161,246,1.4796747967479675,0.04597601721925548,651,Give him two small mice and call me in the morning!
9144,295,29,59,156,244,1.4795081967213115,0.04478044307990728,651,Does anyone besides you see the snake?
4847,296,31,53,156,240,1.4791666666666667,0.046098825330860335,651,And is this snake in the room with you right now?
897,296,32,51,157,240,1.4791666666666667,0.04647546880206719,651,And you say this all started when he gave your wife an apple?
7494,298,22,68,144,234,1.4786324786324787,0.04333607647080256,651,Hissing in your ears?
386,299,28,55,149,232,1.478448275862069,0.04609959261783499,651,"Sorry for the wait, Mr. Baker....So, what brings you in to see us today?"
6108,300,28,66,161,255,1.4784313725490197,0.042976950306715445,651,Mmmhm... and how far apart are the constrictions?
5629,301,23,64,143,230,1.4782608695652173,0.04430577604896505,651,I'm afraid I specialize in internal medicine. Come back once it has consumed you.
3753,302,30,60,161,251,1.4780876494023905,0.04420695300933927,651,Of course if it swallows you first we’ll have to try something more aggressive:
8982,303,39,51,180,270,1.4777777777777779,0.04473777633008347,651,I see you’ve met our claims adjuster.
2695,304,30,75,178,283,1.4770318021201414,0.04045339653667903,651,"I'm not so much concerned about when you last ate, as I am with when it last ate."
4840,305,34,46,159,239,1.4769874476987448,0.04736720716547912,651,"Unfortunately, your COBRA doesn't cover this."
2771,306,22,59,135,216,1.4768518518518519,0.045910320415521864,651,It's nothing serious but if it bothers you I can remove it.
5350,307,27,53,145,225,1.4755555555555555,0.04674219134250252,651,"It could be the python, but we'll run lots of tests to be sure."
404,308,30,56,158,244,1.4754098360655739,0.04514708304801775,651,I’m going to prescribe a mongoose.
3800,308,25,66,153,244,1.4754098360655739,0.04323889788877676,651,"Otherwise, you're in perfect health."
8176,308,28,60,156,244,1.4754098360655739,0.04439365248434952,651,Well... I have your test results and it's definitely Irritable Boa Syndrome.
9107,308,24,68,152,244,1.4754098360655739,0.042847064394359084,651,I think we should to a PET scan
2962,312,37,51,175,263,1.4752851711026616,0.04500882010785597,651,This should hold you until you can afford the gastric band.
3262,313,32,56,165,253,1.4743083003952568,0.04464606683155125,651,"Trust me, this is more effective than an enema."
5854,313,29,62,162,253,1.4743083003952568,0.0435793815211549,651,I see you picked up something from your trip to the Amazon.
5807,315,29,61,161,251,1.4741035856573705,0.04383628966668371,651,So which one of you is the patient?
4129,316,30,67,171,268,1.4738805970149254,0.04209843884953333,651,"My problem with these trendy diets is that as soon as the snake comes off, you're eating again."
6068,317,25,67,155,247,1.4736842105263157,0.042852395035188166,651,Your vitals are OK. Your bloodwork is good. No sign of heart disease. So I'm going to say the tightness in your chest is from the snake.
7888,318,43,47,191,281,1.4733096085409252,0.044534795588386286,651,It says here your insurance doesn't cover preexisting constrictions.
137,319,28,67,165,260,1.4730769230769232,0.042356264474183586,651,"Yeah, it’s going around."
1166,320,28,66,164,258,1.4728682170542635,0.04259656596012912,651,OK  you can put your pants back on
3809,321,23,66,148,237,1.4725738396624473,0.04334238114256588,651,"Sorry, this is Hematology.
You want Herpetology."
9028,322,24,72,158,254,1.4724409448818898,0.041618295442610705,651,I'm going to write you a little something to help you unwind.
2164,323,32,46,155,233,1.4721030042918455,0.04752040710535634,651,This is the last letter I'm writing for your emotional support animal.
2374,323,28,54,151,233,1.4721030042918455,0.04593685251807094,651,"Sorry sir, this doesn't qualify you for medical marijuana."
5971,325,31,45,151,227,1.47136563876652,0.04807386585396225,651,Buy a mongoose and use as directed.
417,326,35,45,164,244,1.471311475409836,0.04696825889311345,651,"Sorry, you only have COBRA coverage."
5557,327,24,57,142,223,1.4708520179372198,0.04573705852074975,651,"He may not be in your network, but I can refer you to an excellent mongoose."
3747,328,28,56,154,238,1.4705882352941178,0.045210667953591355,651,Two mice every fours hours.
2218,329,40,47,183,270,1.4703703703703703,0.04502863117856536,651,"Yes, we've recently been seeing a lot of this in South Florida. It's called Reptile Disfunction."
3633,330,32,54,165,251,1.4701195219123506,0.044903774305086123,651,Well I see that you have COBRA coverage.
69,331,27,56,151,234,1.4700854700854702,0.04538222750909935,651,Shortness of breath can be caused by many things. Let’s not jump to conclusions.
960,332,32,61,173,266,1.4699248120300752,0.04298736044282556,651,Good news.  It's not your prostate.
2510,332,33,59,174,266,1.4699248120300752,0.04331611682365994,651,Preliminary tests indicate it's a snake.
2229,334,27,63,159,249,1.4698795180722892,0.043345955761045926,651,I’m prescribing an anti-hssstamine.
6316,334,35,47,167,249,1.4698795180722892,0.04623821796573497,651,Trust me.  This is the best remedy for constipation you’ve ever seen.
5232,336,40,36,171,247,1.4696356275303644,0.04826100466613506,651,I checked with your COBRA plan and unfortunately they aren't going to cover it.
289,337,29,50,151,230,1.4695652173913043,0.04678519328020938,651,I'm afraid this will be out-of-pocket for you.  Your insurance doesn't cover pre-existing constrictions.
5254,338,30,47,151,228,1.469298245614035,0.0475021584028259,651,So what seems to be bothering you?
8335,339,34,54,172,260,1.4692307692307693,0.04440041201139018,651,Good. I see you have COBRA coverage.
755,340,31,59,168,258,1.4689922480620154,0.04363576678990445,651,"Well, your labs all came back normal. So, I guess we’re back to square one."
2497,340,28,65,165,258,1.4689922480620154,0.04258627237603421,651,And does Eve have a last name?
3739,340,32,57,169,258,1.4689922480620154,0.043980033266949436,651,"Actually, when I said a pet could help lower your blood pressure, I was thinking more of a dog or a cat."
6239,343,34,60,179,273,1.468864468864469,0.04279374386421478,651,Good thing you're covered by Cobra.
7161,344,32,56,168,256,1.46875,0.044237480227322455,651,"So, how can I help you today?"
2055,345,34,44,161,239,1.4686192468619246,0.047347014883957816,651,What seems to be the trouble today?
6600,346,26,52,144,222,1.4684684684684686,0.046761162519249125,651,"It works like any laxative, but faster."
1505,347,28,62,162,252,1.4682539682539681,0.04332837700338449,651,The good news is that the cancer won't kill you.
4649,348,34,35,151,220,1.4681818181818183,0.05048072611971767,651,Let me guess...your covered by COBRA.
7439,349,31,48,156,235,1.4680851063829787,0.04681346995500812,651,"Well, I don't know what to tell you.  All your labs came back normal."
37,349,21,68,146,235,1.4680851063829787,0.042752759885958024,651,"So, to recap. You were picking apples. 
A naked woman said: ‘want one?’  
And that’s the last you remember."
1641,351,33,42,156,231,1.4675324675324675,0.048214202537253316,651,"Well, of course, that could be the source of your chest pain, but wouldn’t you feel better if we ran a few tests first?"
3273,352,25,63,154,242,1.4669421487603307,0.04347550217411993,651,Any changes since your last check up?
1823,353,27,66,164,257,1.4669260700389104,0.042344515522343924,651,You had your Lap-Band surgery in Brazil?
8352,354,34,59,179,272,1.4669117647058822,0.042906625155480584,651,The real problem is you have a frog in your throat.
8888,355,23,66,151,240,1.4666666666666666,0.04293400382369281,651,You say you caught it on a plane?
916,356,27,64,162,253,1.466403162055336,0.04283180410731312,651,A rattle could mean any number of things.
4253,356,34,50,169,253,1.466403162055336,0.04532273843443443,651,"I never thought I'd say this, but I think a bottle of snake oil might do the trick."
5529,358,33,45,160,238,1.4663865546218486,0.047118714453262545,651,"I'm sorry, but your insurance does not cover pre-existing constrictions."
5858,358,33,45,160,238,1.4663865546218486,0.047118714453262545,651,"And Eve, how is she feeling today?"
7011,360,31,48,157,236,1.4661016949152543,0.04665686281959647,651,Do you need a minute to unwind?
4573,361,26,64,159,249,1.465863453815261,0.04295862777044341,651,I’m prescribing a muscle relaxant - good luck getting her to take it.
488,362,30,49,155,234,1.4658119658119657,0.04656627722720509,651,"I'm sorry, Mr. Wilson, but this isn't covered by COBRA."
8424,363,31,60,171,262,1.465648854961832,0.04312777150663808,651,It says here you have a service animal?
1748,364,27,60,158,245,1.4653061224489796,0.043851673338811785,651,What brought you in today?
8036,365,25,70,163,258,1.4651162790697674,0.041498280665076354,651,"Yes, there is something definitely going around."
5528,366,23,59,144,226,1.4646017699115044,0.04483484697893179,651,"I'm prescribing a muscle relaxant -- not for you, for your friend."
2083,367,28,48,148,224,1.4642857142857142,0.04729093665458314,651,"More testing, yes. But my gut says it's the giant reticulated python."
3024,368,29,45,148,222,1.4639639639639639,0.048036687778261755,651,Just one more question...how did you get that shirt off?
5067,369,32,45,158,235,1.4638297872340424,0.047187213122029656,651,Lucky for you your COBRA coverage has kicked in.
5761,369,33,43,159,235,1.4638297872340424,0.04757103458366292,651,"The most puzzling question, Sir, is how you took your shirt off!”"
770,371,27,53,151,231,1.4632034632034632,0.045797866318536065,651,I'm sorry. It looks like your COBRA coverage expired 2 weeks ago.
7990,372,26,60,156,242,1.462809917355372,0.043854386118007516,651,You just need to unwind
8398,373,35,48,172,255,1.4627450980392156,0.04538209939695433,651,"So, you're insured through COBRA?"
3309,374,29,65,172,266,1.462406015037594,0.04196277798404341,651,Let's try something to help you unwind.
357,374,27,69,170,266,1.462406015037594,0.0412810985616785,651,"I won't lie to you, Barry. Your snake has a mild cold."
3455,376,22,66,150,238,1.4621848739495797,0.0427653772685129,651,"I will prescribe a mongoose. If that doesn’t work, come back next week"
1565,377,29,58,164,251,1.4621513944223108,0.04380151505448093,651,"No, I prescribed a VASOconstrictor. Guess the nurse is right. I do need to work on my handwriting."
1883,378,25,72,167,264,1.4621212121212122,0.04080739965063059,651,Looks like you’ve caught something that’s been going around.
9176,379,23,63,150,236,1.4618644067796611,0.04344039353525658,651,I’m not sure how to code this for the insurance.
2669,380,29,56,162,247,1.4615384615384615,0.044325960195504735,651,Your medical insurance carrier has authorized me to unwind two loops.
7394,380,25,58,151,234,1.4615384615384615,0.04453844959607658,651,"Blame your HMO, it's the only gastric band they'll pay for."
4337,382,24,59,149,232,1.4612068965517242,0.04440036498275307,651,Any other complaints?
3485,383,25,62,156,243,1.4609053497942386,0.04332430678808668,651,Glad I could squeeze you in.
8010,384,28,50,152,230,1.4608695652173913,0.04634911520300791,651,"Yeah, there’s definitely something going around."
8612,385,25,61,155,241,1.4605809128630705,0.04358492740411821,651,First time in Florida?
7607,386,18,69,141,228,1.4605263157894737,0.04230873339077821,651,Well...your cholesterol is fine.
4779,387,31,60,174,265,1.460377358490566,0.042746270014078526,651,"All the lab tests are coming back negative. Quite frankly, we’re baffled."
3671,388,25,58,152,235,1.4595744680851064,0.044391986158675005,651,"Here, this may help you unwind."
2448,389,23,67,156,246,1.4593495934959348,0.04215323912650292,651,It's just something that's been going around.
6547,389,30,53,163,246,1.4593495934959348,0.044823917789749514,651,It looks like a severe case of irritable boa syndrome.
8161,391,34,50,173,257,1.4591439688715953,0.044761617923152024,651,These days we have many successful treatments for ereptile dysfunction.
4679,392,26,60,158,244,1.459016393442623,0.04357648297753032,651,I recommend a PET scan.
7773,392,26,60,158,244,1.459016393442623,0.04357648297753032,651,New York Fashion Week already?
9164,394,26,54,151,231,1.4588744588744589,0.045368870527447924,651,I'll just need your signature in three places.
5249,395,23,54,141,218,1.4587155963302751,0.04600665010664053,651,I could remove it but they usually come right back.
201,396,28,55,159,242,1.4586776859504131,0.04461441187610709,651,"So, what brings you here today?"
3649,397,26,64,163,253,1.458498023715415,0.042436281964773066,651,I'n prescribing a muscle relaxant for both of you.
968,397,34,48,171,253,1.458498023715415,0.04529674160124133,651,It started with a frog in my throat.
2568,399,29,40,145,214,1.4579439252336448,0.049374459001418375,651,"We 'll have to run some expensive tests, but fortunately you're covered by Cobra."
9215,400,29,61,170,260,1.4576923076923076,0.04265724859976784,651,Bad news: your insurance doesn't cover removing it. Good news: it qualifies as an Emotional Support Animal
8747,401,21,71,155,247,1.45748987854251,0.04123270149253473,651,Take two Aspirin and lie down on a flat rock in the sun.
4175,402,24,54,145,223,1.4573991031390134,0.04568950242936525,651,You think you’re being squeezed now...wait til you see my bill.
3595,403,24,62,155,241,1.4564315352697095,0.043169815523618135,651,"Technically yes, it does make you look fat."
6606,404,24,67,161,252,1.4563492063492063,0.041800646151520765,651,So who am I here to see today?
8765,404,29,57,166,252,1.4563492063492063,0.04365079365079366,651,I'm giving you something to help you unwind.
5456,406,24,56,148,228,1.456140350877193,0.044947480216736425,651,You're lucky - I squeezed you in today.
2942,406,23,58,147,228,1.456140350877193,0.044515537907236905,651,And what brings you in today?
3026,408,22,65,152,239,1.4560669456066946,0.04261269315875854,651,The good news is that your hiccups are gone.
4843,409,24,66,160,250,1.456,0.0420395682804286,651,And what brings you into the office today?
1861,410,33,53,175,261,1.4559386973180077,0.0438937600622386,651,I am sorry but your Cobra coverage has expired.
3264,411,28,47,151,226,1.4557522123893805,0.046943452692742034,651,"Monty, is that your python?"
3466,412,31,46,160,237,1.4556962025316456,0.04647035454930111,651,"Well, some more bad news. You also have a tape worm."
6093,412,27,54,156,237,1.4556962025316456,0.0449050445807079,651,And what else did the internet say about curing your sore throat?
6586,414,26,61,161,248,1.4556451612903225,0.04304738315989118,651,Let me prescribe something to help you unwind.
4090,415,28,62,169,259,1.4555984555984556,0.04241931324213073,651,"How about we try no snake, and see if that helps?"
3716,415,29,60,170,259,1.4555984555984556,0.04277064879590219,651,This is the new colonoscopy prep.  Works fast and most people like that they don't have to drink the two gallons of liquid.
6990,417,28,51,156,235,1.4553191489361703,0.04558740519424861,651,"Stick out your tongue. No, not you... him."
8206,418,25,62,159,246,1.4552845528455285,0.04291674718573733,651,Can you sit up without your support animal?
3347,419,30,57,170,257,1.4552529182879377,0.04336710724739058,651,I regret to inform you...it's the E-boa virus.
6597,419,24,69,164,257,1.4552529182879377,0.04121059323642074,651,"Your test results came back fine, but I'm afraid the snake has bronchitis."
9122,419,30,57,170,257,1.4552529182879377,0.04336710724739058,651,I’m sorry to have kept you waiting.  Tell me what brings you here today?
9173,422,26,54,153,233,1.4549356223175967,0.045064377682403435,651,...and I would consider another service animal.
8893,423,26,58,158,242,1.4545454545454546,0.04382206180749183,651,"Tightening in the chest, hissing in the ears, any other symptoms Mr. Jones?"
7044,423,18,69,144,231,1.4545454545454546,0.04189936391245287,651,First tell me how you got here.
6589,423,27,51,153,231,1.4545454545454546,0.04576405073207165,651,Good news.  You're not having a heart attack.
4257,423,25,60,157,242,1.4545454545454546,0.043429030892422615,651,"and insurance ... okay, I see you're still covered by COBRA"
2717,423,32,51,170,253,1.4545454545454546,0.04458353632241244,651,For insurance purposes Iam just going to write tightness in chest.
6210,428,27,55,158,240,1.4541666666666666,0.0444821108114354,651,The good news is we identified the problem. The bad news is he’s hungry.
6923,429,25,54,150,229,1.4541484716157205,0.0452206213972673,651,You have a bad case of coilitis.
7810,430,27,69,175,271,1.4538745387453875,0.040694636758467476,651,"I'm sorry, it's an endangered species."
3248,431,28,57,164,249,1.4538152610441768,0.043661388062970576,651,But it's more commonly known as Irritable Boa Syndrome.
6260,431,32,49,168,249,1.4538152610441768,0.045120585850467874,651,I think you misunderstood when I suggested COBRA coverage!
4795,433,27,54,157,238,1.453781512605042,0.044756943582437925,651,"Unfortunately, your new insurance won't pay for the scope, but Alice here knows her way around a colon. She'll be wearing a Go-Pro."
1403,434,28,47,152,227,1.4537444933920705,0.046779300285278325,651,Hmm.. Bad news... you’re not covered for pre-existing constrictions...!
5465,434,28,47,152,227,1.4537444933920705,0.046779300285278325,651,I'm prescribing an anti-compressant
6153,436,25,48,143,216,1.4537037037037037,0.04721736645585644,651,"Can't read this writing.
Does it say it 'bowel constriction""...?"
7549,437,34,49,175,258,1.4534883720930232,0.04460821930258497,651,So - what seems to be the problem?
9064,438,22,58,145,225,1.4533333333333334,0.04449005596046243,651,"Other than attachment issues, he's in pretty good health."
962,439,30,51,164,245,1.453061224489796,0.04493596128888366,651,"No, there's little hope now. 
 I'd recommend just getting the boots to match."
3517,439,25,61,159,245,1.453061224489796,0.04303441169798009,651,Any discomfort?
8389,441,19,63,141,223,1.452914798206278,0.04340188122381015,651,I guess we’ll have to skip the “take a deep breath” part
4816,442,34,52,179,265,1.4528301886792452,0.04370956063872718,651,"Yeah, this is probably the main drawback of the emotional-support snake."
3011,443,26,43,141,210,1.4523809523809523,0.048683701030659075,651,"Actually, I don't think your Cobra policy does cover this."
6995,443,30,54,168,252,1.4523809523809523,0.04399509500001258,651,"When did you become aware of the python, Monty?"
6622,445,28,57,165,250,1.452,0.0435242627253252,651,Give it two hamsters and call me in the morning.
8558,446,23,71,165,259,1.4517374517374517,0.040600001147581936,651,Here's something to help you unwind.
1016,447,19,60,138,217,1.4516129032258065,0.0442412314098761,651,"Yes, it's been going around."
8680,448,29,58,170,257,1.45136186770428,0.04299869483570313,651,It says here you have COBRA insurance?
2672,449,37,37,172,246,1.451219512195122,0.04731283090152957,651,I'm going to give you something for ereptile dysfunction.
5762,450,27,52,156,235,1.451063829787234,0.045167895966214636,651,I'd like to help but that's clearly a preexisting constriction.
5046,451,27,56,161,244,1.4508196721311475,0.04392721115291794,651,So ‘Adam’ is it?
9010,451,24,62,158,244,1.4508196721311475,0.04275986189650184,651,Give him one of these in the evening to help him unwind.
7317,453,24,66,163,253,1.4505928853754941,0.04165629667063359,651,You can leave your snake on for this part of the exam.
4110,454,33,57,183,273,1.4505494505494505,0.04241396503326403,651,I need you to take off your boa.
2461,455,28,62,172,262,1.450381679389313,0.04203986797241511,651,The results are in from the lab. It’s a python.
6886,455,33,52,177,262,1.450381679389313,0.043744574669907485,651,I'm sorry.  Your COBRA plan doesn't over pythons.
748,457,22,60,149,231,1.4502164502164503,0.04363872376123414,651,"The good news, it's not poisonous."
5568,457,26,52,153,231,1.4502164502164503,0.04533114023634132,651,"Sorry, but there's no cure for the common coiled."
7610,459,23,53,144,220,1.45,0.04566059565806057,651,He seems perfectly healthy
7826,460,26,55,157,238,1.449579831932773,0.04433975088905201,651,"So, hissing sounds, tightness in the chest. Anything else?"
3028,461,27,61,168,256,1.44921875,0.042396761097547295,651,"As your vet, I'm going to prescribe a Valium to help you unwind, which should take care of that annoying human."
7029,462,28,54,163,245,1.4489795918367347,0.04416661572685247,651,The good news is he says you're 120 over 80.
3928,463,33,48,173,254,1.4488188976377954,0.044775373244606134,651,Good thing we were able to squeeze you in
8393,463,29,56,169,254,1.4488188976377954,0.04336292980918126,651,"Your eyes look good, so I'm taking you off the vasoconstrictor."
14,465,28,62,173,263,1.4486692015209126,0.04191471283258128,651,Take two live mice and call me in the morning.
499,465,28,62,173,263,1.4486692015209126,0.04191471283258128,651,So WebMD told you it was likely cancer?
3308,467,23,50,141,214,1.4485981308411215,0.04658835408664271,651,Ice it three times a day until it hibernates.
4413,468,25,59,159,243,1.448559670781893,0.04327097061953732,651,Any difficulty swallowing?
7606,468,27,55,161,243,1.448559670781893,0.04404993948233453,651,Let's double the dosage on the muscle relaxer. Try giving it to the snake this time.
6222,470,24,60,157,241,1.4481327800829875,0.04313157756502228,651,And you're saying the fruit was forbidden?  By who exactly?
1933,471,30,52,168,250,1.448,0.04423812889570229,651,I think you just need to unwind.
3464,471,29,54,167,250,1.448,0.043873494665191026,651,When did you first notice a man in your coils?
2335,473,30,43,157,230,1.4478260869565218,0.04710609821614403,651,You’re in luck...we accept Cobra.
5022,474,30,60,178,268,1.4477611940298507,0.04200729846367473,651,"As your veterinarian, I'm concerned that you've formed an unhealthy attachment to this man."
111,475,29,49,161,239,1.4476987447698744,0.04537159381243293,651,For a middle-aged snake your vitals look pretty good -- and I see your hunting skills are still up to par.
4606,476,27,70,180,277,1.447653429602888,0.0400274219837282,651,It might not be a panic attack after all.
3003,477,22,58,148,228,1.4473684210526316,0.044037047530833096,651,I’ll order a coilonoscopy.
7127,478,26,54,157,237,1.4472573839662448,0.04446611255673483,651,Any complaints since your last visit?
2877,479,22,74,168,264,1.446969696969697,0.03966851495115926,651,"So, would you describe the pain as ""dull,"" ""aching,"" ""shooting,"" or ""crushing""?"
5508,480,30,49,165,244,1.4467213114754098,0.045045154331839816,651,Tell me again how you got your shirt off.
1,481,31,46,165,242,1.4462809917355373,0.04569938826953408,651,I highly recommend you set aside some time to unwind.
5159,481,21,66,155,242,1.4462809917355373,0.04177930492676088,651,"Well, the test results came back, and it turns out you have a large serpent wrapped around you."
1559,481,31,46,165,242,1.4462809917355373,0.04569938826953408,651,"I'm sorry, but this is considered a pre-existing condition."
7940,484,34,44,173,251,1.4462151394422311,0.04552026025567675,651,You were better off when you were covered under COBRA.
8857,485,31,58,180,269,1.446096654275093,0.042213817001988035,651,Have you recently traveled outside of the United States?
4452,486,33,37,161,231,1.4458874458874458,0.04812963098900545,651,When did you first start to feel contractions?
972,487,31,61,184,276,1.4456521739130435,0.041415148522295435,651,"I think Alfred is fine, but I'm going prescribe him something for his separation anxiety."
2067,488,26,42,143,211,1.4454976303317535,0.04847557015214579,651,"Actually, I'd prescribed a vasoconstrictor. But your pressure has responded well."
2569,489,25,56,157,238,1.4453781512605042,0.043916899242151114,651,Good news!  I think we can save the snake.
5577,489,26,54,158,238,1.4453781512605042,0.04431874614548884,651,This should get the two of you on the plane.
7245,489,20,66,152,238,1.4453781512605042,0.04184982598207679,651,"Any dryness, itching or shedding of skin?"
834,492,32,54,179,265,1.4452830188679244,0.04301671124964182,651,Tell me again why you’re here.
3912,493,26,45,147,218,1.444954128440367,0.04730049356802449,651,It looks like you have a preexisting constriction.
2996,493,24,49,145,218,1.444954128440367,0.04639806915688875,651,"I see the problem now, you can put your shirt back on."
7437,495,31,39,157,227,1.4449339207048457,0.04797194424431592,651,I think it’s a pre-existing constriction.
1292,496,30,49,166,245,1.4448979591836735,0.044897959183673466,651,"You're fine, Bob, but your python has diarrhea. Good luck."
7772,497,24,69,170,263,1.4448669201520912,0.040487008999773415,651,I think you need to unwind a bit.
7640,497,33,51,179,263,1.4448669201520912,0.04359384515387856,651,I need you to remove the snake and put on that gown.
4540,499,20,68,155,243,1.4444444444444444,0.04123720105695586,651,Is that the same one as last time?
5707,499,32,44,167,243,1.4444444444444444,0.04591980369355507,651,"Not to worry.  I only use it for monitoring blood pressure, not for performing the actual colonoscopy."
2155,499,24,60,159,243,1.4444444444444444,0.04285495643554833,651,"Sorry, I'm a hematologist... I'm writing you a referral to the herpetologist."
4066,499,36,48,186,270,1.4444444444444444,0.04369462494116832,651,I'm not sure COBRA will cover this.
2149,503,29,61,178,268,1.4440298507462686,0.0416551408556184,651,"He'll get hungry in about 6 weeks, but until then just don't piss him off."
1201,504,33,45,172,250,1.444,0.04529528287363276,651,I see you've met the drug rep.
1279,505,29,45,158,232,1.4439655172413792,0.04637790080270653,651,Well it’s covered but only if your employer offers COBRA.
4855,505,31,41,160,232,1.4439655172413792,0.04717571078996241,651,We find this gives a more accurate reading than the arm cuff.
7933,507,30,54,173,257,1.443579766536965,0.043313888518302146,651,Now which one of you two am I seeing today?
4758,508,29,52,167,248,1.4435483870967742,0.04411450793439461,651,You're perfectly healthy. The snake just makes you look fat.
7548,508,26,58,164,248,1.4435483870967742,0.04299000141523651,651,What brings you in to see me today?
8221,510,32,42,165,239,1.4435146443514644,0.046498930654348423,651,You need to stop blaming Eve...
2813,511,30,53,172,255,1.4431372549019608,0.04356462960053926,651,"So, after trying alternative methods, you're ready to reconsider Western medicine?"
4248,511,22,69,164,255,1.4431372549019608,0.040630641235352156,651,Patients with your diagnosis have an average life expectancy of 45 minutes.
929,513,24,56,155,235,1.4425531914893617,0.04389941802764754,651,I'm glad we caught this early.
1352,514,28,55,168,251,1.4422310756972112,0.043348371185363554,651,"Next time, eat the apple."
2134,515,29,49,164,242,1.4421487603305785,0.04492144621569066,651,I suggest you take some time to unwind.
3389,515,24,59,159,242,1.4421487603305785,0.04297062305908546,651,The snake is in terrific shape.
8050,517,27,49,157,233,1.44206008583691,0.04541013401816815,651,We'll just need your signature here before we can begin treatment.
7305,518,26,62,170,258,1.441860465116279,0.04175946417953518,651,"Results won’t be back for a few days, but from what I can tell, it’s a snake."
4402,519,32,46,171,249,1.4417670682730923,0.04506433743568513,651,Were you dressed in something provacative?
7976,519,30,50,169,249,1.4417670682730923,0.044339815950962466,651,You’ll find that a vasoconstrictor works much better.
8223,519,30,50,169,249,1.4417670682730923,0.044339815950962466,651,It says here you're still covered by COBRA.
2563,522,25,56,159,240,1.4416666666666667,0.04362883367507677,651,"Two mice tonight, and call me in the morning."
7966,523,27,48,156,231,1.4415584415584415,0.04569991047527887,651,"It is ironic. Nevertheless, the condition is not covered while on COBRA insurance."
5260,524,22,69,165,256,1.44140625,0.04050861793862874,651,You’re fortunate we could squeeze you in today.
7039,524,34,45,177,256,1.44140625,0.04481735362693031,651,You can put your shirt on now.
7506,526,17,71,150,238,1.4411764705882353,0.040534245314629014,651,"You're lucky, my landlord won't even let me have a cat."
5687,526,30,45,163,238,1.4411764705882353,0.045869040914825084,651,I still have to check your prostate.
2406,528,27,58,169,254,1.4409448818897639,0.042598916194615505,651,So have you travelled outside the United States in the last 30 days?
6939,528,22,68,164,254,1.4409448818897639,0.040731495203449285,651,"Your snake's fine, Mr. Jones, but I suggest you see a physician immediately!"
3817,530,22,64,159,245,1.4408163265306122,0.04178835871747857,651,…and stay off planes.
1192,531,27,50,159,236,1.4406779661016949,0.04497254271627098,651,Any recent lifestyle changes?
7690,532,26,48,153,227,1.4405286343612336,0.04587102188084946,651,Your insurance says it looks like a pre-existing condition.
204,533,21,65,157,243,1.440329218106996,0.04162400094158154,651,You say you think you picked this up on a plane?
7357,534,22,59,153,234,1.4401709401709402,0.04318115705501792,651,"Ok, so there's a few questions that I'll need to ask as you're a new patient.
Do you smoke?"
6059,535,27,56,167,250,1.44,0.043093249035664506,651,Feed it two good-sized rodents and call me in the morning.
475,535,23,53,149,225,1.44,0.04486310747929096,651,"It’s okay, choosing the right therapy animal takes time."
2366,535,26,58,166,250,1.44,0.04271884359850551,651,"No, it's fine. A lot of my patients bring their comfort animals."
3436,538,20,77,169,266,1.4398496240601504,0.038693662497219755,651,"Well, the good news is that it isn't contagious."
3982,539,25,56,160,241,1.4398340248962656,0.04348605787624478,651,You got something that's going around.
1672,540,22,65,161,248,1.439516129032258,0.04142018597789232,651,Here is a prescription for 25 mice.  We'll see if that helps.
1915,541,27,62,175,264,1.4393939393939394,0.04140463227713567,651,I'll give you something to help you unwind.
7333,541,24,68,172,264,1.4393939393939394,0.04034759086178251,651,So what brings you into Urgent Care today?
1576,543,26,53,160,239,1.4393305439330544,0.04414892857545661,651,Thanks to the Republicans this seems to be the one thing you actually have coverage for.
469,543,29,47,163,239,1.4393305439330544,0.045327799610327034,651,Could be the anaconda. Could be any number of things. Let's the what the lab results have to say.
8196,543,26,53,160,239,1.4393305439330544,0.04414892857545661,651,"You’ll never believe it, but last week I had a guy come in with a monkey on his back."
329,546,25,44,145,214,1.439252336448598,0.04746902034898791,651,"At the present time I'm less concerned about your flu symptoms than I am
the whereabout of my resident assistant."
6147,547,24,64,167,255,1.4392156862745098,0.04136169256094549,651,"First, let me just say how impressed I am that you managed to change out of your clothes."
9070,548,27,54,165,246,1.4390243902439024,0.043602760169925175,651,"Would you describe the chest pain as sharp, dull or more of a constriction?"
5195,548,23,62,161,246,1.4390243902439024,0.04205311728276811,651,Perhaps you need a different kind of emotional support.
2670,550,35,45,182,262,1.4389312977099236,0.044353430157566244,651,Any noticeable changes to your reptile dysfunction
3977,551,17,63,141,221,1.4389140271493213,0.042646254112760976,651,Maybe we skip the colonoscopy today.
5093,552,27,50,160,237,1.4388185654008439,0.044820968407759475,651,"The nurse said remove everything, Mr. Chambers."
6100,552,31,42,164,237,1.4388185654008439,0.04638911544911974,651,"I'm sorry, but your COBRA policy does not cover large boa constriction."
2152,554,28,55,170,253,1.4387351778656126,0.04307572213724746,651,I’m afraid you have the original preexisting condition.
7490,554,28,55,170,253,1.4387351778656126,0.04307572213724746,651,Are you still with Eve?
4148,556,25,50,153,228,1.4385964912280702,0.045285577185116256,651,Next of kin?
2690,557,32,39,164,235,1.4382978723404256,0.04707392227135303,651,"Shortness of breath is the most common side effect, but others experience constipation, skin irritation, and abject terror"
401,558,30,50,171,251,1.4382470119521913,0.04405589146383773,651,We've found it works faster than laxatives.
4193,558,27,56,168,251,1.4382470119521913,0.042957002255662256,651,"Well, you're the third patient today with a mistaken Amazon delivery."
107,560,24,51,151,226,1.4380530973451326,0.04514430992974723,651,"Well, the shortness of breath could be caused by any number of things."
1044,561,24,58,160,242,1.43801652892562,0.042946708110848913,651,I have a pretty good idea of what's going on but first I'm going to order a few tests.
6307,561,27,52,163,242,1.43801652892562,0.04412818677412845,651,"She’s less accurate than the normal blood pressure machines, but she also helps with the mice."
1092,561,31,44,167,242,1.43801652892562,0.045655956623324744,651,I’m going to prescribe something to help you unwind.
5811,561,25,56,161,242,1.43801652892562,0.04334411279935364,651,The test results are back. We think it's a snake.
852,565,24,65,169,258,1.437984496124031,0.04100871070545148,651,The good news is that we can rule out Lyme disease.
9041,566,26,50,157,233,1.4377682403433476,0.0449761993454964,651,"Oddly enough, COBRA does not cover cobra."
1438,567,24,61,164,249,1.4377510040160641,0.0420683078761898,651,It’ll clear up with anti-hiss-tamines.
4607,567,23,63,163,249,1.4377510040160641,0.04168158961208005,651,I’m prescribing a muscle relaxer.
234,569,27,51,162,240,1.4375,0.044397112028659654,651,"So, have you been out of the country in the last six months?"
6594,569,35,42,179,256,1.4375,0.045137317720267696,651,"Believe it or not, you're actually going to want to use snake oil for this."
8922,569,28,49,163,240,1.4375,0.044788068276853665,651,"I told you I accepted Cobra, not Boa."
7840,572,20,71,163,254,1.437007874015748,0.03993632812922484,651,I’ve seen this go a couple of ways ...
6628,572,25,61,168,254,1.437007874015748,0.04183925505900383,651,"No, that's normal for boas. But if she still hasn't eaten anything by Monday, bring her back for another appointment."
1566,574,25,54,159,238,1.4369747899159664,0.04386938113646763,651,I'm prescribing a muscle relaxer for your partner.
8706,574,32,40,166,238,1.4369747899159664,0.046612478450924096,651,"Ah, I see you brought your insurance company with you."
4557,576,23,51,148,222,1.436936936936937,0.04528593207410457,651,If there's nothing else I'll just go get my flute.
3231,577,32,46,174,252,1.4365079365079365,0.04462937288011568,651,And when was you last boa movement?
6865,578,25,63,171,259,1.4362934362934363,0.04124946167329702,651,Your emotional-support animal needs to come off too.
7584,579,21,64,158,243,1.4362139917695473,0.04159877478164651,651,The tests were inconclusive.  It's either a Burmese or Madagascar python.
2183,580,26,64,176,266,1.4360902255639099,0.04081269976857876,651,Good news. It should fall off on its own in four to six days.
8553,581,24,61,165,250,1.436,0.041936268341492174,651,"Look, I respect your persistence... but a snake coiled around your naked body is, again, not a good reason for me to prescribe medical marijuana."
6949,582,27,58,172,257,1.4357976653696498,0.042204616515920924,651,And is Eve your ex-wife?
8117,583,31,53,180,264,1.4356060606060606,0.04275235547811431,651,Do you have COBRA?
2426,584,28,52,168,248,1.435483870967742,0.043697715812582597,651,I thought you said BOWEL constriction.
2738,585,22,57,153,232,1.4353448275862069,0.043418574889421385,651,I'm prescribing a strong mongoose.
4852,586,27,57,171,255,1.4352941176470588,0.04244393498270469,651,"Yes, Bob... definitely a case
of Irritable Boa Syndrome."
8141,587,27,53,166,246,1.434959349593496,0.04357877731548761,651,And why did you come in today?
2091,587,19,69,158,246,1.434959349593496,0.04041828534014438,651,"You're fine, but your snake is stressed out and needs to unwind."
7599,589,29,52,172,253,1.434782608695652,0.0434154763445806,651,"Chest tightness, shortness of breath, feeling of impending doom...I think you’re having a panic attack."
5479,589,29,52,172,253,1.434782608695652,0.0434154763445806,651,How big was he when you got him?   Where is your wife?
5176,591,31,51,178,260,1.4346153846153846,0.04323708504619243,651,My apologies.  It seems that 'topical anesthesia' was auto-corrected to 'tropical anaconda'...
8382,592,26,54,164,244,1.4344262295081966,0.04345258210808031,651,"You can get a second opinion if you want, but you really need to have that thing removed."
7536,593,22,55,151,228,1.4342105263157894,0.043959041874487334,651,Has anything changed since last year's physical?
402,594,30,42,163,235,1.4340425531914893,0.04626977582043121,651,This is a more naturopathic approach for those with severe constipation.
6143,594,24,54,157,235,1.4340425531914893,0.04384826860499421,651,Any other symptoms besides the tightness in your chest?
789,596,24,44,144,212,1.4339622641509433,0.047299294694477606,651,"Frankly, I'm more concerned about your cholesterol​."
591,597,22,54,150,226,1.4336283185840708,0.04423598662691563,651,You really need to find time to unwind
1244,598,24,53,156,233,1.4334763948497855,0.04411892205130344,651,"In your case, paying out of pocket will be a challenge."
1418,599,30,54,179,263,1.4334600760456273,0.042521181100404225,651,"So, what brings you in to see us today?"
4668,600,24,46,147,217,1.433179723502304,0.046484426271502344,651,Take two rodents and call me in the morning.
278,601,27,56,171,254,1.4330708661417322,0.04255286952130681,651,You have coilitis.
8099,602,25,50,156,231,1.432900432900433,0.04481594555829175,651,So no frog in the throat anymore
8858,603,25,53,160,238,1.4327731092436975,0.04384305432497806,651,"Lets start with the good news, your ankles look great"
5217,603,25,53,160,238,1.4327731092436975,0.04384305432497806,651,"So tell me, Frank, how long have you been experiencing erreptile disfunction?"
3865,605,30,46,169,245,1.4326530612244899,0.04482947421377787,651,I'll prescribe an antiboatic.
3138,605,24,58,163,245,1.4326530612244899,0.04253170260130683,651,I guess we can skip the gown.
7159,607,24,48,150,222,1.4324324324324325,0.045704680593857225,651,"You may have a large snake wrapped around you, but we'll need to run some tests."
704,608,20,59,150,229,1.4323144104803494,0.042924410818297926,651,"Your labs came back negative, so you're free to go."
7237,608,25,49,155,229,1.4323144104803494,0.04510024275059583,651,We bought our medical equipment from the wrong Amazon.
8504,608,31,37,161,229,1.4323144104803494,0.047580081112165655,651,"After I was fired, I elected to be covered by COBRA"
1141,611,18,69,156,243,1.4320987654320987,0.04032602519241679,651,My diagnosis is that you have 3-6 minutes to live.
2363,612,31,46,173,250,1.432,0.044513253294670596,651,"As a veterinarian, the snake will be my first priority."
758,613,30,51,176,257,1.4319066147859922,0.04324829864381012,651,Your comfort snake is anxious. Try getting him a dog.
1895,614,24,50,153,227,1.4317180616740088,0.044957763924955436,651,I'm prescribing a muscle relaxant for the Boa
2770,615,30,44,167,241,1.4315352697095436,0.04538149569244031,651,You're not the first man to come in here with Ereptile Disfunction.
2010,616,23,54,155,232,1.4310344827586208,0.04381778580458426,651,Any other symptoms beyond shortness of breath?
9014,617,29,48,169,246,1.4308943089430894,0.044308600592639545,651,"Unfortunately, COBRA doesn't cover Boas."
7166,618,25,52,160,237,1.4303797468354431,0.04396278686765506,651,"Yes, tightness in the chest is a symptom of a heart attack, but it could be something else entirely."
1829,619,26,56,169,251,1.4302788844621515,0.04253517512784889,651,"Unfortunately, your insurance company lists this as a pre-existing condition."
4348,620,26,62,177,265,1.430188679245283,0.04088753952726945,651,Well I'm glad we could squeeze you in.
1912,621,23,49,149,221,1.4298642533936652,0.0453885134361739,651,Perhaps we might consider a more appropriate support animal for you.
2816,622,24,56,162,242,1.4297520661157024,0.042893883111630345,651,Sigh* What ELSE did the internet say you should do?
6421,623,26,55,168,249,1.429718875502008,0.042781133961164036,651,"Sorry, but your comfort animal will have to stay in the waiting room."
6892,623,26,55,168,249,1.429718875502008,0.042781133961164036,651,"There are several causes of cold feet.  It could be 
a circulation problem."
8570,625,26,58,172,256,1.4296875,0.041923420023252854,651,"I see you're covered by Aetna and Petplan."""
8343,626,29,58,183,270,1.4296296296296296,0.04134642951229808,651,"Any chest pain, tightness, or difficulty breathing?"
3983,627,19,59,148,226,1.4292035398230087,0.04285009810162564,651,It's just a little something to help you unwind.
1332,627,19,59,148,226,1.4292035398230087,0.04285009810162564,651,"You can put your clothes back on,Mr. Matthews. I think we've identified the problem."
4254,627,19,59,148,226,1.4292035398230087,0.04285009810162564,651,"For once, I don't think the problem is your anxiety."
5434,630,34,38,175,247,1.4291497975708503,0.045988859226215185,651,You have what used to be called “the grippe”.
4759,630,30,46,171,247,1.4291497975708503,0.04453441295546559,651,I don't see how medicinal marijuana is going to improve this specific situation....
6569,632,33,43,178,254,1.4291338582677164,0.04466920620260479,651,Yes Doctor I am still insured under Cobra
4457,633,26,53,166,245,1.4285714285714286,0.0432843655349805,651,I'm also going to have to ask you to remove your boa.
5845,633,24,69,180,273,1.4285714285714286,0.03932902942072073,651,I'm hearing a slight rattle.
4403,633,23,56,159,238,1.4285714285714286,0.042998148822288175,651,"I can't up your dose anymore. 
THIS IS our strongest emotional support pet."
3723,633,22,55,154,231,1.4285714285714286,0.043507827864393195,651,"It's as effective as gastric bypass, but less invasive."
3689,633,29,44,165,238,1.4285714285714286,0.045404670765481984,651,And where is Eve?
2997,633,27,57,175,259,1.4285714285714286,0.04192056754443581,651,This treatment has cured hiccups in 94.7% of those surviving the procedure.
1595,633,18,48,130,196,1.4285714285714286,0.046880723093849545,651,"Feed it two mice, and call me in the morning."
4738,640,31,54,186,271,1.4280442804428044,0.041881873664527274,651,Voter suppression. Florida style.
317,641,28,54,175,257,1.4280155642023347,0.04251456890399624,651,Well.....you might want to consider a different therapy pet.
4755,641,25,60,172,257,1.4280155642023347,0.04142815553507263,651,I'm going to give you something to help you unwind.
6583,643,26,52,165,243,1.4279835390946503,0.04354181987611381,651,I'd say you have a snake wrapped around your body. That will be 1000 dollars.
8303,643,25,54,164,243,1.4279835390946503,0.04314950686976276,651,Have you traveled to any foreign countries in the past month?
8913,645,23,49,150,222,1.427927927927928,0.04522506931198125,651,Have you traveled outside the country in the last 21 days?
4992,646,23,75,185,283,1.4275618374558303,0.03800414694703854,651,I’m going to send you over to the zoo for a second opinion.
2241,647,26,60,176,262,1.4274809160305344,0.04120848148122447,651,Not a serious problem - probably  doesn’t know you from Adam
8309,647,29,54,179,262,1.4274809160305344,0.042259689236153065,651,"How would you describe your pain? With 1 being no pain, and 10 being crushed by a boa constrictor."
8461,647,25,62,175,262,1.4274809160305344,0.040852068285532575,651,Any pets in the home?
7712,650,26,51,164,241,1.4273858921161826,0.043803292598417046,651,Was there a woman and an apple involved?
5878,651,29,56,182,267,1.4269662921348314,0.04167068089642835,651,It's a prescription for a mongoose.
59,652,25,55,166,246,1.4268292682926829,0.04275693410963988,651,"Before I get to the diagnosis, I have to ask how you got undressed."
152,652,24,57,165,246,1.4268292682926829,0.04236710291188961,651,Have you recently traveled out of the country?
8511,654,31,42,171,244,1.4262295081967213,0.04529992756082291,651,I'm sorry. Your COBRA insurance has expired.
4063,654,19,66,159,244,1.4262295081967213,0.04058703088371073,651,"No, I don't think it's just a panic attack."
3726,654,28,48,168,244,1.4262295081967213,0.04416887305275826,651,I see you selected the COBRA option on your insurance plan.
2782,654,30,44,170,244,1.4262295081967213,0.04492607342728823,651,"Well, I think his tenure as an emotional support animal is pretty much over."
3896,654,21,62,161,244,1.4262295081967213,0.04140977907208282,651,"I guess ""cough twice"" is out of the question."
5275,659,19,63,155,237,1.4261603375527425,0.04141998908413723,651,It's grown a lot since your last visit.
1181,660,26,66,185,277,1.4259927797833936,0.03957420854971203,651,I can only say that your wife Eve told a different story.
5162,661,20,52,144,216,1.4259259259259258,0.044705663588723944,651,This will help you unwind.
7268,661,32,51,187,270,1.4259259259259258,0.04231015190064213,651,"So, why have you come to see me today?"
8423,661,21,50,145,216,1.4259259259259258,0.04518476158003102,651,"Well, he has malnutrition, but that should resolve itself soon."
2305,664,31,47,178,256,1.42578125,0.04368690193389899,651,And how frequent are the constrictions?
4079,665,27,52,170,249,1.4257028112449799,0.04313086788608982,651,"So, a tightening in your chest.  Any other symptoms?"
8512,665,20,66,163,249,1.4257028112449799,0.040417303964701834,651,Meditation could help you both unwind.
435,667,22,56,157,235,1.425531914893617,0.0429514010225799,651,"I think I see what the problem is, but your insurance requires that I get a second opinion."
5946,668,21,55,152,228,1.4254385964912282,0.04345492998714448,651,I’m sorry I couldn’t squeeze you in earlier.
7663,668,19,59,150,228,1.4254385964912282,0.04255637690007335,651,I'm going to prescribe some Xanax for your friend. That should help her unwind.
8714,670,20,51,143,214,1.425233644859813,0.04500004590448982,651,I hear it’s going around.
853,671,18,52,137,207,1.4251207729468598,0.04506231633598084,651,"Ah, type B, O, and A."
4925,672,27,51,169,247,1.4251012145748987,0.04338397542962303,651,"So, what do you do to unwind?"
5795,673,25,43,151,219,1.4246575342465753,0.04656228023837304,651,And...it might be a good idea for Eve to come in also.
7806,674,22,63,167,252,1.4246031746031746,0.040853371725814144,651,Other than that you're pretty healthy.
5406,674,24,59,169,252,1.4246031746031746,0.0416201524316209,651,And you said you hear hissing in which ear?
1343,676,28,48,169,245,1.4244897959183673,0.04402261144277696,651,Did you eat the apple?
857,677,26,49,163,238,1.4243697478991597,0.04418829388129687,651,What can I do for you?
156,678,25,65,181,271,1.4243542435424354,0.039850626861950594,651,"The good news is, there's nothing medically wrong with you."
2175,679,24,61,172,257,1.424124513618677,0.04103225382349584,651,"Look, I'll do some tests but I'm pretty sure you've got a snake wrapped around your neck."
7094,680,22,51,151,224,1.4241071428571428,0.04445327297635807,651,"Unfortunately, it’s an endangered species and we will have to let your condition run it’s course."
8599,681,22,62,166,250,1.424,0.04108097596632024,651,"You’re okay, but it sounds like he might have a frog in his throat."
1663,682,21,50,146,217,1.423963133640553,0.04501886343579734,651,"First, tell me how you were able to remove your clothes!"
2756,682,23,46,148,217,1.423963133640553,0.04595690220268534,651,"And how do you feel about Eve now, Adam?"
409,682,22,48,147,217,1.423963133640553,0.04549030075256788,651,This should help you unwind.
304,685,27,63,186,276,1.423913043478261,0.0399937699221131,651,The bad news is she'll probably swallow you whole. The good news is you'll be part of the marvelous cycle of life.
7604,686,26,51,166,243,1.4238683127572016,0.04351288095338185,651,"Don't tell me, you bought it on Amazon."
6747,687,23,43,144,210,1.4238095238095239,0.04707942136135528,651,This is the only case where prescribing snake oil actually works.
808,688,24,52,160,236,1.423728813559322,0.04364131053999795,651,I'm prescribing a flute and music lessons.
6758,688,25,50,161,236,1.423728813559322,0.04405253695684774,651,It's time for you to unwind.
746,690,20,57,152,229,1.4235807860262009,0.042860063651631614,651,I’m going to prescribe you adder-all
7213,691,26,42,154,222,1.4234234234234233,0.04652495375563536,651,Does it rattle when you pee?
1014,692,14,63,138,215,1.4232558139534883,0.04182422542018082,651,"Yes, it’s clearly something that’s going around."
2052,693,28,46,167,241,1.4232365145228216,0.04455672940783893,651,"I’m sorry but it looks like your insurance plan covers boa constrictors, anacondas, and other members of the boa family, but what you have there is a reticulated python."
252,694,25,60,175,260,1.4230769230769231,0.04104760079541041,651,"I can prescribe something for your high blood pressure, or, you can get rid of the snake."
3878,695,24,59,170,253,1.4229249011857708,0.0414892771240152,651,"You seem tense. Before we begin this examination, I want you to relax, unwind and tell me what's eating you."
4035,696,24,48,155,227,1.422907488986784,0.04489468942119959,651,"I am referring you to a specialist, don’t worry, he’s a real charmer."
1937,697,31,42,173,246,1.4227642276422765,0.044997376603508756,651,Looks like a serious case of full-monty python
8437,698,25,51,163,239,1.4225941422594142,0.04363780230911637,651,I think we know what this is but I'll need to run a few more tests to be sure.
3687,698,29,43,167,239,1.4225941422594142,0.04522056856387863,651,"On your intake form you checked, ""difficulty breathing;"" Are you a smoker?"
4284,698,18,65,156,239,1.4225941422594142,0.04072019445367865,651,We don't accept your coverage. Don't you have a COBRA?
5241,698,25,51,163,239,1.4225941422594142,0.04363780230911637,651,"With your insurance, we can get a snake charmer in next Tuesday."
7273,702,23,52,157,232,1.4224137931034482,0.04375533325901732,651,"Unfortunately, your plan does not cover pre-existing constrictors."
6721,703,20,66,165,251,1.4223107569721116,0.040166002107182665,651,I know you don't like taking medication but I'm going to give you something to help you unwind.
9221,704,23,68,179,270,1.4222222222222223,0.03924572231345142,651,"Any known allergy to mongooses, Mr. Jones?"
5715,705,25,61,177,263,1.4220532319391634,0.04070178127795175,651,Your insurance company says this is a preexisting condition.
3666,706,20,49,142,211,1.4218009478672986,0.045432229380494224,651,I'm referring you to Dr. Mortenson.  She's quite the charmer.
267,707,25,47,158,230,1.4217391304347826,0.04488055669907487,651,Here is a prescription for a big mongoose.
8043,707,22,53,155,230,1.4217391304347826,0.043592975683160125,651,I know the feeling.  I have student loans.
5304,707,19,59,152,230,1.4217391304347826,0.042266188475024634,651,I’m going to write a prescription for a little something that will help you unwind.
8328,710,22,58,162,242,1.421487603305785,0.042026171720430994,651,The good news is the tightness in your chest has nothing to do with your heart.
3077,711,19,61,155,235,1.421276595744681,0.04162843134297812,651,I guess we can eliminate family history.
5863,712,31,45,178,254,1.421259842519685,0.043913968884597955,651,This is the one condition where snake oil really does work.
5664,713,24,56,167,247,1.4210526315789473,0.04220060959877675,651,Do you know when the boa last ate?
2507,714,24,55,166,245,1.420408163265306,0.04244492607457303,651,There’s definitely something going around.
6559,715,26,64,186,276,1.4202898550724639,0.039637085017905346,651,"On the bright side, this delays your prostate exam."
255,716,31,46,180,257,1.4202334630350195,0.04352093765897452,651,"I'm sorry, but we cannot not allow your emotional support animal to be with you during the colonoscopy."
360,717,25,50,163,238,1.4201680672268908,0.043753765172432506,651,I'll prescribe you an antiboatic.
3247,717,25,50,163,238,1.4201680672268908,0.043753765172432506,651,"We think our new Stress Test is far more affordable and accurate but yes, we’ve had complaints.”"
3922,719,22,53,156,231,1.41991341991342,0.04344223201519292,651,Im gonna prescribe a muscle-relaxant. That'll straighten him out.
3581,720,23,56,164,243,1.4197530864197532,0.04229280287635639,651,"""Shortness of breath can be caused by many things."
7920,720,25,52,166,243,1.4197530864197532,0.043089458631767594,651,"Actually, you are fine...except for the snake."
9085,722,23,69,182,274,1.4197080291970803,0.03882129674501987,651,"Don't worry, it will shed in a few weeks."
461,723,18,71,166,255,1.419607843137255,0.03891812381187184,651,Your insurance covers python prevention but not python removal.
5666,724,27,58,182,267,1.4194756554307115,0.040936546393320616,651,"If possible, I'd like the $20 co-pay now."
4075,725,29,46,173,248,1.4193548387096775,0.043962043147032094,651,Of course you’re constipated... your asp is too tight...
5890,725,32,40,176,248,1.4193548387096775,0.04506229938954779,651,And your health insurance is a ... Cobra plan?
7391,725,26,39,152,217,1.4193548387096775,0.04729378699926053,651,"So, do you want to live free or die?"
3707,728,25,59,176,260,1.4192307692307693,0.04101906627348328,651,"The good news is, your scoliosis has cleared up."
5679,728,27,55,178,260,1.4192307692307693,0.04173684052906344,651,A compression bandage would have worked just as well.
4544,730,22,52,155,229,1.4192139737991267,0.04371023786906112,651,"It’s nothing to be embarrassed about, John. A lot of men have problems with their snakes."
4985,731,20,63,163,246,1.41869918699187,0.0407076086665489,651,Your legs look healthy.
5694,731,24,55,167,246,1.41869918699187,0.04230656479302769,651,"Your blood pressure is quite elevated Mr. Jones, so I'm writing you a prescription for that. I wouldn't worry about the snake, it seems quite healthy."
7150,731,34,35,177,246,1.41869918699187,0.046061757214429615,651,I don't care if it makes you calm. I'm not signing this airline form.
2248,734,25,58,175,258,1.4186046511627908,0.04124394764230146,651,There is no good news. You have become his therapy animal.
2283,734,20,50,145,215,1.4186046511627908,0.04479555368537514,651,I should've gone with the leeches.
1039,736,18,59,150,227,1.4185022026431717,0.04217265488840385,651,The good thing about this condition is that it’s easily detectable.
2308,736,28,39,160,227,1.4185022026431717,0.046565879883544076,651,Sorry you're not covered under COBRA.
6450,738,23,54,162,239,1.4184100418410042,0.04279184020497421,651,Shortness of breath is quite common with your condition
7007,738,26,48,165,239,1.4184100418410042,0.044007080240357245,651,So let me get this right. Your boyfriend said he had a fantasy of  you showing up at his doorstep wearing nothing but a boa?
4622,740,25,65,185,275,1.4181818181818182,0.03938968551037672,651,All your tests came back normal.
5822,741,27,43,162,232,1.418103448275862,0.045396358126968676,651,Anything else besides shortness of breath?
8434,742,25,52,167,244,1.4180327868852458,0.04294696742917354,651,I'm afraid your H.R. Department doesn't quite understand the COBRA concept.
4860,743,21,65,170,256,1.41796875,0.03996730889719833,651,Will you need a note for work?
8390,744,25,62,181,268,1.4179104477611941,0.04012286698881337,651,I'm prescribing a mongoose for your symptoms.
8818,745,28,48,173,249,1.4176706827309238,0.0434463648722332,651,"I'm sorry sir, but this procedure isn't covered by your COBRA plan."
6925,746,27,55,179,261,1.417624521072797,0.041607637621533085,651,First a monkey on your back and now this?
3781,747,23,55,164,242,1.4173553719008265,0.042399625677243015,651,It's probably just pressure - you should go somewhere and unwind.
1337,748,23,60,171,254,1.4173228346456692,0.040950507510293215,651,It's something that's going around.
7949,749,23,42,146,211,1.4170616113744077,0.046860009469196856,651,"Unfortunately, Mr. Haverford, that’s a python. Your healthcare provider only covers boas."
820,750,27,44,164,235,1.4170212765957446,0.04495495207240554,651,You don't have COBRA.
4054,751,26,51,170,247,1.417004048582996,0.04294248317376991,651,What’s the nature of your visit?
1263,752,25,58,176,259,1.416988416988417,0.04111617451477079,651,"Let's see, trouble breathing, tightness in the chest. Is that all?"
2936,752,26,56,177,259,1.416988416988417,0.04147854950715476,651,"As your vet, I must say everything looks fine."
5422,754,25,50,165,240,1.4166666666666667,0.04345867507029688,651,Shortness of breath. Tightness in the stomach. Anything else?
275,754,19,47,138,204,1.4166666666666667,0.04598832928409393,651,I say we just keep an eye on it and see if it gets any worse.
407,754,25,60,179,264,1.4166666666666667,0.04054990329954736,651,Your tests came back normal. It’s probably just anxiety.
2808,754,28,44,168,240,1.4166666666666667,0.044645928698212725,651,Take two field mice and call me in the morning.
1138,754,21,63,168,252,1.4166666666666667,0.04040246837860963,651,This should help you both unwind
7820,754,29,47,176,252,1.4166666666666667,0.0434202243124075,651,Looks like I'm not the only one who squeezed you in today.
7789,760,28,51,178,257,1.416342412451362,0.04243102126219678,651,"And finally, would you say you feel safe at home?"
8490,761,24,49,160,233,1.4163090128755365,0.04399276989799495,651,"Unfortunately, that snake has you better covered than your health insurance."
381,762,23,46,152,221,1.416289592760181,0.0452838203144564,651,"Sounds like a panic attack, but let me take a look at you."
2949,763,21,67,174,262,1.416030534351145,0.03930694967215218,651,Definitely come see me if you notice it getting bigger.
2842,764,32,40,178,250,1.416,0.044763725991684766,651,I see your COBRA payments have kicked in.
2579,765,17,65,156,238,1.415966386554622,0.04034636404222917,651,I’m prescribing an anti strangulant.
8417,765,24,51,163,238,1.415966386554622,0.0433131577868583,651,"So, what happened to Eve?"
573,767,26,54,175,255,1.415686274509804,0.04194169013456841,651,"Chuck, what you've got is going around."
7868,767,30,46,179,255,1.415686274509804,0.04338916159436933,651,Taking patient's blood pressure is Larry's favorite part of the job.
3178,769,24,53,166,243,1.4156378600823045,0.04266019364807274,651,I’ve seen bigger.
7684,769,23,55,165,243,1.4156378600823045,0.04225969695905107,651,You've got what's going around
3490,771,25,46,160,231,1.4155844155844155,0.0446884979637058,651,It’s going to be tricky to find you an in-network mongoose.
5011,771,24,48,159,231,1.4155844155844155,0.04426531751097865,651,"We think we know the problem, but we'll check you for Lyme disease just in case."
6342,771,24,48,159,231,1.4155844155844155,0.04426531751097865,651,It says here that you've been under a lot of pressure lately...
6665,774,30,53,189,272,1.4154411764705883,0.04135339733396353,651,Did't you also have a Poodle
4575,775,22,64,174,260,1.4153846153846155,0.039887438434347965,651,One mouse a day at 4 P.M.
7856,775,32,44,184,260,1.4153846153846155,0.04345121450378799,651,COBRA plans aren't what they used to be.
3653,777,22,59,167,248,1.4153225806451613,0.041248191690954686,651,It seems the monkey on your back was eaten by something else.
2659,778,24,50,162,236,1.4152542372881356,0.04357473336844776,651,The snake actually covers you better than your health insurance does.
3932,778,24,50,162,236,1.4152542372881356,0.04357473336844776,651,"I'm sorry it took so long for you to be seen, but for future reference ""There's a boa around my neck"" has multiple meanings."
114,780,31,38,172,241,1.4149377593360997,0.04564472523384722,651,And is that when you told Eve it was her fault?
8126,781,26,43,160,229,1.4148471615720524,0.045394142809220196,651,We found no one liked the blood pressure cuff.
5000,782,24,42,151,217,1.4147465437788018,0.04634462316911087,651,"Let's see . . . non-smoker, no history of major illness, no surgeries . . . so, what brings you in today?"
2303,783,24,54,168,246,1.4146341463414633,0.04227387007136753,651,Maybe you're not as charming as you think.
1020,784,25,59,179,263,1.414448669201521,0.04064344300044046,651,Let's postpone your colonoscopy.
47,785,24,56,171,251,1.4143426294820718,0.04166043084928001,651,Instagram or Snapchat?
4387,785,24,56,171,251,1.4143426294820718,0.04166043084928001,651,So I guess we should reschedule that colonoscopy?
1586,787,23,41,146,210,1.4142857142857144,0.047001001733807564,651,"I'm sorry, your insurance only covers bites, not constrictions."
9104,788,20,59,160,239,1.4142259414225942,0.04150563531707216,651,"So, you say it is more of a hiss rather than a ringing in your ears?"
4467,789,19,56,152,227,1.4140969162995596,0.04259406774869755,651,I'm writing you a prescription to unwind.
6790,789,23,48,156,227,1.4140969162995596,0.044386866829925424,651,I still think gastric bypass was the better option...
4933,791,24,58,174,256,1.4140625,0.041069751575646206,651,I still don't quite get how it ate your pants.
5322,791,27,52,177,256,1.4140625,0.04217388124409676,651,"Sorry, but you only get COBRA coverage if you've lost your job."
720,793,19,51,145,215,1.413953488372093,0.04426661913392044,651,"For starters, you've become too attached to your pet."
9233,794,24,53,167,244,1.4139344262295082,0.04251913287497981,651,"No sir, I don’t think it’s ringworm."
7622,795,25,63,185,273,1.413919413919414,0.03956288348249261,651,Anything else?
1727,796,29,38,165,232,1.4137931034482758,0.046177165464469434,651,"Current address still: Eden, Garden of? Emergency contact: Eve?"
5208,797,23,57,169,249,1.4136546184738956,0.04150803609098681,651,Any recent trips overseas?
858,798,23,52,162,237,1.4135021097046414,0.04301216530606667,651,"I think you'll find that when we get this removed, a colonoscopy won't seem so bad."
4547,799,23,59,172,254,1.4133858267716535,0.04091832930032722,651,"Some airlines have tightened their rules lately, but this letter might help."
5702,799,30,45,179,254,1.4133858267716535,0.04349905534556107,651,"And you're Monty, I take it?"
27,801,24,40,149,213,1.4131455399061033,0.04697492383225843,651,Take two mice and call me in the morning.
7147,802,27,41,162,230,1.4130434782608696,0.045650139638421204,651,I'm afraid my recommendation will depend on which one of you has better insurance.
1961,803,19,64,164,247,1.4129554655870444,0.04013541118761746,651,Let's not jump to any conclusions until we can run some tests.
1052,804,22,53,160,235,1.4127659574468086,0.04284858375488306,651,Yes we can remove it. No it's not called a Hissterectomy.
2590,804,19,59,157,235,1.4127659574468086,0.0415558706128341,651,"Kick once for yes, two for no."
7743,804,22,53,160,235,1.4127659574468086,0.04284858375488306,651,"No, I'm sure you won't need another appointment."
4000,807,19,68,170,257,1.4124513618677044,0.0390410019913044,651,We all agree. It's an Anaconda. Was there anything else?
1121,807,24,58,175,257,1.4124513618677044,0.04094134829129543,651,A vet would've been a lot less expensive.
6348,809,32,30,166,228,1.412280701754386,0.04799995774141229,651,"Ah, I see you’ve already met Dr. Boa. He’ll be preforming your colonoscopy today."
2849,810,20,61,164,245,1.4122448979591837,0.040769461217738105,651,So what’s the reason for the visit?
7380,810,22,57,166,245,1.4122448979591837,0.041581979013637305,651,Any family history of this sort of thing?
122,812,25,46,162,233,1.4120171673819744,0.044375518250622074,651,"The good news is, it's not asthma."
2246,812,24,48,161,233,1.4120171673819744,0.043956659927289095,651,"You think you feel squeezed now, wait 'til you see my bill."
2466,812,21,54,158,233,1.4120171673819744,0.042675425572798825,651,"The good news is it’s temporary, the bad news is I’m talking to the snake."
3049,812,25,46,162,233,1.4120171673819744,0.044375518250622074,651,Who sold you this COBRA plan?
3437,816,25,53,172,250,1.412,0.04214413973562902,651,So what seems to be the trouble?
9131,817,21,56,161,238,1.411764705882353,0.042030987218105526,651,"For insurance purposes, I'm going to call this a major constriction."
8994,817,28,35,158,221,1.411764705882353,0.047463296730226825,651,Looks like this time he charmed the pants off of you.
854,817,27,44,167,238,1.411764705882353,0.0444898551549308,651,"Okay, lets try one blink for yes and twice for no!"
7620,820,25,57,178,260,1.4115384615384616,0.04095775432169226,651,"Look, I’m a hepatologists, and your liver looks in really good shape. You need a herpetologist for that other thing."
6133,821,27,62,193,282,1.4113475177304964,0.03928317212775013,651,"So, we’ll skip the rectal exam today."
2470,822,15,65,151,231,1.4112554112554112,0.0402165079580774,651,When's the last time either of you ate?
7303,822,28,39,164,231,1.4112554112554112,0.04589916359912361,651,"Well, your blood pressure is high, but that won’t matter much longer."
8493,822,19,57,155,231,1.4112554112554112,0.042046897340465496,651,"Otherwise, how was your trip to the Everglades?"
2028,825,26,52,175,253,1.4110671936758894,0.04214603074935582,651,"Let me guess, it's after the frog in your throat."
9193,825,20,64,169,253,1.4110671936758894,0.039850600100923436,651,"Your relationship isn’t toxic, but it is suffocating."
1598,827,19,59,158,236,1.4110169491525424,0.04141635846071542,651,The good news? The tightness in your chest has nothing to with your heart.”
6574,827,21,55,160,236,1.4110169491525424,0.042278112558607354,651,Sorry...undress means removing your boa too...
6941,829,17,56,146,219,1.4109589041095891,0.0426917060459681,651,"Other than trouble taking a deep breath, no complaints?"
6188,830,26,61,188,275,1.410909090909091,0.03966804405322079,651,"To lower your blood pressure, I’m prescribing a live goat."
8731,831,21,57,163,241,1.4107883817427387,0.04164908692922143,651,It’s not terminal. For the snake.
7670,832,31,30,163,224,1.4107142857142858,0.04823400431947879,651,"That's not what I meant when I said you should have 
COBRA  coverage.""


Joan Black, Easton Connecticu"
8562,832,22,48,154,224,1.4107142857142858,0.04434155207699306,651,"The good news is, you don't have worms."
653,834,21,66,176,263,1.4106463878326996,0.03915674848893563,651,And is it causing you any discomfort?
1258,835,26,49,171,246,1.410569105691057,0.04301799476176723,651,"Well, all our tests are negative. But tell me again why you brought this man with you?"
3852,835,27,47,172,246,1.410569105691057,0.04340198012340996,651,"So Adam, What seems to be the problem?"
5315,835,20,61,165,246,1.410569105691057,0.04063796059679653,651,"I've seen dozens of patients come in with monkeys on their backs, but this is a first."
2509,838,22,50,157,229,1.4104803493449782,0.043635550558398066,651,So he's having trouble swallowing?
8480,839,26,58,184,268,1.4104477611940298,0.0404103598201088,651,You need to find a different support animal.
1767,840,27,49,175,251,1.4103585657370519,0.042759974532001636,651,"So, for your first drag queen appearance, when they said, “Wear a boa” they meant a feathery, long scarf."
8649,840,20,63,168,251,1.4103585657370519,0.04006629321831898,651,"I'm sorry to tell you, Mr. Johnson, but we can't do anything for you without a referral from your vet."
6850,840,26,51,174,251,1.4103585657370519,0.04238564511738932,651,"That reminds me, Mr. Johnson, you're due for a colonoscopy."
805,840,27,49,175,251,1.4103585657370519,0.042759974532001636,651,Have you been under a lot of pressure lately?
6312,840,25,53,173,251,1.4103585657370519,0.0420079802187288,651,You may experience some loss of bladder control.
1168,845,24,48,162,234,1.4102564102564104,0.04380381023014677,651,And the prescription for Xanax will help you unwind.
3439,846,30,45,181,256,1.41015625,0.04321869151669728,651,I’m going to write a prescription for Viagra which should straighten this whole thing out.
39,847,17,55,145,217,1.4101382488479262,0.04295814572270986,651,"We could play the good news / bad news game, but you really don't have a lot of time for that."
1820,848,21,56,162,239,1.4100418410041842,0.04189019997320854,651,"Your chest feels tight? Well, that could be a lot of things."
4963,849,17,59,151,227,1.4096916299559472,0.04162751674513383,651,Sorry for the wait...  I’m having trouble finding the right medical billing code.
8455,849,23,47,157,227,1.4096916299559472,0.04434815847091898,651,Tightness in the chest. Anything else?
5990,851,18,50,142,210,1.4095238095238096,0.04446613841969269,651,We received the test results and I think I finally know what the problem is
2054,852,23,49,160,232,1.4094827586206897,0.04364766899862102,651,I am sorry but there just isn't anything we can do for the common coiled.
2572,852,20,55,157,232,1.4094827586206897,0.04234574359371258,651,It says here you’ve been under a lot of pressure lately.
3008,854,22,44,149,215,1.4093023255813955,0.045673828097839604,651,"The problem is that seems to be a python and, the thing of it is, we only accept COBRA."
6817,855,23,51,163,237,1.409282700421941,0.042975318032636926,651,This does seem to be going around.
5141,856,24,58,177,259,1.4092664092664093,0.04068672148974893,651,Sorry but your insurance doesn't cover pre-constricted conditions
6017,857,17,56,147,220,1.4090909090909092,0.04253824450265608,651,"No, I will not certify him as an emotional support snake"""
7152,857,26,47,169,242,1.4090909090909092,0.04352762132779779,651,Any tightening in the chest?
2240,859,25,51,171,247,1.408906882591093,0.04249013246320901,651,Let's start with why you don't have any clothes on.
6948,859,21,59,167,247,1.408906882591093,0.040911491308681866,651,Prunes will do the job and are less restrictive.
8007,859,30,41,176,247,1.408906882591093,0.0443845457484012,651,You just left your job.  I guess it's safe to assume you have COBRA coverage.
8184,859,24,53,170,247,1.408906882591093,0.04210102193333167,651,I am going to give you something to unwind.
8238,859,25,51,171,247,1.408906882591093,0.04249013246320901,651,So how is COBRA working out for you?
6441,864,23,66,185,274,1.4087591240875912,0.03873259099622011,651,"Ah, I see you are being prepped for your colonoscopy."
6566,865,26,51,175,252,1.4087301587301588,0.0422485070069685,651,Take two a day for you reptile disfunction.
3669,865,25,53,174,252,1.4087301587301588,0.0418726257928251,651,I’m prescribing Valium for you and cyanide for your friend. Be careful not to mix them up.
2930,867,22,52,161,235,1.4085106382978723,0.04281064146248699,651,Trust me he's not covered under your COBRA plan.
5985,867,30,36,169,235,1.4085106382978723,0.0460837608656158,651,I see you have been spending time in the White House.....
1478,869,27,62,195,284,1.408450704225352,0.03905959800306566,651,The X-rays show you have a human stuck in your coils.
4288,870,22,54,164,240,1.4083333333333334,0.042165769473534,651,"If I were you, Mr. Morris, I'd choose a different emotional support animal."
5329,870,24,50,166,240,1.4083333333333334,0.042984731269006586,651,We need to do a hisssterectomy.
874,872,22,45,151,218,1.408256880733945,0.04520399550326543,651,"Yes, a lot of it's going around."
7201,873,21,58,166,245,1.4081632653061225,0.041141229449446946,651,"Take these twice a day with food. Also, you may want to do something about the snake."
2326,873,18,64,163,245,1.4081632653061225,0.03990279118749912,651,You might have picked something up while visiting Brazil.
9025,875,26,39,158,223,1.4080717488789238,0.046243239250106864,651,You've certainly gone to great lengths to avoid your prostate exam.
3988,875,20,51,152,223,1.4080717488789238,0.043543568010828905,651,There’s no magic pill. You just need to unwind.
5153,877,21,60,169,250,1.408,0.04055518328853003,651,"So, Adam, I'm guessing you ate the apple."
5261,877,30,42,178,250,1.408,0.043975897012707876,651,You also have chlamydia.
457,879,26,52,177,255,1.407843137254902,0.0418766787782623,651,"Can you still see this ""snake""?"
3562,880,23,49,161,233,1.407725321888412,0.04349545539494989,651,So this happened right after she handed you the apple?
3789,880,27,41,165,233,1.407725321888412,0.04516469098981943,651,I'm going to have to ask you to turn your cellphone off.
7393,882,23,60,177,260,1.4076923076923078,0.04019270025657261,651,"We’ll know more after your tests come back,"
1569,883,20,57,161,238,1.4075630252100841,0.04156854095820879,651,So I'm going to put down 'emotional support animal'.
2517,883,25,47,166,238,1.4075630252100841,0.04364893700549219,651,Lab test results say it's a snake.
299,885,23,53,167,243,1.4074074074074074,0.04218843126647027,651,"You've got a snake, I'm left-handed; we all have our problems."
2285,885,21,57,165,243,1.4074074074074074,0.04137443005873572,651,I'm afraid our options are somewhat constricted.
5026,885,22,55,166,243,1.4074074074074074,0.041783412949464166,651,"Other than that, how was the trip to the Amazon?"
6710,885,26,47,170,243,1.4074074074074074,0.04338080379368729,651,"Let's go with ""Shortness of breath, other."""
1017,889,25,53,175,253,1.407114624505929,0.041738070509197596,651,I should probably skip asking you to take a deep breath.
268,890,28,49,181,258,1.4069767441860466,0.04223341372881609,651,You should have gone with the non-binding agreement.
8406,891,23,48,160,231,1.406926406926407,0.04376178129107289,651,It's a Catch-22. I can't treat you until you sign a waiver.
7669,891,18,58,155,231,1.406926406926407,0.04155569662808902,651,Give it three mice every four hours and call me in the morning.
4937,893,23,61,179,263,1.4068441064638784,0.03985790230081894,651,"Yes, that's probably a python, but I'd like to do CAT scan and a few other expensive tests to be sure."
1777,894,20,47,147,214,1.4065420560747663,0.04483571998644587,651,Any tightness in your chest?
2635,895,19,62,165,246,1.4065040650406504,0.040189858344120935,651,"First, the good news. Your chest pain isn't a heart attack."
8378,896,30,29,160,219,1.4063926940639269,0.04861429712944992,651,So you’re still using your Cobra insurance?
5788,897,22,58,171,251,1.406374501992032,0.04081828369266089,651,"Let's try a different comfort animal """
3807,898,23,69,191,283,1.4063604240282686,0.03783951738551362,651,Which one of you am I seeing first?
6024,899,19,66,171,256,1.40625,0.03909006380444133,651,And have you travelled to any tropical countries in the past 30 days?
6763,900,22,62,177,261,1.4061302681992338,0.03969939201872082,651,"If it gets any bigger, let us know."
5142,901,17,59,153,229,1.4061135371179039,0.041340315684720366,651,I'm a little concerned about your blood pressure.
1437,902,24,47,163,234,1.4059829059829059,0.04376532183749885,651,"In this case, snake oil is exactly what you need."
6983,903,21,55,163,239,1.405857740585774,0.04185155100715179,651,I’d still like to run a few tests to be sure.
9024,904,21,57,166,244,1.4057377049180328,0.04123833004979391,651,"You’re fine, but the snake has a hernia."
1600,905,24,53,172,249,1.4056224899598393,0.04182644488451408,651,"As you make payments towards my bill, we will replace him with progressively smaller snakes."
7082,906,20,50,152,222,1.4054054054054055,0.04365807305904889,651,This isn't quite doing it.  I'm going to try you on Anaconda for a month.
4644,907,30,47,187,264,1.4053030303030303,0.04219749020355184,651,"So, what’s been eating you?"
696,908,27,38,162,227,1.4052863436123348,0.04603359613132629,651,"I'm only a student but chest pressure, shortness of breath, anxiety   sounds like a panic attack to me."
8564,908,20,52,155,227,1.4052863436123348,0.04296740774688985,651,"So,what’s the problem."
5454,910,26,44,167,237,1.4050632911392404,0.04416822157000713,651,You said you were ok with a generic vasoconstrictor.
4347,910,21,54,162,237,1.4050632911392404,0.04209564428452497,651,"OK, but no discomfort in the lower legs, is that right?"
4503,910,21,54,162,237,1.4050632911392404,0.04209564428452497,651,"Besides that, how are you feeling in general?"
6843,913,21,56,165,242,1.4049586776859504,0.04147292603150111,651,Is anything else bothering you ?
7337,913,24,50,168,242,1.4049586776859504,0.04269520727234231,651,"Unfortunately, an anti-hiss-tamine won’t help this time around."
8087,915,16,51,138,205,1.4048780487804877,0.044117122158055994,651,"The snake is overweight, but everything else is normal."
568,916,23,54,170,247,1.4048582995951417,0.041671522058134805,651,This will work like a charmer.
2402,917,26,50,176,252,1.4047619047619047,0.04221359609742573,651,"So Howard, what brings you in today?"
8366,917,23,56,173,252,1.4047619047619047,0.04107467632107263,651,Any other pressing problems?
9160,919,22,60,175,257,1.404669260700389,0.04012277426778277,651,"I'll write an Emotional Support letter,but I don't think they'll let you board."
8629,920,20,66,176,262,1.4045801526717556,0.03883193024257433,651,I recommend a coilonoscopy.
2389,921,25,39,156,220,1.4045454545454545,0.0462355077640054,651,"On a scale of 1 to 10, how would you rate the pressure?"
869,922,25,58,184,267,1.404494382022472,0.04011939861063064,651,I’m afraid your insurance only covers animal bites. Let’s just wait a while and see what happens.
2421,923,21,49,155,225,1.4044444444444444,0.04368800722519444,651,"Mrs. Davis, do you mind if I speak to your husband alone for a few minutes?"
5277,924,23,47,160,230,1.4043478260869566,0.043876098954908384,651,"What can I do for you today, Mr. Jones?"
7173,924,19,55,156,230,1.4043478260869566,0.04210965374542042,651,I’m prescribing some snake oil to loosen that up.
4445,926,28,39,168,235,1.4042553191489362,0.045250056827142546,651,"And finally Adam, do you feel safe at home?"
3720,927,25,47,168,240,1.4041666666666666,0.04335073006655805,651,"You'll need to remove the snake,too."
3027,927,22,53,165,240,1.4041666666666666,0.0421269900045485,651,Any pre-constricting conditions?
2300,929,21,57,167,245,1.4040816326530612,0.04110304116196973,651,Have you traveled outside the United States in the last six months?
3535,929,21,57,167,245,1.4040816326530612,0.04110304116196973,651,Have you travelled outside the US recently?
3554,929,21,57,167,245,1.4040816326530612,0.04110304116196973,651,I'm prescribing a new pet.
7295,929,25,49,171,245,1.4040816326530612,0.042699929908308065,651,Feed him two rats and try to call me in the morning.
2162,933,22,57,171,250,1.404,0.04091248373420031,651,You wouldn’t believe the day I’m having.
4794,933,19,63,168,250,1.404,0.03971707168375497,651,So you'd just bitten into the apple?
5792,933,24,53,173,250,1.404,0.04169038682254765,651,Anything more specific than 'shortness of breath'?
9148,936,17,48,138,203,1.4039408866995073,0.04495654290429678,651,"So, what seems to be the matter?"
6548,937,28,47,180,255,1.4039215686274509,0.04257354813306921,651,"Oh,him? He's just here to check your prostate."
2781,937,31,41,183,255,1.4039215686274509,0.04364793786683818,651,Rate your constriction on a scale of 1 to 10.
6952,937,20,63,172,255,1.4039215686274509,0.03956613521185104,651,I’m hoping this muscle relaxer will do the trick.
6737,940,19,67,174,260,1.4038461538461537,0.038650412397149954,651,Good news! I found a herpetologist in your provider network.
1209,941,26,34,153,213,1.403755868544601,0.04782379818092942,651,"So, shortness of breath, difficulty sleeping and range of motion restrictions in the arms and shoulders; we'll need to run some tests."
1653,942,26,59,190,275,1.4036363636363636,0.039605949503199005,651,I believe a dog would be a better comfort animal.
772,943,22,46,155,223,1.4035874439461884,0.044418872098899824,651,Any tightness in the chest?
8268,944,27,59,194,280,1.4035714285714285,0.039420473615034715,651,"If the snake doesn’t spark joy, I suggest getting rid of it."
8038,945,24,48,166,238,1.403361344537815,0.04320208829044685,651,Unfortunately our herpetologists are all out of network.
1028,946,18,62,163,243,1.4032921810699588,0.040082340143096314,651,"Other than that, would you rate your overall health as excellent, good, or fair?"
3450,947,26,48,174,248,1.403225806451613,0.04269808208617389,651,"Again?"""
2892,948,24,56,178,258,1.4031007751937985,0.04074486680136468,651,Shortness of breath? Any other symptoms I should know about?
6341,949,23,60,180,263,1.403041825095057,0.03982327636925411,651,"So, how's Eve?"
3494,950,26,41,164,231,1.4025974025974026,0.0449937657095742,651,You’re lucky I could squeeze you in.
8508,951,25,45,166,236,1.402542372881356,0.04387440574592117,651,"It’s funny, but this us not covered by your COBRA  insurance!"
5286,952,27,43,171,241,1.4024896265560165,0.043996122798506766,651,"Certainly, the snake is one possible explanation​ for your shortness of breath.  However, I make a lot more money if we run a series of unnecessary tests."
563,953,17,65,164,246,1.4024390243902438,0.039315222068993336,651,It's a tropical thing that's going around.
4070,953,26,47,173,246,1.4024390243902438,0.042945811601589605,651,How can I examine this snake with you in there?
4335,953,22,55,169,246,1.4024390243902438,0.04137156889557688,651,Your insurance only covers snakes under ten feet long.
2800,956,20,61,170,251,1.402390438247012,0.039991745311010685,651,Any other symptoms?
682,956,21,59,171,251,1.402390438247012,0.04038826813544875,651,The good news is that it's not a tapeworm.
1423,956,28,45,178,251,1.402390438247012,0.0430618133930983,651,Do you have cobra insurance?
4773,956,21,59,171,251,1.402390438247012,0.04038826813544875,651,You’re lucky I went to medical school in the Caribbean.
1389,960,20,50,154,224,1.4017857142857142,0.0433426944233881,651,You gotta unwind.
6129,961,26,44,169,239,1.401673640167364,0.0438630962553564,651,"Unfortunately Mr. Monty, your health plan doesn’t cover Ereptile Dysfunction!"
3733,961,25,46,168,239,1.401673640167364,0.0434604498986024,651,So what seems to be the matter here?
6360,963,26,46,172,244,1.401639344262295,0.04319731432653601,651,"I see you still have your COBRA benefits, everything else the same?"
5887,963,23,52,169,244,1.401639344262295,0.04200968786792428,651,Have you traveled out of the country in the last three weeks?
5573,965,28,46,180,254,1.4015748031496063,0.042676507295930595,651,"By 'pre-existing,' I mean you had it before you got here."
982,966,24,58,182,264,1.4015151515151516,0.040062637099869146,651,I see that you marked “Yes” on  “Shortness of Breath”.
4548,967,25,37,155,217,1.400921658986175,0.04667649841301925,651,"This requires an injection. 
Would you like it in your arm or your asp?"
3338,968,18,55,154,227,1.4008810572687225,0.04200535909561626,651,This perscription will help you unwind.
7562,969,16,61,155,232,1.4008620689655173,0.04045748691209397,651,"When I said a restricted diet, I meant a calorie-restricted diet."
8525,970,22,53,167,242,1.4008264462809918,0.04184454475273932,651,It's the high blood pressure that worries me
8686,971,23,53,171,247,1.4008097165991902,0.041633129860755964,651,"Okay, trouble breathing. Any other symptoms?"
780,972,22,57,173,252,1.4007936507936507,0.040650158155767786,651,"Any family history of anacondas, boa constrictors or reticulated pythons?"
623,973,21,54,165,240,1.4,0.04167015327113842,651,Last question. Have you been to any exotic locations during the past three months?
4806,973,26,54,185,265,1.4,0.040649388487998886,651,Your cobra plan should take about 6 weeks to kick in.
5168,973,16,58,151,225,1.4,0.041307979935470175,651,Maybe you should consider a different emotional support animal .
656,973,27,48,180,255,1.4,0.04217346564205071,651,"Unfortunately, Animal Control is an out-of-network provider."
5936,973,21,36,138,195,1.4,0.048449389864798235,651,This is not what we meant by `support animal’
7739,973,19,60,166,245,1.4,0.04024016226462445,651,"So, any unusual symptoms?"
1245,973,24,54,177,255,1.4,0.041060512964070796,651,I'm just going to have to disagree with WebMD on this one.  It isn't cancer.
9243,973,26,38,161,225,1.4,0.04586038162918624,651,"Sir, it seems you've contracted e-boa"
7382,973,25,58,187,270,1.4,0.03975693739865271,651,"We think the reason for your difficult breathing is the snake, but to be sure, we’d like to run some tests.."
3256,973,21,60,174,255,1.4,0.039916541000993816,651,Have you traveled outside the country in the past few weeks?
2640,983,21,63,179,263,1.3992395437262357,0.03905091352461373,651,Next time try a turtle neck
2243,983,21,63,179,263,1.3992395437262357,0.03905091352461373,651,A little snake oil should do the trick.
7517,985,23,57,178,258,1.3992248062015504,0.04033608487481635,651,As a last resort we could try to remove it.
831,985,20,63,175,258,1.3992248062015504,0.03919834428354386,651,I'm going to start off by prescribing you some mice.
7575,987,25,51,177,253,1.3992094861660078,0.04166522525216806,651,I’m not going to ask what happened this time.
2915,987,24,53,176,253,1.3992094861660078,0.04128706091170592,651,"In my professional opinion, a weighted blanket would be just as effective and have fewer side effects."
4589,989,21,55,167,243,1.3991769547325104,0.04129485888977667,651,The good news is your snake is going to be OK.
2032,990,23,49,166,238,1.3991596638655461,0.04274882669363114,651,"Not a wise choice for a halloween contest, was it?"
6401,990,23,49,166,238,1.3991596638655461,0.04274882669363114,651,This isn't covered by your insurance. Come back if it bites.
8439,990,22,51,165,238,1.3991596638655461,0.04233207959478345,651,"I know your in a tight spot right now, but if you could sign these forms it'd be great."
5206,993,19,55,159,233,1.3991416309012876,0.04167390433256105,651,"Bill, I'm afraid this'll be a little trickier than the mole on you back last year."
9001,994,19,53,156,228,1.3991228070175439,0.042316744511965425,651,All I can say is that must have been some bachelor party.
8590,995,23,43,157,223,1.399103139013453,0.04482688675723929,651,It's time to reassess: is this particular emotional support animal giving you more than it takes out of you?
844,996,20,47,151,218,1.3990825688073394,0.04416673011340696,651,Present this note at the gate and you shouldn't have any issues flying with your emotional support animal.
2639,997,27,48,181,256,1.3984375,0.04203745102409209,651,Have you traveled outside the United States within the last 6 months?
6777,997,21,60,175,256,1.3984375,0.039791000982523375,651,"Well, let's start with this.  Have you been out of the country recently?"
639,999,25,50,176,251,1.3984063745019921,0.041899017769354285,651,"I say there's nothing wrong here, but I'm just your vet."
4812,1000,17,64,165,246,1.3983739837398375,0.0392731686426798,651,"OK, weight gain, tightness in the chest...any other symptoms"""
128,1000,20,58,168,246,1.3983739837398375,0.0405207822131396,651,How was your vacation?
8028,1000,23,52,171,246,1.3983739837398375,0.04173111317821528,651,We'll need to get some bloodwork done just to be sure.
6482,1000,20,58,168,246,1.3983739837398375,0.0405207822131396,651,"On a scale of hug to asphyxiation, how would you describe this tightness in your chest?"
1066,1000,21,56,169,246,1.3983739837398375,0.040928202947040464,651,"No,she seems pretty healthy, but you were wise to bring her in regardless."
168,1005,22,52,167,241,1.3983402489626555,0.04194430380113754,651,Any shortness of breath?
3278,1006,30,34,172,236,1.3983050847457628,0.04584411293545128,651,"Sorry, but the insurance will not approve the operation without your signature."
3972,1007,25,42,164,231,1.3982683982683983,0.044531420156194906,651,What exactly is the problem?
1846,1007,20,52,159,231,1.3982683982683983,0.042365431682040426,651,Of course an MRI will be more conclusive.
7747,1009,15,58,148,221,1.3981900452488687,0.04130712790396605,651,"The good news is, it’s not a tumor”"
3034,1009,24,40,157,221,1.3981900452488687,0.04556859480992859,651,And would you say this tightness in your chest started before or after you came home from safari?'
2976,1011,22,42,152,216,1.3981481481481481,0.045409245241319396,651,"Any trouble eating, sleeping, peeing, bowel movements, or sex?"
949,1011,21,44,151,216,1.3981481481481481,0.04493254089465895,651,"That was quite a trick, getting your shirt off."
4025,1013,22,59,178,259,1.3976833976833978,0.039835683955223494,651,Compression sock... Is my handwriting that bad?
3793,1014,20,61,173,254,1.3976377952755905,0.03961286442162594,651,Have you traveled outside the country within the last two weeks?
2270,1014,23,55,176,254,1.3976377952755905,0.04077434001126782,651,It's really up to you Mr. Smith.  Is this something you can live with or do you want to see a specialist?
1486,1016,21,57,171,249,1.3975903614457832,0.04056988021116513,651,We found an anomaly in your x-ray. You have 832 extra ribs and vertebrae.
4344,1016,20,59,170,249,1.3975903614457832,0.040168738657969515,651,"No, the Xanax is to help the snake to relax, not you."
5035,1018,24,49,171,244,1.3975409836065573,0.042369308201936594,651,"On the plus side, it's the only thing holding you together."
52,1018,21,55,168,244,1.3975409836065573,0.04115779619033997,651,Unfortunately you’re only covered if it actually bites you.
5319,1018,19,59,166,244,1.3975409836065573,0.04032990776585218,651,"Now, which of you is the patient?"
2372,1021,19,57,163,239,1.397489539748954,0.04091841757450136,651,"Well, the good news is I can explain the breathing problems and sudden weight gain..."
945,1021,22,51,166,239,1.397489539748954,0.042187657199167346,651,"Unfortunately, it's feed a boa and starve a fever, not the other way around."""
5877,1021,25,45,169,239,1.397489539748954,0.04341981049138343,651,I'll write you a prescription for a flute.
4550,1021,23,49,167,239,1.397489539748954,0.04260233476785266,651,I think we'll give him something to help him relax a bit.
4235,1021,18,59,162,239,1.397489539748954,0.04048649637945386,651,Good news - it looks like he's benign.
5218,1021,19,57,163,239,1.397489539748954,0.04091841757450136,651,"Other than shortness of breath, have you experienced any other symptoms?"
3066,1027,26,41,167,234,1.3974358974358974,0.044514685192643816,651,No  I am a veterinarian and we are trying to figure out how to have you removed.
1928,1028,23,45,161,229,1.3973799126637554,0.043946861858331215,651,"So, when did the contractions start?"
553,1028,20,51,158,229,1.3973799126637554,0.042619368319538144,651,It's a textbook emboalism.
761,1030,24,41,159,224,1.3973214285714286,0.045107883894999576,651,"Well, the good news is that it isn’t cancer..."
2244,1030,17,55,152,224,1.3973214285714286,0.04188618067082266,651,So the feeling just kind of crept up on you?
5082,1030,20,49,155,224,1.3973214285714286,0.04329627515026054,651,"So, my bad, I probably should have explained the side effects of the new treatment."
266,1033,25,37,157,219,1.3972602739726028,0.04632132739314513,651,It’s an intestinanal disorder. The good news is that it’s not yours.
872,1033,21,45,153,219,1.3972602739726028,0.04447581399297513,651,Any changes since your last visit?
7203,1035,21,43,150,214,1.397196261682243,0.04522728587853162,651,"I can remove it, but I hate to tell you boa constrictors are not covered under your current COBRA insurance plan."
197,1036,26,60,196,282,1.3971631205673758,0.03883635432957826,651,I'm putting you on a boa blocker.
6076,1037,22,54,171,247,1.3967611336032388,0.04119551776702643,651,"No, in fact, some snake oil is exactly what you need."
3476,1037,21,56,170,247,1.3967611336032388,0.04079406053806383,651,"Yeah, this isn't covered."
6564,1037,19,60,168,247,1.3967611336032388,0.039979053982840414,651,"Well, technically, it is a pre-existing condition..."
8292,1037,22,54,171,247,1.3967611336032388,0.04119551776702643,651,Any change since the last check-up?
8460,1041,24,48,170,242,1.396694214876033,0.042615477590681745,651,Take two rats and a bunny and call me in the morning.
2827,1041,20,56,166,242,1.396694214876033,0.0409744972277068,651,"Take two rats, call me in the morning."
4477,1041,25,46,171,242,1.396694214876033,0.043015942475860436,651,How did you get your shirt off?
7797,1041,22,52,168,242,1.396694214876033,0.041803040280255034,651,It seems to me that you're under a lot of pressure.
1783,1045,24,44,164,232,1.396551724137931,0.043949745304351084,651,"Tightening of the chest, shortness of breath...I know you are being attacked by a snake, but the insurance company says you are having a heart attack so that is what I have to treat you for."
5876,1046,23,44,160,227,1.39647577092511,0.04422018048300609,651,I'll write you a prescription for an antiboatic.
6230,1047,19,50,153,222,1.3963963963963963,0.04309504724729618,651,This antidepressant should help him unwind.
9040,1048,19,48,150,217,1.3963133640552996,0.04379900899964133,651,"I know our website says that we accept COBRA coverage, but this isn't what we meant."
1696,1049,23,61,186,270,1.3962962962962964,0.03902224664364057,651,Point to where it hurts.
6686,1050,24,57,184,265,1.3962264150943395,0.03990344020197694,651,Unfortunately veterinarians are out of network for you
6804,1051,29,45,186,260,1.396153846153846,0.04224825049076061,651,This time I'm writing you a prescription for a service dog.
9248,1052,25,51,179,255,1.396078431372549,0.04139680932903221,651,It’s a traditional Chinese folk remedy for treating constipation.
7457,1053,24,51,175,250,1.396,0.0416132509016348,651,Seems you tried to see a doctor outside your network.
5784,1053,23,53,174,250,1.396,0.041225406444887654,651,"Ah, yet another case of an Amazon order gone awry."
1026,1055,18,57,160,235,1.3957446808510638,0.04094619764606139,651,The x-ray is showing a multitude of broken bones but honestly I’d take the fact that he hasn’t eaten yet you as a win.
7115,1056,20,49,156,225,1.3955555555555557,0.043139574959537956,651,Are you under a lot of pressure?
5885,1057,22,43,155,220,1.3954545454545455,0.044775964276239234,651,I’m going to prescribe you some antihisstamines.
7524,1057,21,45,154,220,1.3954545454545455,0.044309998605867075,651,There's been a lot of this going around and around.
3458,1059,18,68,177,263,1.3954372623574145,0.03788032396130192,651,I thought when you called you said you had ebola.
5120,1059,20,64,179,263,1.3954372623574145,0.03863895755124739,651,I'm putting you on a boa constricted diet.
276,1061,21,58,174,253,1.3952569169960474,0.04009100717064878,651,I'm afraid your boa is constricted.
1523,1061,23,54,176,253,1.3952569169960474,0.040865976669241466,651,I'll prescribe a relaxant to help you unwind.
1280,1063,23,50,170,243,1.3950617283950617,0.04206883235463819,651,This muscle relaxant prescription is for the snake not you.
2147,1063,21,54,168,243,1.3950617283950617,0.04125247126709115,651,110 over 70... that's really good.
6317,1065,28,38,172,238,1.3949579831932772,0.044733637008041685,651,"I am sure the nurse did mention, you can't bring your support animal to your colonoscopy"
448,1066,21,48,159,228,1.394736842105263,0.043174178217811346,651,"In the future I suggest you avoid apples, gardens and naked women."
1289,1066,21,48,159,228,1.394736842105263,0.043174178217811346,651,I see you've met our colonoscopist.
5803,1068,21,46,156,223,1.3946188340807175,0.04386894985591943,651,I’d say its a Boa but it could be an Anaconda. Would you like a second opinion?
8641,1068,21,46,156,223,1.3946188340807175,0.04386894985591943,651,yup...typical case of Ereptile Dysfunction
2855,1068,19,50,154,223,1.3946188340807175,0.04293817036606078,651,"Let's see, crushing chest pain, Right?"
1515,1071,24,53,179,256,1.39453125,0.040890880270637336,651,Sorry but i can’t find a billing code for this...
2655,1072,24,38,156,218,1.3944954128440368,0.04599400223008355,651,"Now tell me, what seems to be the problem?"
7332,1073,25,49,177,251,1.3944223107569722,0.041859600513387545,651,So your first name is Monty?
2586,1074,24,47,170,241,1.3941908713692945,0.04271877772029038,651,"Look, you keep telling me about the snake but let’s take a moment to talk about your high cholesterol."
730,1074,24,47,170,241,1.3941908713692945,0.04271877772029038,651,"Before the procedure, which way ya leaning, purses, belts, shoes or steaks?"
35,1076,19,53,159,231,1.393939393939394,0.04187213000388005,651,"Rex is fine physically, but he seems to have some separation issues."
7850,1076,20,51,160,231,1.393939393939394,0.04231924842156601,651,I think he has a crush on you.
8137,1076,18,55,158,231,1.393939393939394,0.04142018535880117,651,Just give this letter to the airline and you should have no problem traveling with Simon.
437,1079,20,49,157,226,1.3938053097345133,0.042983916278941936,651,We won’t know for sure until we run some tests.
4650,1080,22,56,176,254,1.3937007874015748,0.04035067743418712,651,"Once I uncoil it, you should find it easier to walk, sleep, shower, and definitely to make new friends."
4616,1081,26,35,160,221,1.3936651583710407,0.04641644590516691,651,"Actually, I'm a vet--so you're not the patient here."""
8315,1082,18,62,169,249,1.393574297188755,0.039311200644414596,651,"Three to five medium-sized rodents a day for Monty,
Don't miss a feeding, you should be fine."
1208,1083,20,56,168,244,1.3934426229508197,0.040702673374849715,651,Good news! It's definitely not your heart.
2257,1083,26,44,174,244,1.3934426229508197,0.04311723321816877,651,"Okay, I'll certify Chester as a comfort animal. But I still don't think they will allow a snake on a plane."
2593,1085,24,46,169,239,1.393305439330544,0.042970240376492976,651,Tight chest and difficulty breathing... Could be asthma...
6310,1085,23,48,168,239,1.393305439330544,0.04255914766881329,651,Take 2 aspirin and coil me in the morning.  Just kidding!
7595,1085,25,44,170,239,1.393305439330544,0.043377437288656395,651,The xrays revealed that you have a snake wrapped around you.
4149,1088,20,52,162,234,1.393162393162393,0.04192400117202596,651,Yes...I can see that...we just want to run some tests first to rule out any other potential causes of your discomfort.
8190,1088,17,58,159,234,1.393162393162393,0.04059032586619975,651,Twenty minutes every day at bedtime.  But don't sleep with it on.
504,1090,24,55,183,262,1.3931297709923665,0.040199924754608526,651,"Any chest pains, difficulty breathing or shortness of breath?"
5580,1091,22,46,161,229,1.3930131004366813,0.043462705393764345,651,A constriction?  Can you be more specific?
7451,1092,25,51,181,257,1.3929961089494163,0.04113158650157302,651,"Here's a prescription for four rats a day, plus two refills."
5540,1093,19,61,172,252,1.3928571428571428,0.03938339786911227,651,"You think you’re being squeezed, let me tell you about malpractice insurance."
5633,1094,27,43,177,247,1.3927125506072875,0.04310664054742953,651,Feed it two rabbits and call me in the morning.
7522,1095,16,54,149,219,1.3926940639269407,0.04200284817476157,651,"So, shortness of breath, tightness in the chest and you're generally feeling constricted."
162,1096,24,58,188,270,1.3925925925925926,0.03933657201873491,651,I'll prescribe something easy to swallow.
6783,1097,20,55,167,242,1.3925619834710743,0.040930379550348554,651,And have you been under any extra pressure lately?
3564,1097,22,51,169,242,1.3925619834710743,0.04175979793706938,651,Go get two Mongooses and call me in the morning.
8433,1099,17,59,161,237,1.3924050632911393,0.04022622706761156,651,Two more weeks of this and we’ll hit your goal weight.
3119,1099,28,37,172,237,1.3924050632911393,0.04484957199056207,651,"Before I jump to conclusions, let's run a few expensive diagnostics."
6468,1099,20,53,164,237,1.3924050632911393,0.04153820484146895,651,So...I don't think it's anything internal.
6940,1099,19,55,163,237,1.3924050632911393,0.04110553193508434,651,"I suggest you unwind a bit, Mr. Smithers."
2321,1103,19,51,157,227,1.3920704845814977,0.04237172733903809,651,"You should've come in at ""Oh, Gee! It's up to my knee.""  ""Oh, fiddle! It's up to my middle"" is much harder to treat."
2534,1103,23,43,161,227,1.3920704845814977,0.04417355110573163,651,"Okay, Adam, one more time. So you ate an apple and what happened?"
300,1103,19,51,157,227,1.3920704845814977,0.04237172733903809,651,Take off the snake and the doctor will be right in.
786,1106,21,56,173,250,1.392,0.04039642912367101,651,If it's an adult anaconda it may be considered a pre-existing condition.
3419,1106,22,54,174,250,1.392,0.04079215610874228,651,"So, tell me what's eating you today."
724,1106,24,50,176,250,1.392,0.041572310834405754,651,"I wouldn't worry about it, it seems to be going around."
3393,1109,19,49,154,222,1.3918918918918919,0.0430449522023386,651,Nice boa! Now what brings you in?
8257,1110,24,48,173,245,1.3918367346938776,0.04218514400271425,651,"...And last week it was from the jaws of a lion. Tell me, has the Great Zordini ever considered a change of career?"
7093,1111,17,60,163,240,1.3916666666666666,0.039870635767024834,651,"The good news is, your prostate is fine."
6274,1111,19,56,165,240,1.3916666666666666,0.04073576565427806,651,Separate bills?
4023,1111,23,48,169,240,1.3916666666666666,0.04241311845864746,651,This is completely normal. My last patient's emotional support alligator was clingy too.
1557,1114,18,56,161,235,1.3914893617021276,0.04089892328937647,651,Looks like you picked something up.
5083,1114,27,38,170,235,1.3914893617021276,0.044721965167646205,651,There was really no need to take off your pants.
8983,1114,23,46,166,235,1.3914893617021276,0.043064755565442765,651,"He needs to cut down on mice, but otherwise he's fine."
8150,1117,22,46,162,230,1.391304347826087,0.04330704850124253,651,And where was Eve when this happened?
4951,1118,22,53,173,248,1.3911290322580645,0.04101774412228384,651,"Look, I know it gets a bad rap but snake oil really is the best option here."
5981,1118,23,51,174,248,1.3911290322580645,0.04141382855703788,651,"So, this is Eve's fault?"
5301,1120,18,59,166,243,1.3909465020576133,0.03995118316262625,651,Let me know if that gets too tight.
7697,1120,22,51,170,243,1.3909465020576133,0.041618956932804735,651,I'm recommending a less needy emotional support reptile.
8805,1120,18,59,166,243,1.3909465020576133,0.03995118316262625,651,"On the other hand, this might help your constipation issues."
4493,1123,18,50,152,220,1.3909090909090909,0.04282999936512742,651,"As a veterinarian, my first concern is for the snake."
9199,1124,24,54,183,261,1.3908045977011494,0.04028668467247267,651,"Sorry,I can’t help you, it’s an endangered species."
3443,1125,24,45,169,238,1.3907563025210083,0.04307517160227584,651,Because antibiotics are what your insurance will cover.
7814,1126,20,60,176,256,1.390625,0.039322054350368486,651,Have you been out of the country in the last month?
2107,1126,23,54,179,256,1.390625,0.040473889398465475,651,So Mr. Peterson what seems to be the problem?
2299,1126,23,54,179,256,1.390625,0.040473889398465475,651,"Yes, they are 'Dad sneakers' but I don't think you're in the position to be passing judgements."
3059,1129,20,51,162,233,1.390557939914163,0.04202299530730361,651,But could you play the violin before?
2214,1130,27,44,180,251,1.3904382470119523,0.04257396690529375,651,So you refused to eat the apple.
1869,1131,24,41,163,228,1.3903508771929824,0.04444981259689663,651,You’ve got to unwind
7587,1131,23,43,162,228,1.3903508771929824,0.04401298646122487,651,Next I'd like to examine you without your comfort animal.
4848,1133,24,57,188,269,1.3903345724907064,0.039417974332085215,651,"Unfortunately, that one's not on my list of emotional support animals."
1257,1134,21,54,171,246,1.3902439024390243,0.040842420242766846,651,You can put your pants back on now.
640,1134,22,52,172,246,1.3902439024390243,0.041246664066275855,651,Wait a minute; how did you get your shirt off?
3913,1136,19,56,166,241,1.3900414937759336,0.0405989262715515,651,"The bad news is, your snake has a cold."
3395,1137,22,57,180,259,1.38996138996139,0.03975582811279219,651,...and when did you notice the tightness in your chest?
8708,1137,20,61,178,259,1.38996138996139,0.03899570930188441,651,Let's see if an MRI shows us anything.
4720,1139,27,45,182,254,1.389763779527559,0.04219503000222354,651,My assistant there is just taking your blood pressure.
458,1140,21,55,173,249,1.3895582329317269,0.04048482963995129,651,The X-rays are showing it's a very large snake...
1210,1141,19,50,157,226,1.3893805309734513,0.04247377889122435,651,That human will have to be removed Mr. Snake.
7742,1142,26,43,175,244,1.389344262295082,0.04307472986720974,651,I remember when The New Yorker cartoons were funny.
534,1142,26,43,175,244,1.389344262295082,0.04307472986720974,651,"So, which of you has the gerbil?"
9046,1142,29,37,178,244,1.389344262295082,0.04423377039545939,651,Next I am prescribing compression leggings.
6685,1142,26,43,175,244,1.389344262295082,0.04307472986720974,651,"Now, what seems to be the problem here?"
826,1146,22,58,182,262,1.3893129770992367,0.039425341163987944,651,Glad I could squeeze you in today.
8077,1146,21,60,181,262,1.3893129770992367,0.03905265756788184,651,Nothing too alarming here. You just caught what is going around.
8214,1148,21,44,156,221,1.3891402714932126,0.04409470023113372,651,"Good news,its not your heart."
5442,1149,23,47,169,239,1.389121338912134,0.0425141865478392,651,This should keep the swelling down.
1540,1150,19,62,176,257,1.3891050583657587,0.038808536135094454,651,Have you been out of the country recently?
1713,1150,20,60,177,257,1.3891050583657587,0.039198230950308936,651,"Take the decongestant pills for 2 weeks. If your breathing doesn't improve, I'd get rid of the snake."
7652,1150,22,56,179,257,1.3891050583657587,0.039966222926408834,651,Everything looks good. I'll see you in a year.
829,1153,26,55,194,275,1.3890909090909092,0.039466796663132006,651,It appears that your pet is suffering from separation anxiety.
7312,1154,21,49,164,234,1.3888888888888888,0.04231201802077871,651,"You are suffering from Bronchial Obstructive Asthma, but we doctors call it BOA"
3933,1154,22,47,165,234,1.3888888888888888,0.042743295487206165,651,I'll just write 'got himself in a bind' and leave it at that.
6111,1156,26,58,199,283,1.3886925795053005,0.03865450902572895,651,Shortness of breath. Anything else bothering you?
1538,1157,23,57,185,265,1.3886792452830188,0.03946577896359202,651,You seem fine but your snake seems wound pretty tight.
4026,1158,22,52,173,247,1.388663967611336,0.04110970548441692,651,I'm going to go ahead and schedule you for a hiss-terectomy.
7711,1158,23,50,174,247,1.388663967611336,0.04150810997775824,651,Scales don't lie...
2211,1160,21,59,180,260,1.3884615384615384,0.03925452206378221,651,In cases like this I often recommend snake oil.
1855,1161,27,40,175,242,1.3884297520661157,0.04372170457340268,651,You have to find a different emotional support animal.
4676,1161,22,50,170,242,1.3884297520661157,0.0417148123186563,651,Coiliosis.
1250,1163,28,43,184,255,1.388235294117647,0.04242253216001218,651,I'm not judging you but if you're naked under there tell me now.
2938,1163,18,63,174,255,1.388235294117647,0.03861199688661433,651,i’m writing a prescription that should help you unwind
8146,1165,23,58,187,268,1.3880597014925373,0.03914398469603321,651,Not the best choice of therapy pet.
7253,1166,19,59,172,250,1.388,0.039548455359029386,651,Have you traveled outside of the country in the last 30 days?
5108,1167,15,60,157,232,1.3879310344827587,0.03984552921280929,651,You need to unwind a bit.
8025,1167,25,40,167,232,1.3879310344827587,0.04428155628036667,651,Studies show that it is an extremely effective treatment for constipation
6075,1169,21,60,182,263,1.3878326996197718,0.03893203679970631,651,"In the plus column, you’ve quit smoking."
421,1170,20,55,170,245,1.3877551020408163,0.04052252910138847,651,"It says here you're been feeling a bit constricted. I'm thinking it's probably the snake, but going to have to run some more tests just to be sure."
2975,1170,20,55,170,245,1.3877551020408163,0.04052252910138847,651,"Well, it's not worms."
4086,1172,24,59,193,276,1.3876811594202898,0.03867334160652367,651,Just when did you begin to feel this tightness in your chest?
4633,1172,24,59,193,276,1.3876811594202898,0.03867334160652367,651,"Have you been out of the country during the last two weeks?"""
1315,1174,16,56,155,227,1.3876651982378854,0.040915953966348825,651,"Well, I have some good news. It’s not cancer..."
2963,1174,22,44,161,227,1.3876651982378854,0.04368093747130116,651,He seems a bit lonely and depressed.  Give him 2 of these a day to unwind.
3872,1176,24,52,182,258,1.3875968992248062,0.04058962579328641,651,I misunderstood when you told me you liked to wear your wife's boa.
2677,1177,24,33,152,209,1.38755980861244,0.04738459031867402,651,We don't accept Cobra.
1354,1178,21,51,168,240,1.3875,0.04153658215240832,651,Any concerns today other than feeling constricted?
2943,1178,17,59,164,240,1.3875,0.03982232593604703,651,"It's probably benign, but there's a small chance it could lead to the Fall of Man."
1756,1180,19,48,155,222,1.3873873873873874,0.0429926633040062,651,"You may experience some side effects such dizziness, nausea, blurred vision, or in rare cases, asphyxiation."
8716,1180,17,52,153,222,1.3873873873873874,0.04203379122417394,651,"Well, the good news is you're not having a heart attack...."
4290,1182,19,60,174,253,1.3873517786561265,0.03921390295882477,651,I think you need a chance to unwind.
257,1183,18,55,162,235,1.3872340425531915,0.040849699922676036,651,"It won't relieve your back pain, but it will take your mind off of it."
5881,1183,21,49,165,235,1.3872340425531915,0.04216406919619237,651,"Can you let go of your human now,so I can examine you?"
7987,1183,26,39,170,235,1.3872340425531915,0.044268046905892866,651,"First the good news, you don't have a tape worm."
3217,1186,20,61,180,261,1.3869731800766283,0.03875374140542645,651,I'll write him a little something for separation anxiety.
3511,1187,15,64,164,243,1.3868312757201646,0.038604244936818355,651,"Your's is the first case this season."""
5018,1187,20,54,169,243,1.3868312757201646,0.040747250241495385,651,Any chest pain or shortness of breath?
7537,1187,24,46,173,243,1.3868312757201646,0.04238371081351879,651,HOW DID YOU GET YOUR JACKET OFF?
8520,1190,20,59,177,256,1.38671875,0.03927866049383496,651,It’s nothing serious. Just try to unwind a bit.
2172,1190,20,59,177,256,1.38671875,0.03927866049383496,651,The good news is it's not ringworm.
7320,1192,25,37,163,225,1.3866666666666667,0.04528568924940473,651,I'm going to recommend Boa-tox.
1852,1193,24,44,170,238,1.3865546218487395,0.04302932070921302,651,I presume you want a note for your emotional support snake.
5411,1194,21,38,148,207,1.3864734299516908,0.04621657903562145,651,The good news is that it’s not a tapeworm.  The bad news...
291,1195,17,63,171,251,1.3864541832669324,0.038603912487368316,651,It's been going around.
1577,1195,30,37,184,251,1.3864541832669324,0.04364177687508224,651,"As herpetologists go, you're too wrapped up in your work."
2411,1197,30,47,200,277,1.3862815884476534,0.04054316991875992,651,Cough.
4177,1198,24,42,167,233,1.386266094420601,0.04370123796935846,651,HE SEEMS TO HAVE A CRUSH ON YOU.
3014,1199,20,55,171,246,1.386178861788618,0.04038823704852515,651,What’s eating you?
5156,1199,26,43,177,246,1.386178861788618,0.04278216595433785,651,We'll have to run more tests to be sure.
8580,1199,17,61,168,246,1.386178861788618,0.03913639835191196,651,"So, how was Florida this year?"
8648,1202,15,53,147,215,1.386046511627907,0.041947312647638096,651,"So, besides a little tightness in your chest, any other symptoms?"
2613,1202,21,41,153,215,1.386046511627907,0.044948747536797874,651,Is anything else bothering you today?
3105,1204,23,42,163,228,1.3859649122807018,0.04396386104657221,651,That tight feeling around your chest... I think I know what it is.
40,1205,19,55,167,241,1.3858921161825726,0.04055118881315453,651,This is exactly why we recommend vaccinations.
5003,1205,21,51,169,241,1.3858921161825726,0.041395110911589456,651,I have some snake oil that may actually work in this case.
6192,1205,24,45,172,241,1.3858921161825726,0.042629680355555304,651,"By any chance, were you recently on a plane?"
7703,1208,29,40,185,254,1.3858267716535433,0.042885587775167384,651,She handed me an apple and said she’d be right back.
2941,1209,19,43,148,210,1.3857142857142857,0.04471553664582737,651,"Basically you’re fine, except that your blood pressure is a tad high and there’s a slight rattle in your chest."
2336,1210,24,43,169,236,1.3855932203389831,0.04328534316705437,651,The best I can do is prescribe you an emotional support mongoose.
5287,1210,15,61,160,236,1.3855932203389831,0.03935813375805009,651,An aspirins for you. A muscle relaxer for her.
5955,1210,13,65,158,236,1.3855932203389831,0.038430959388815196,651,You need to learn to unwind.
8476,1210,20,51,165,236,1.3855932203389831,0.04158572863791208,651,This new organic body cast will help realign your spine and it is environmentally friendly.
7351,1210,19,53,164,236,1.3855932203389831,0.0411498578328062,651,Slightly constricted or very constricted?
7813,1215,21,54,174,249,1.3855421686746987,0.04043982505124573,651,"Well, I think I've determined the cause of your high blood pressure."
2983,1215,27,42,180,249,1.3855421686746987,0.042775052776490644,651,Can you describe the tightness in your chest?
9224,1217,18,65,179,262,1.3854961832061068,0.0378691767063261,651,"If you relax, he’ll relax.  Have you tried meditation?"
2356,1218,28,50,197,275,1.3854545454545455,0.04009640310421119,651,What seems to be the problem here?
2899,1219,20,49,162,231,1.3852813852813852,0.04222094125972865,651,Have you traveled outside the country recently?
6028,1220,20,54,170,244,1.3852459016393444,0.0406108665513709,651,"So, how was the Amazon?"
3220,1220,24,46,174,244,1.3852459016393444,0.042239412114044556,651,"You need to give up wearing boas, they're too constricting."
1105,1222,18,63,176,257,1.3852140077821011,0.03837021534719272,651,The good news is your blood work came back & looks great.
8296,1223,23,58,189,270,1.385185185185185,0.038906423274380306,651,So you're feeling constricted?
4181,1224,22,43,161,226,1.3849557522123894,0.04379016056592869,651,Do you want me to write you a note for work?
2419,1224,12,63,151,226,1.3849557522123894,0.03904183006391817,651,The good news is your cholesterol looks great.
3934,1224,19,49,158,226,1.3849557522123894,0.042421504712761314,651,"A tightness in your chest... any other symptoms?"""
7132,1224,17,53,156,226,1.3849557522123894,0.04148398882177123,651,"Sir, we cannot perform the operation until you sign the documents."
8988,1228,22,48,169,239,1.3849372384937237,0.042051438055556445,651,The python comes off when you start paying your deductible.
1619,1229,18,61,173,252,1.3849206349206349,0.03888966323759257,651,"Blood pressure is a little high, otherwise I’d say you’re good to go"
5401,1229,21,55,176,252,1.3849206349206349,0.04009070425084937,651,That frog in your throat has led to other complications.
7642,1229,27,43,182,252,1.3849206349206349,0.042390823163987935,651,I thought you selected the COBRA plan with full coverage.
1402,1232,23,49,175,247,1.3846153846153846,0.0414631390978395,651,Have you been under any pressure lately?
2932,1232,22,46,166,234,1.3846153846153846,0.04269467298322794,651,Are you her main squeeze?
3628,1232,18,54,162,234,1.3846153846153846,0.040940265517960525,651,"Before I examine your throat, Mr. Jones, I'm gonna have to ask you to remove your boa."
5563,1232,21,53,173,247,1.3846153846153846,0.040661545543995724,651,Now Cough
5722,1236,26,46,183,255,1.384313725490196,0.04164615920874966,651,Shortness of breath?  You smoke?
5386,1237,22,49,171,242,1.384297520661157,0.0416680777788008,651,"I don't know what to tell you doc, it just started with a frog in my throat."
3818,1238,20,48,161,229,1.3842794759825328,0.04247193342626771,651,You can remove the boa also. You haven't got anything that  I haven't seen before.
5476,1238,24,40,165,229,1.3842794759825328,0.04423897162702863,651,Didn't the nurse ask you to take EVERYTHING off?
2523,1240,23,45,169,237,1.3839662447257384,0.04271649716251878,651,Now which toe did you say is bothering you?
4803,1240,27,37,173,237,1.3839662447257384,0.044359102256220896,651,"So, Mr. Schmidt, what seems to be the problem?"
4168,1240,18,55,164,237,1.3839662447257384,0.040569823772201564,651,The good news is we’ve resolved your low blood pressure issue.
4756,1243,19,48,157,224,1.3839285714285714,0.042677762275920954,651,"Here’s a prescription for snake oil, but you may not need it."
2805,1244,25,39,168,232,1.3836206896551724,0.04423339796673848,651,"Dr. Scott is the best herpetologist I know, and he's a real charmer, too."
3813,1244,21,47,164,232,1.3836206896551724,0.04251255678430653,651,The good news is that the tightness you feel is not because of a heart attack.
4382,1246,19,59,175,253,1.383399209486166,0.03916802855332592,651,Please slip out of your boa and put on the robe. Then we can begin your exam.
391,1246,22,53,178,253,1.383399209486166,0.04035149626116878,651,This wasn’t exactly what I had envisioned when I said “emotional support animal.”
818,1246,12,73,168,253,1.383399209486166,0.03625668606816182,651,"We'll run some tests, but I've got a hunch you picked something up when you were on safari."
3827,1246,19,59,175,253,1.383399209486166,0.03916802855332592,651,I'd like to run a few more tests before making a diagnosis.
3969,1246,20,57,176,253,1.383399209486166,0.039566451159298355,651,Take two mongooses and see me in the morning.
306,1251,23,46,171,240,1.3833333333333333,0.042320532004013645,651,"I'm prescribing a fairly aggressive muscle relaxant first. And then, charm school."
692,1251,17,58,165,240,1.3833333333333333,0.03977213104904288,651,I suggest you find a new way to unwind.
3173,1251,23,46,171,240,1.3833333333333333,0.042320532004013645,651,Have you offered it a cow?
5692,1251,23,46,171,240,1.3833333333333333,0.042320532004013645,651,Okay you can put your clothes back on
5962,1255,18,51,158,227,1.3832599118942732,0.04180454204263332,651,We don't have a code for boa constrictor--let's just call it chest pain
7754,1256,26,48,187,261,1.3831417624521072,0.040930422613930886,651,We need to remove that mole on your face immediately.
762,1256,29,42,190,261,1.3831417624521072,0.04199662873555002,651,"Well, next time, accept the apple..."
2381,1258,21,53,174,248,1.3830645161290323,0.04052694067321295,651,"Not so charming, is it."
3925,1258,16,63,169,248,1.3830645161290323,0.038460156083630785,651,"Well, your snake is in perfect health."
2416,1258,25,45,178,248,1.3830645161290323,0.04210739094045635,651,The bad news is that your support animal has not been approved for air travel.
8015,1261,17,56,162,235,1.3829787234042554,0.04035032868715257,651,WebMD says it’s asthma.
4485,1262,22,54,180,256,1.3828125,0.04000696458210157,651,Does it hurt when you laugh?
832,1263,22,44,164,230,1.382608695652174,0.043207816568514,651,"You're not covered, but the snake is - Trump Care."
6356,1263,23,42,165,230,1.382608695652174,0.043645019107038795,651,"When they told you to wear a boa for drag night, I think they meant a scarf."
6124,1265,27,47,190,264,1.3825757575757576,0.04093753945049258,651,You might have to go out of network.
5537,1266,16,51,150,217,1.3824884792626728,0.04214483845873718,651,So besides the tightness in the chest...?
8906,1267,22,52,177,251,1.3824701195219125,0.04057021232262325,651,"I'm referring you to a herpetologist, but she's out of network."""
9022,1268,20,51,167,238,1.3823529411764706,0.041298869348390124,651,"Any tightness, heavy pressure, or squeezing around chest area?"
6541,1268,17,57,164,238,1.3823529411764706,0.03999031066228808,651,"Actually, I WOULD recommend snake oil."
4533,1268,21,49,168,238,1.3823529411764706,0.041725937141284516,651,"So, a little tightness. Where?"
5010,1271,27,45,187,259,1.3822393822393821,0.041513360387870346,651,So what seems to be bothering you today?
4551,1272,19,48,158,225,1.3822222222222222,0.04252191052598109,651,I think we've found the reason for your shortness of breath.
3401,1273,20,54,172,246,1.3821138211382114,0.040340614812715274,651,Chest pressure? Okay.  Can you be a bit more specific?
6033,1273,25,44,177,246,1.3821138211382114,0.042347198608822606,651,"Sir, I know you're scared, but you're going to have to remove the therapy snake."
9185,1273,17,60,169,246,1.3821138211382114,0.03908725095909842,651,Your insurance company claims it was a pre-existing condition.
7680,1273,23,48,175,246,1.3821138211382114,0.04155619351427878,651,And this is why you don't trust ads from the internet.
9202,1277,18,45,149,212,1.3820754716981132,0.043860243707734566,651,"Well, the contractions are three minutes apart and dilation has begun, but unfortunately you’re in breech position, Mr. Coyle."
5073,1278,23,51,180,254,1.3818897637795275,0.04060570718199202,651,"It's probably nothing, but we can run some tests."
706,1279,26,53,196,275,1.3818181818181818,0.03938968551037672,651,"I said ""restrictive diet"" not ""constrictive diet"""
6123,1279,19,67,189,275,1.3818181818181818,0.03695602417398801,651,"It seems you picked up an exotic organism on your trip abroad."""
8013,1281,19,54,168,241,1.3817427385892116,0.040501623870291624,651,Tightness in the chest could result from a number of causes.
77,1282,25,53,192,270,1.3814814814814815,0.03956729461058209,651,Does he usually frighten this easily when he goes to the vet ?
222,1283,17,56,163,236,1.38135593220339,0.04021174708152168,651,We find it more cost effective than collection agencies.
6581,1283,24,42,170,236,1.38135593220339,0.0432367758991066,651,"Before I examine you, Mr. Boa, I must ask that you please put down your emotional-support human."
4524,1285,22,41,160,223,1.3811659192825112,0.04417348468369738,651,"Well, Sir, it seems you have your head up your asp."
1013,1286,26,41,177,244,1.3811475409836065,0.04298477321960909,651,"Finally, a  contraceptive coil  that's fool proof."
8056,1286,25,43,176,244,1.3811475409836065,0.04259060184265436,651,And just when did these contractions begin?
8609,1288,25,46,181,252,1.380952380952381,0.04159376499071411,651,"So, I understand that you are her therapy human."
8142,1288,21,54,177,252,1.380952380952381,0.04004451363139697,651,We're probably going to go back to the old style blood pressure monitors.  There's some problems with these.
6792,1288,26,44,182,252,1.380952380952381,0.04197214361495799,651,"Routine question,we ask everybody ... do you feel safe at home?"
2537,1288,19,58,175,252,1.380952380952381,0.03924696121881706,651,The good news is we've fixed the hissing in your ear.
1307,1288,25,46,181,252,1.380952380952381,0.04159376499071411,651,Any peanut allergy?
2558,1293,24,51,185,260,1.3807692307692307,0.04028850628340984,651,"I'm recommending boatox."""
8815,1294,20,51,168,239,1.3807531380753137,0.04115681236980516,651,"OK, let's skip the ""breathe deeply"" for now."
2619,1294,18,55,166,239,1.3807531380753137,0.04029345094438901,651,"I have your ""emotional support animal"" papers here, but sir, I still don't think you will be able to fly without clothing"""
546,1294,22,47,170,239,1.3807531380753137,0.04200243111867228,651,It's our new way to collect co-pays.
4536,1294,24,43,172,239,1.3807531380753137,0.0428313580839351,651,I stand corrected. You should feed Larry more than once a year.
8526,1298,14,55,149,218,1.3807339449541285,0.0409684589865664,651,Which garden were you in?
2848,1299,21,52,174,247,1.3805668016194332,0.040613996794056015,651,I'm going to prescribe him some oxycodone and he should loosen right up.
4778,1299,16,62,169,247,1.3805668016194332,0.038534662202187805,651,"It's surprisingly good at detecting high blood pressure, and no one can pronounce sphygmomanometer anyway."
7157,1299,27,40,180,247,1.3805668016194332,0.04297660513638364,651,Ironic that using a Python for constipation is covered by your COBRA plan.
6053,1299,22,50,175,247,1.3805668016194332,0.04101721644014579,651,"Sir, we do accept Cobra insurance.  However, we do not accept insurance for cobras.  You may want to contact your provider for clarification."
1760,1303,20,49,165,234,1.3803418803418803,0.041775103236096234,651,You're lucky that we were able to squeeze you in.
3408,1304,25,58,201,284,1.380281690140845,0.03814255686519013,651,"If I can just get you to sign this insurance form, we’ll have a look at you."
7692,1305,28,44,191,263,1.3802281368821292,0.04137809546361062,651,Not to worry. This happens occasionally with people who opt for COBRA medical coverage.
8233,1305,22,56,185,263,1.3802281368821292,0.03921729838341666,651,I'm not liking that blood pressure.
8695,1307,21,50,171,242,1.3801652892561984,0.04120555501311258,651,"Next time, just remember, what goes around comes around."
7466,1307,15,62,165,242,1.3801652892561984,0.03862827336434841,651,"Two rats a day, given orally, should gradually relieve that constricting sensation"
7048,1307,21,50,171,242,1.3801652892561984,0.04120555501311258,651,Your insurance won't cover you until there's a fifth coil.
2163,1307,22,48,172,242,1.3801652892561984,0.04161958842592372,651,Not all of these “Natural Slimming Aids “ work.
3006,1307,22,48,172,242,1.3801652892561984,0.04161958842592372,651,"Okay sir, the chart says you are 46 years old, currently employed as a civil serpent..sorry, servant."
1491,1307,17,58,167,242,1.3801652892561984,0.03950605341868638,651,Any trouble breathing prior to getting the snake?
9151,1313,25,45,180,250,1.38,0.041825800534615536,651,"… good length for his age, healthy skin color--- oh, you mean you-- two broken ribs and a crushed sternum."
2269,1314,21,45,163,229,1.3799126637554586,0.04286786845250694,651,"So, what exactly has brought you into the clinic today?"
8813,1314,19,49,161,229,1.3799126637554586,0.041964787677713514,651,"Everything looks good..Though I am a bit concerned 
about your blood pressure."
2059,1316,23,52,183,258,1.37984496124031,0.04012903992797637,651,The test results suggest you may be a carrier of some kind of tropical pest.
5521,1316,16,66,176,258,1.37984496124031,0.0374058493528454,651,"""""On a positive note, you'll get a very nice set of luggage out of this."""
5623,1316,29,40,189,258,1.37984496124031,0.042323975976453675,651,"So, looks like you’re no longer on cobra."
7200,1316,22,54,182,258,1.37984496124031,0.03975143598314494,651,"Unfortunately, the nearest zoo is out-of-network."
2727,1320,28,34,175,237,1.379746835443038,0.044713120218603665,651,I'd like to run some tests to see what the problem is
7930,1321,17,48,151,216,1.3796296296296295,0.042749588946442534,651,Stripping to your skivvies includes removing your boa.
8066,1322,24,45,176,245,1.379591836734694,0.0420489684073582,651,So at first she was just wrapped around your little finger?
634,1322,24,45,176,245,1.379591836734694,0.0420489684073582,651,Shortness of breath can mean any number of things.
2544,1322,26,41,178,245,1.379591836734694,0.04283722393933727,651,"When I said, ""Get it on Amazon"" I meant the website"
1148,1325,22,41,161,224,1.3794642857142858,0.044008749283508085,651,"Clarence, we've discussed this before, humans are bad for your cholesterol"
8917,1325,12,61,151,224,1.3794642857142858,0.03919675553543225,651,Any symptoms other than chest pains?
134,1325,16,53,155,224,1.3794642857142858,0.04118906884237774,651,I'm going give you something that will help you unwind.
7982,1328,20,56,177,253,1.3794466403162056,0.03951941728227818,651,"So, tell me what brings you in today."
701,1329,19,50,163,232,1.3793103448275863,0.04157229714567308,651,"Look at it this way, most people are up to their neck in debt."
883,1329,20,48,164,232,1.3793103448275863,0.04201874454103052,651,"No, that's a different kind cobra insurance."
1807,1329,27,45,189,261,1.3793103448275863,0.04124647112450963,651,"So when you got laid off you got on COBRA, and this happened?"
2314,1329,19,50,163,232,1.3793103448275863,0.04157229714567308,651,"One Mongoose, at breakfast, as needed."
5642,1329,18,52,162,232,1.3793103448275863,0.04112100299277601,651,"Dr. Oz is wrong about this, too."
3971,1334,18,55,167,240,1.3791666666666667,0.04015656105333149,651,I’m going need you to cough.
8470,1334,14,63,163,240,1.3791666666666667,0.038380716273708836,651,"So,I see that you're here for a second opinion."
4287,1336,23,48,177,248,1.3790322580645162,0.04127770454157728,651,Now I understand the need to squeeze you in.
1408,1337,22,39,158,219,1.3789954337899544,0.04473526290911836,651,Why are you here ?
4728,1338,23,51,182,256,1.37890625,0.040342834906314975,651,"I could prescribe a muscle relaxant,
for the snake of course."
4930,1339,22,42,163,227,1.3788546255506609,0.043576623460863474,651,"We'll give you some Advil for the chest pain, and some mice for the snake"""
4180,1340,20,60,184,264,1.378787878787879,0.03835112806062515,651,Well...we can still check your prostate.
3031,1341,18,53,164,235,1.3787234042553191,0.04074537762500956,651,"Well, that about wraps it up"
2732,1341,22,45,168,235,1.3787234042553191,0.04249313820311999,651,You may feel a little tightness in your chest for a few days.
7445,1343,20,66,194,280,1.3785714285714286,0.036813598318279614,651,The good news is the snake is doing very well
531,1344,18,45,151,214,1.3785046728971964,0.04352233167846746,651,"Well, you must understand sir, that this is a veterinarian's office, so of course our first concern is, 'What can we do to save this snake?'"
5486,1344,18,45,151,214,1.3785046728971964,0.04352233167846746,651,It says here there's a tightness in your chest?
6240,1344,21,39,154,214,1.3785046728971964,0.04500915753119004,651,"So, what brings you to my office?"
2803,1347,24,39,167,230,1.3782608695652174,0.04402635357542137,651,"You seem rattled, Fred."
4595,1348,22,60,193,275,1.3781818181818182,0.037976189744533595,651,The tests confirm it. It's a human stuck in your coils. That'll have to be removed.
3943,1349,22,46,170,238,1.3781512605042017,0.04209827934100238,651,"...on the other hand Brad, it looks like your constipation is no longer a problem."
7006,1349,23,44,171,238,1.3781512605042017,0.04251731816961292,651,"Our blood pressure machine is out of order, so we are using him."
8770,1351,18,57,171,246,1.3780487804878048,0.03945906499270426,651,"Well, a tightness around the chest doesn't always mean that you will die from a heart attack."
4017,1352,17,62,175,254,1.3779527559055118,0.03818835873389222,651,Any wheezing or shortness of breath?
6505,1352,26,44,184,254,1.3779527559055118,0.04169477269147195,651,This is what happens when you deny cobra coverage.
1766,1354,21,40,156,217,1.3778801843317972,0.04454685099846391,651,"Well, going out on a limb here, that tightness in your chest might not be bronchitis"
8527,1355,23,53,186,262,1.3778625954198473,0.03966598924788089,651,"No, it's not a tapeworm..."
4020,1356,14,57,154,225,1.3777777777777778,0.040061680838488774,651,I had prescribed compression socks but never mind.
4516,1356,19,47,159,225,1.3777777777777778,0.0424658800687992,651,So Eve told you that an apple a day keeps the doctor away?
8379,1358,21,63,194,278,1.3776978417266188,0.037335502929001035,651,Coils!  My nurse thought you said boils
8326,1359,17,54,162,233,1.3776824034334765,0.04052251142943547,651,"""GIVE HIM 2 RATS, 1 LIZARD AND 
CALL ME IN THE MORNING."
8999,1359,21,46,166,233,1.3776824034334765,0.0423092023647401,651,"He needs to cut down on mice, but otherwise he's in good health."
2686,1361,19,53,169,241,1.3775933609958506,0.04045022472513933,651,"At this point, it's not the cancer I would worry about."
5198,1361,17,57,167,241,1.3775933609958506,0.03958616408660468,651,"On the plus side, your foot fungus has completely cleared up."
6757,1361,19,53,169,241,1.3775933609958506,0.04045022472513933,651,What do you suppose is triggering your anxiety this time?
6862,1361,16,59,166,241,1.3775933609958506,0.039146982520754374,651,Let’s try two dead rats and call me in the morning.
7419,1361,16,59,166,241,1.3775933609958506,0.039146982520754374,651,"Unfortunately, your insurance only covers bites."
8162,1361,17,57,167,241,1.3775933609958506,0.03958616408660468,651,I'm going to prescribe an antidepressant to help you unwind.
3536,1367,17,60,172,249,1.3775100401606426,0.03870600491450346,651,So this is your comfort animal?
3877,1367,20,54,175,249,1.3775100401606426,0.039941427883460376,651,I'm going to recommend not poking it.
7402,1367,23,48,178,249,1.3775100401606426,0.04113976794171019,651,"I think I know what's causing the tightness in your chest, but just to be sure, let's do lots of tests."
7759,1367,21,52,176,249,1.3775100401606426,0.040344829611062914,651,"I'm sorry Sir, but it looks like this is a pre-existing constrictor."
7136,1371,18,61,178,257,1.377431906614786,0.038276077890173586,651,"Well, it could explain that feeling of tightness in your chest."
550,1371,18,61,178,257,1.377431906614786,0.038276077890173586,651,I highly doubt it's contagious.
5594,1371,22,53,182,257,1.377431906614786,0.039832818998834806,651,Please tell me the reason for your visit to the clinic today.
2475,1374,19,62,184,265,1.3773584905660377,0.03785715208931913,651,Your high blood pressure appears to be stress related.  I suggest you try to unwind.
3430,1374,23,54,188,265,1.3773584905660377,0.039338467459487075,651,...and one of you call me in the morning.
3659,1374,16,68,181,265,1.3773584905660377,0.03670695671127445,651,"So, you’re experiencing some tightness in your chest?  Let me run a few tests and see if I can figure out what’s going on."
1469,1377,25,56,200,281,1.3772241992882561,0.03839931388059317,651,I'm afraid the emotional support snake will have to come off as well.
2042,1378,18,50,160,228,1.3771929824561404,0.041598732046294586,651,The good news is that I figured out why you have shortness of breath.
3336,1378,16,54,158,228,1.3771929824561404,0.040659178330764184,651,When did you last feed him?
3919,1380,19,51,166,236,1.3771186440677967,0.041045751407205976,651,It's not as rare as people think.
4383,1380,21,47,168,236,1.3771186440677967,0.04191512569412086,651,"Don't shoot the messenger, you won't believe the things your HMO excludes."
5896,1380,18,53,165,236,1.3771186440677967,0.04060408454695478,651,"Your vitals are fine, but I suggest you take a few days off and unwind."
5634,1383,15,62,167,244,1.3770491803278688,0.03837404792261844,651,‘So a little tightness in your chest?’
669,1383,17,58,169,244,1.3770491803278688,0.039243219552055564,651,"Well, the good news is it isn’t venomous."
974,1383,21,50,173,244,1.3770491803278688,0.04092622306660699,651,"Yeah, this has been going around."
4462,1383,19,54,171,244,1.3770491803278688,0.04009355319317876,651,I am prescribing a muscle relaxer for you and a small gazelle for the snake.
2511,1387,23,49,180,252,1.376984126984127,0.040779593049296556,651,"Okay, and what seems to be the problem today?"
6973,1387,20,55,177,252,1.376984126984127,0.039599451368302105,651,"Any coughing, wheezing or tightening of the chest?"
2179,1387,17,61,174,252,1.376984126984127,0.03838304167304633,651,I’m prescribing something to unwind you.
1152,1390,20,61,187,268,1.376865671641791,0.03792816334852929,651,First the good news - that tightness in your chest is not a heart attack.
6970,1391,29,52,211,292,1.3767123287671232,0.038593408225339236,651,"So far, nothing obvious. We'll have to do more tests."
1167,1392,19,49,163,231,1.3766233766233766,0.04166535278947096,651,"I see, any other complaints?"
5221,1392,21,45,165,231,1.3766233766233766,0.04255923701007627,651,"So Mr. Johnson, what brings you here today?"
2412,1394,14,62,163,239,1.3765690376569037,0.03845326800650906,651,"First, the mole on your back is no longer a problem."
6335,1394,22,46,171,239,1.3765690376569037,0.04195161358186673,651,You appear to be constricted.
8177,1394,23,44,172,239,1.3765690376569037,0.042368601461931645,651,"Removing the snake is doable... getting you “back to the garden”, not so much."
7156,1397,16,64,175,255,1.3764705882352941,0.03765940819529786,651,I’m ordering a PET scan to help diagnose the cause of your constriction
908,1398,25,49,189,263,1.376425855513308,0.04026835076699904,651,"Besides that, is everything else normal?"
8384,1399,17,45,148,210,1.3761904761904762,0.04356021865615861,651,And why have you come in today?
8293,1400,15,55,156,226,1.3761061946902655,0.04040867276754292,651,If it's not bothering you we won't do anything right now.
2267,1401,16,56,162,234,1.376068376068376,0.03992445061402587,651,We'll have to run some tests.
2578,1402,18,55,169,242,1.3760330578512396,0.03988534021982821,651,The good news is you’re not in danger. The bad news is you’re endangered.
6831,1403,24,46,180,250,1.376,0.04139262491785658,651,"The next time you dress in drag Mr. Jones, Id try a feather boa."
1985,1404,21,55,182,258,1.375968992248062,0.03932341243739693,651,"Now that we've cured your fear of snakes, is there anything else we can help you with?"
4610,1405,20,49,168,237,1.3755274261603376,0.04133794936765315,651,Your insurance says they only cover snake bites.
4215,1406,20,52,173,245,1.3755102040816327,0.040375674223404316,651,"We can help you with the Full Monty, but not the Python."
2201,1407,20,58,183,261,1.3754789272030652,0.03861801131249627,651,Don't worry.  It's going around.
2291,1408,29,46,202,277,1.3754512635379061,0.04010285209029256,651,Difficulty breathing...feeling the world is closing in on you...sounds like a anxiety. I’ll give you something to help unwind.
6321,1409,19,49,164,232,1.375,0.041517122293085656,651,"Sorry, but with your insurance this is the only pet scan they will pay for"
7243,1409,32,32,192,256,1.375,0.04358336613802987,651,"Yeah, man, you’re fucked."
6087,1409,22,49,177,248,1.375,0.040831159949587324,651,You do understand he doesn’t think of himself as a pet?
454,1409,20,53,175,248,1.375,0.04002354178589936,651,I notice your blood pressure is a bit high.
6900,1409,19,55,174,248,1.375,0.039613558716897125,651,Maybe we could move your service viper to the chair”
5650,1409,19,55,174,248,1.375,0.039613558716897125,651,Why don't you take a week off work and go and unwind somewhere?
6139,1409,20,53,175,248,1.375,0.04002354178589936,651,"I need you to take everything off, Mr Cooper please."
2968,1409,26,53,201,280,1.375,0.03880330352646965,651,And what happened to the gerbil?
4500,1409,17,59,172,248,1.375,0.0387805919046616,651,"What do you mean, 'I think I came home with something from Africa?'"
6506,1418,20,63,192,275,1.3745454545454545,0.03722665351164967,651,I found out the reason of your discomfort. You have a human tangled up in your coils.
635,1418,24,55,196,275,1.3745454545454545,0.03862635023838171,651,So tell me when you noticed this tightness in your chest.
5695,1418,26,51,198,275,1.3745454545454545,0.03930751242789331,651,Wear it for three days and your constipation will be gone.
9112,1421,21,55,183,259,1.3745173745173744,0.039198178294966586,651,Restricted movement. Any other symptoms?
5202,1422,24,46,181,251,1.3745019920318724,0.041254590520667545,651,"Well Mr. Jones, you say you are experiencing tightness in the chest. As you may know, that has many causes. Let’s get a CT, MRI,EKG, sonogram, upper endoscopy, colonoscopy, cardiac cath, some blood work and we’ll get to the bottom of this."
2436,1422,23,48,180,251,1.3745019920318724,0.04086647438999103,651,It says here you would like something removed.
7025,1424,24,43,176,243,1.374485596707819,0.04223982095405146,651,I think we’ll skip the prostate exam today.
5817,1424,15,61,167,243,1.374485596707819,0.038446212544907474,651,You can get dressed now.  I think I've discovered your problem.
1479,1424,16,59,168,243,1.374485596707819,0.03888600511840264,651,Maybe the insurance code for vasoconstriction is close enough
4926,1427,18,52,165,235,1.374468085106383,0.04069026363018805,651,So.....what are your symptoms?
6077,1427,23,42,170,235,1.374468085106383,0.04286663970939683,651,"I'm prescribing some snake oil. 
After a few days, you should be able to slip right out of its grip."
3590,1429,20,45,162,227,1.3744493392070485,0.042616237989167,651,"I’ll endorse your emotional support python, but I make no guarantees about snakes on a plane."
7408,1429,17,51,159,227,1.3744493392070485,0.04122122312173243,651,I’ll just prescribe a little something to help you both relax.
3891,1431,21,40,158,219,1.3744292237442923,0.04420618922109362,651,Any tightness in your chest....difficulty breathing?
7414,1432,23,55,192,270,1.374074074074074,0.03877842075875455,651,Next of Kin: Eve
5532,1433,25,42,179,246,1.3739837398373984,0.04225152743018288,651,Does it feel any better if you lie on a warm road?
4384,1433,22,48,176,246,1.3739837398373984,0.041056540943620344,651,"I see you told the nurse that you're feeling a tightening in your chest, is that right?"
5265,1433,20,52,174,246,1.3739837398373984,0.04024017325554516,651,"Offhand, I'd say you're not actually paranoid."
2414,1436,21,44,165,230,1.373913043478261,0.04265791494705235,651,How long have you have you had this feeling of tightness in your chest?
6254,1436,22,42,166,230,1.373913043478261,0.04310069590929339,651,"I would be a bit more cautious on Tinder in the future"""
5920,1438,17,46,151,214,1.3738317757009346,0.0429521014942285,651,"Tightness in your chest can be caused by many things, so let's not jump to conclusions until we've run a few tests."
414,1439,18,60,179,257,1.3735408560311284,0.038226601601417436,651,You said it's 'slowly squeezing the life out of you'. Sounds like my ex.
227,1440,16,61,172,249,1.3734939759036144,0.03823264323109754,651,"No, it’s not in your head ... this relationship is definitely suffocating you."
861,1440,17,59,173,249,1.3734939759036144,0.038653882384728465,651,It says here you're having trouble breathing?
3848,1440,17,59,173,249,1.3734939759036144,0.038653882384728465,651,"So tell me, Mr. Jones, when did you first notice you had difficulty breathing?"
3029,1440,20,53,176,249,1.3734939759036144,0.03989091962264747,651,It's never the obvious reason. Let's run a few tests to see why you're short of breath.
8921,1444,26,38,177,241,1.3734439834024896,0.043289298596657734,651,It says here Adam that you had a bad reaction to an apple.
6515,1444,22,46,173,241,1.3734439834024896,0.04166114240566654,651,"I know men wear boas these days, but yours is a bit constricting, no?"
5444,1444,19,52,170,241,1.3734439834024896,0.0403969843764507,651,"Yes, difficulty in breathing, and what else?"
3691,1444,22,46,173,241,1.3734439834024896,0.04166114240566654,651,"I have a hunch about your shortness of breath, but your insurance company requires more tests."
7801,1448,19,46,160,225,1.3733333333333333,0.042407696216756434,651,I'm recommending that you switch to a feather boa.
1877,1448,20,44,161,225,1.3733333333333333,0.04287301293465667,651,"OK, so the inhaler didn’t work."
3040,1450,30,43,203,276,1.3731884057971016,0.04051083464159121,651,So tell me what the problem is.
1298,1451,27,43,190,260,1.373076923076923,0.04129107713667564,651,"Look...it's your choice. Do you want to feel embraced & loved, or do you want to breathe?"
1075,1452,20,51,173,244,1.3729508196721312,0.04045995490170807,651,"I can prescribe a muscle relaxant, but you have to figure out how to give it to the snake."
3703,1453,22,44,170,236,1.3728813559322033,0.042289857357339394,651,I don’t think I can treat this. It’s an endangered species.
7792,1454,15,68,180,263,1.3726235741444868,0.03643689971817292,651,"Hmm, shortness of breath.  Anything else?"
985,1455,22,51,182,255,1.3725490196078431,0.0399953376812829,651,Feeling any tightness in your chest?
3589,1455,23,49,183,255,1.3725490196078431,0.040379518686697875,651,"In fact, it is the opposite of a tape worm."
8332,1457,23,46,178,247,1.3724696356275303,0.04131825833031164,651,"Your cholesterol is down, but your blood pressure is out of control."
4611,1457,18,56,173,247,1.3724696356275303,0.03927622597576678,651,Have you noticed any other symptoms?
6927,1457,17,58,172,247,1.3724696356275303,0.03885494328897319,651,"Take 3 aspirin,give him 3 rabbits,and call me in the morning."
3394,1460,22,45,172,239,1.3723849372384938,0.041898978857135255,651,"This isn't even covered in Canada, unfortunately."
5552,1460,19,51,169,239,1.3723849372384938,0.040620720157543644,651,"Ok, give him two mice and call me in the morning."
2192,1460,17,55,167,239,1.3723849372384938,0.03974571537514465,651,"Everything seems to be perfectly normal, was there a specific reason for your visit today?"
5280,1463,20,46,165,231,1.3722943722943723,0.04205852267519032,651,It's actually good he has you covered -- his plan's deductible is much lower.
7306,1463,19,48,164,231,1.3722943722943723,0.04160860264074141,651,And you ate the entire apple?
501,1465,17,65,184,266,1.3721804511278195,0.03693347981593816,651,Have you tried asking nicely?
8395,1466,21,54,183,258,1.372093023255814,0.039275070209726086,651,"And, on a scale of one to ten, how would you rate the discomfort?"
3438,1467,21,48,173,242,1.371900826446281,0.04110225689369963,651,"Your blood work looks fine, however there appears to be a circulation problem."
1046,1467,18,54,170,242,1.371900826446281,0.03983112340044867,651,"After ruling out all the possibilities, I have concluded that he just really likes you"
1308,1467,21,48,173,242,1.371900826446281,0.04110225689369963,651,"I’m not worried about your medical coverage
I can see you have COBRA"
2536,1467,17,56,169,242,1.371900826446281,0.03939829964017652,651,I'm afraid you've got the Grippe
5414,1467,20,50,172,242,1.371900826446281,0.04068295890113012,651,Compression stockings should take care of those cold feet.
7889,1467,16,58,168,242,1.371900826446281,0.03896066782965221,651,"Don't be modest, take off the snake."
6013,1473,20,47,167,234,1.3717948717948718,0.041666137589652076,651,"I've got some pills for that, but you might have a hard time swallowing them."
4399,1473,18,51,165,234,1.3717948717948718,0.040776244817393184,651,You are fine but the boa needs to unwind.
108,1473,20,47,167,234,1.3717948717948718,0.041666137589652076,651,"Get more exercise, eat more vegetables, and avoid the Amazon river basin."
1360,1476,16,52,158,226,1.3716814159292035,0.04083175568849151,651,"Well, if it’s any consolation, it seems to like you."
8978,1476,22,40,164,226,1.3716814159292035,0.04362591515595552,651,I’ll write the note but have you considered a therapy dog instead?
7481,1478,17,63,181,261,1.371647509578544,0.037405976354892734,651,Soooo . . .  a general tightness in the chest?
703,1478,21,55,185,261,1.371647509578544,0.03894992734428372,651,Ha! Everyone's a doctor after they've googled their symptoms.
1211,1480,15,64,174,253,1.3715415019762847,0.037378134756488685,651,"On a positive note, he's bulimic."
191,1481,18,42,150,210,1.3714285714285714,0.044014893041915484,651,Well at least it isn't a frog in the throat.
5209,1481,22,47,176,245,1.3714285714285714,0.04114454849502931,651,I see here that you're out of work. Do you by any chance have COBRA?
240,1481,20,51,174,245,1.3714285714285714,0.04032321738346157,651,"Chest tightness, difficulty breathing,...any other symptoms?"
80,1484,21,46,170,237,1.371308016877637,0.04171399611445369,651,"So what seems to be the problem today?"""
489,1484,18,52,167,237,1.371308016877637,0.04040772642057293,651,I’ll write a prescription for a deconstrictant.
6570,1484,18,52,167,237,1.371308016877637,0.04040772642057293,651,So this is what you meant when you said  you were constricted
2076,1484,19,50,168,237,1.371308016877637,0.04084779137561129,651,A scarf during cold and flu season. A boa is merely affectation
1366,1484,22,44,171,237,1.371308016877637,0.042140422133887724,651,I had to Google this one.
3409,1484,21,46,170,237,1.371308016877637,0.04171399611445369,651,"A little tight, but much better than those gowns that leave you naked in the back"
6534,1490,18,49,162,229,1.3711790393013101,0.0413908626378985,651,"Insurance is denying your claim, as only they have the legal right to squeeze you."
8661,1490,15,55,159,229,1.3711790393013101,0.03997858675179234,651,I've run some tests and think I've found the cause of your high blood pressure
2914,1492,23,49,184,256,1.37109375,0.040247795151445206,651,I’m prescribing snake oil
8128,1492,22,51,183,256,1.37109375,0.039865370431625684,651,"So, what about ""Don't Tread on Me"" did you not understand?"
7794,1494,18,46,157,221,1.3710407239819005,0.04244062337445412,651,"Well, The good news is the tightness in your chest is not the result of a heart attack"
3936,1495,25,42,181,248,1.3709677419354838,0.041964105521805864,651,"I changed my mind, could you please put the shirt back on?"
6919,1495,22,48,178,248,1.3709677419354838,0.04078034531037629,651,"Well, the symptoms you describe could be caused by any number of things"
1206,1497,16,57,167,240,1.3708333333333333,0.039167556890681236,651,And you first noticed this when?
7212,1497,21,47,172,240,1.3708333333333333,0.04133321945141103,651,Give the snake one or two of these muscle relaxants when you find you can’t breathe
9240,1499,14,58,160,232,1.3706896551724137,0.039145001278296766,651,Which one of you is known as Monty?
2533,1500,23,50,186,259,1.3706563706563706,0.03990669365247954,651,One prescription for an Emotional Support mongoose.
4098,1501,21,41,162,224,1.3705357142857142,0.043436412920203185,651,We're gonna need insurance pre-authorzation for an anacondectomy...
8768,1502,24,45,182,251,1.3705179282868525,0.04120531290335398,651,I'm referring you to a veterinarian. I suspect your snake is suffering from a treatable case of separation anxiety.
1455,1502,24,45,182,251,1.3705179282868525,0.04120531290335398,651,I see they squeezed you in
4696,1502,18,57,176,251,1.3705179282868525,0.03881549628308718,651,You say you signed up for Cobra health?
4587,1505,25,40,178,243,1.3703703703703705,0.042589598116745855,651,It doesn't matter--your COBRA coverage has still expired.
1757,1505,18,54,171,243,1.3703703703703705,0.03969638425101548,651,I’m going to have to refer you to a veterinarian.
8372,1505,21,48,174,243,1.3703703703703705,0.040961363840392055,651,"You'll have to uncoil your emotional support animal 
so we can proceed."
5090,1505,24,42,177,243,1.3703703703703705,0.04218843126647027,651,"Mr. Johnson, based on all these tests, I feel the cause of your high blood pressure is stress."
9026,1505,21,48,174,243,1.3703703703703705,0.040961363840392055,651,I might suggest a different emotional support animal for your stress.
1177,1510,19,59,184,262,1.3702290076335877,0.03806616831805203,651,Let's start with a few questions about your lifestyle.
3216,1510,23,51,188,262,1.3702290076335877,0.03957300875026667,651,Have you travelled outside of the US in the past month?
5727,1510,20,57,185,262,1.3702290076335877,0.038448415223528674,651,"No, I said a RESTRICTED diet."
4003,1510,23,51,188,262,1.3702290076335877,0.03957300875026667,651,This certainly could be the reason you’re constipated.
324,1514,25,37,173,235,1.3702127659574468,0.043653708751028523,651,How long has this man been bothering you?
1036,1515,20,54,180,254,1.3700787401574803,0.039292195224239795,651,Let's start from the beginning. Do you have any allergies?
5855,1515,22,50,182,254,1.3700787401574803,0.04007644931027046,651,"I'm glad to report we've ruled out asthma"""
5535,1517,19,46,162,227,1.3700440528634361,0.042097250076307845,651,And how long have you had trouble swallowing?
4151,1518,20,51,175,246,1.3699186991869918,0.04018734094493834,651,...and what can I help you with today?
4940,1518,19,53,174,246,1.3699186991869918,0.03977233167561686,651,You're covered but I'm afraid the snake is out of network.
7760,1518,20,51,175,246,1.3699186991869918,0.04018734094493834,651,"Yeah, that's the problem with our new hospital gowns. Everybody sees your asp."
8759,1518,16,59,171,246,1.3699186991869918,0.03850047208784529,651,We'll know more when the tests come in but I'll bet this is something tropical.
4310,1522,20,48,170,238,1.3697478991596639,0.04113893395035239,651,Have you been under any unusual pressure lately?
315,1523,23,49,185,257,1.3696498054474708,0.040116877761869854,651,"So you say your symptoms are shortness of breath, loss of mobility and trouble sleeping?"
4896,1523,12,71,174,257,1.3696498054474708,0.03570681618161628,651,"On the plus side, it's not poisonous."
5871,1525,18,49,163,230,1.3695652173913044,0.041242096324523775,651,"I'll get to the snake in a minute, did you give us a copy of the front and back of your insurance card?"
3238,1525,18,49,163,230,1.3695652173913044,0.041242096324523775,651,"Frankly, when you phoned the ER about the boa wrapped around your neck, we assumed feathers and alerted Psychiatry."
8175,1527,22,48,179,249,1.3694779116465863,0.04064355341896876,651,"You're going to be just fine, but the snake has got to stop smoking."
6595,1527,13,66,170,249,1.3694779116465863,0.03688373489407314,651,Take a mongoose and call me in the morning
7551,1527,20,52,177,249,1.3694779116465863,0.0398387148960468,651,I suggest we try a muscle relaxant.
5291,1527,25,42,182,249,1.3694779116465863,0.04182177996509315,651,You're right; there IS a lot of it going around.
334,1531,24,51,193,268,1.3694029850746268,0.03928427544222602,651,What seems to be the problem?
82,1532,21,40,161,222,1.3693693693693694,0.04370431435106815,651,The good news is that it will let you go once mating season ends.  The bad news is that you are pregnant.
4699,1533,21,54,185,260,1.3692307692307693,0.03902468626793499,651,Besides the tightness in your chest do you have any other complaints?
2591,1533,16,64,180,260,1.3692307692307693,0.037073251675710954,651,I'm going to prescribe two mice and check with you in the morning.
4945,1535,22,59,198,279,1.3691756272401434,0.037483381290335446,651,I don't think you'll need a follow-up appointment.
8091,1535,29,45,205,279,1.3691756272401434,0.03981839566881677,651,We use this for blood pressure when the nurse is off.
8360,1535,26,51,202,279,1.3691756272401434,0.03883487047454681,651,You're in very good health Mr. President.
8481,1538,20,39,155,214,1.3691588785046729,0.044394543968387504,651,I think you should reconsider your support animal choices.
4971,1539,20,46,167,233,1.3690987124463518,0.041757648104934555,651,Would you say it’s pain or just pressure?
1355,1539,21,44,168,233,1.3690987124463518,0.04219833934295869,651,Now just relax while Mr. Slinky takes your blood pressure.
8514,1539,19,48,166,233,1.3690987124463518,0.04131225613795009,651,Your cholesterol and blood sugar look fine. Its the venom levels that concern me.
355,1539,22,42,169,233,1.3690987124463518,0.04263447561952,651,"Well, I would say get rid of it, 
if it doesn't spark joy!"
7336,1539,18,50,165,233,1.3690987124463518,0.040862009729816816,651,Self medicating I see.
2588,1544,25,43,184,252,1.369047619047619,0.041450982539962676,651,Your insurance will only cover this if you become unable to breathe.
5027,1545,19,62,190,271,1.3690036900369005,0.037171343452144824,651,"Other than that, you're in great shape."
5226,1545,22,56,193,271,1.3690036900369005,0.038258457810600645,651,"Sorry, your HMO only covers anacondas."
8262,1547,15,53,157,225,1.3688888888888888,0.04042978977480055,651,Have you tried charming it?”
8522,1548,17,56,171,244,1.3688524590163935,0.0391338625318623,651,We figured out the tightness in your chest.
467,1548,19,52,173,244,1.3688524590163935,0.03998652177304392,651,Any numbness or tingling in lower extremities?
1411,1548,17,56,171,244,1.3688524590163935,0.0391338625318623,651,OK...other than that anything else...?
7149,1551,19,66,197,282,1.3687943262411348,0.03616573377834926,651,Just learn to relax and unwind.
2051,1552,21,45,170,236,1.36864406779661,0.04180561505449541,651,I'm having trouble finding the code under your insurance whereby I get paid.
5412,1552,13,61,162,236,1.36864406779661,0.03819964969207775,651,Now you might feel a little squeeze.
865,1554,21,52,182,255,1.3686274509803922,0.03955695264833934,651,I want you to take two mongooses and call me in the morning.
2333,1554,16,62,177,255,1.3686274509803922,0.037554760512820265,651,I said a RE-stricted diet.
744,1556,25,48,193,266,1.368421052631579,0.039841994788918166,651,I'm going to need you to get undressed.
7921,1556,18,55,174,247,1.368421052631579,0.039221901985762614,651,"OK, good. Now breathe out."
8550,1556,17,50,161,228,1.368421052631579,0.041011967074142903,651,But the good news is your hernia seems to have stabilized.
7130,1559,19,50,170,239,1.3682008368200838,0.040564545334205594,651,"No, I indicated compression socks."
2332,1560,20,59,190,269,1.3680297397769516,0.03771865285294716,651,"No, that pressure you feel is a snake wrapped around your body. Any other questions?"
5344,1561,21,50,179,250,1.368,0.04010908819486293,651,I'm prescribing a mild muscle relaxant...
8993,1562,20,45,166,231,1.367965367965368,0.04200036382366501,651,Sorry Mr. Johnson... this time I'll write ASP-irin more clearly.
1443,1562,15,55,161,231,1.367965367965368,0.03969651095245401,651,I’m going to start you out on four mice three times a day and we’ll see if that doesn’t reduce the pressure
442,1562,18,49,164,231,1.367965367965368,0.04109432478471276,651,I'll be giving you a letter that should allow you to fly with the support boa.
6337,1565,23,43,176,242,1.3677685950413223,0.04187501162052249,651,"Ok, Let's start with your date of birth please."
353,1566,19,55,179,253,1.3675889328063242,0.03896808511732175,651,You must have heard me wrong; I said  RESTRICTED diet.
7645,1566,23,47,183,253,1.3675889328063242,0.04054614709264969,651,We just need to squeeze one more urine sample out of you and then we'll be done.
9119,1568,9,68,157,234,1.3675213675213675,0.03643870088442369,651,The good news is it’s not poisonous.
5905,1569,23,58,202,283,1.3674911660777385,0.03742536679770554,651,I don't like the look of these blood pressure numbers.
5903,1570,22,46,177,245,1.3673469387755102,0.04109141159531212,651,They didn't kick you off the plane because of your emotional support python. They kicked you off because you weren't wearing pants.
2607,1570,17,56,172,245,1.3673469387755102,0.03900287271638522,651,"Don't worry, he's just taking your blood pressure."
4326,1572,21,41,164,226,1.3672566371681416,0.04311328269615558,651,What brings you in today Mr. York?
9108,1573,21,63,202,286,1.367132867132867,0.03647635484331582,651,"If this doesn’t work, we'll talk about liposuction."
392,1574,13,61,163,237,1.3670886075949367,0.03806991800995333,651,"So, how's the new zookeeper's job going?"
2082,1574,21,45,171,237,1.3670886075949367,0.0416578960530815,651,We find the boa keeps you warmer than the paper gowns
8916,1574,14,59,164,237,1.3670886075949367,0.03853668853274975,651,There’s nothing to worry about.  It’s nonvenomous.
2205,1577,21,38,159,218,1.3669724770642202,0.044253367108753966,651,You'll need to lose your support animal
3131,1578,20,44,165,229,1.3668122270742358,0.042246846982216216,651,I'm cancelling your appointment for next week.
1637,1578,15,54,160,229,1.3668122270742358,0.03991577667882879,651,I ‘m going to prescribe muscle relaxers...
8926,1578,17,50,162,229,1.3668122270742358,0.040864164847699946,651,"His blood pressure is great. Yours, on the other hand..."
7155,1581,21,53,185,259,1.3667953667953667,0.039099291605975105,651,This is our new intern - he’ll be taking your blood pressure.
295,1582,17,54,169,240,1.3666666666666667,0.03955235336157465,651,You say you feel a tightness in your chest?
2719,1582,21,57,192,270,1.3666666666666667,0.03796778999679609,651,This seems to be a case of bowel constrictor.
5312,1584,25,42,184,251,1.3665338645418326,0.041539859313043326,651,I am writing you a prescription to help with the contractions.
6882,1584,21,50,180,251,1.3665338645418326,0.039975866118281855,651,You may want to try snake oil.
7687,1584,24,44,183,251,1.3665338645418326,0.041154433561735156,651,Any trouble being swallowed?
1790,1587,16,49,156,221,1.3665158371040724,0.041394902977105276,651,The good news is that it’s not a skin condition.
4837,1587,19,43,159,221,1.3665158371040724,0.042859584671843316,651,And what is your primary complaint?
465,1589,19,58,185,262,1.366412213740458,0.03801554790319483,651,"Good news, bad news- You have high blood pressure, but we think we know the cause."
3740,1590,18,49,165,232,1.3663793103448276,0.04094753929617789,651,"This particular snake is on the endangered species list, so you are just going to have to learn to live with it."
5462,1590,19,47,166,232,1.3663793103448276,0.04140072435656503,651,"Your temperature is fine, but he's running a bit cold."
8118,1592,23,43,177,243,1.3662551440329218,0.04172978428889173,651,"Your name wouldn't be Monty, by any chance?"
3736,1592,20,49,174,243,1.3662551440329218,0.040488819342341005,651,"Yup, it's herpetitis."
4654,1592,20,49,174,243,1.3662551440329218,0.040488819342341005,651,"All your presenting symptoms point to hypoanacondria, but since you're here let's take a look."
5064,1595,12,54,147,213,1.3661971830985915,0.04032724993590331,651,"You've got coil-itis."""
7162,1596,20,53,181,254,1.3661417322834646,0.039239926786976374,651,Ok. So everything looks fine. I'll see you next year.
4804,1596,19,55,180,254,1.3661417322834646,0.03884133445645004,651,Good news. The snake is going to be ok.
8707,1598,18,50,167,235,1.3659574468085107,0.040574089838473895,651,"I see you checked ""chest tightness"""
1103,1598,18,50,167,235,1.3659574468085107,0.040574089838473895,651,"It's our new organic blood pressure cuff,  from Florida.  You will feel  some tightening."
8646,1598,21,44,170,235,1.3659574468085107,0.04189710626796522,651,I'm afraid all things point to Monty Python Disease.
2180,1601,20,61,195,276,1.3659420289855073,0.03702362865372041,651,"So, Mr. Clark, what brings you in today?"
4191,1601,28,45,203,276,1.3659420289855073,0.03976874108836167,651,"Sorry, your Cobra doesn't cover boa."
4695,1603,23,44,179,246,1.3658536585365855,0.0413544474320591,651,"No, it's not herpes; it's herpetology."
5178,1603,23,44,179,246,1.3658536585365855,0.0413544474320591,651,Are you a smoker?
7532,1603,18,54,174,246,1.3658536585365855,0.03929720468256915,651,"No, the epinephrine is for your anaphalaxisis- the rat is for the anaconda."
2582,1606,15,49,152,216,1.3657407407407407,0.04153246643693446,651,Any unhealthy attachments?
3140,1607,21,41,165,227,1.3656387665198237,0.042953416080237,651,You say you’re feeling short of breath. Any other symptoms?
4126,1607,24,35,168,227,1.3656387665198237,0.04429390993872222,651,I recommend staying off that motherfucking plane.
3018,1609,22,43,173,238,1.365546218487395,0.04193606396444889,651,How may I help you?
1953,1609,18,51,169,238,1.365546218487395,0.04020950854435097,651,Your blood pressure is high.  Any pressing concerns?
1091,1611,26,54,210,290,1.3655172413793104,0.037721650940716674,651,Congratulations! It’s a boa.
6478,1612,22,47,180,249,1.3654618473895583,0.04059071445547209,651,"I recommend switching to a feather boa. It might not make as strong a fashion statement, but it's easier on the heart and lungs."
8409,1612,18,55,176,249,1.3654618473895583,0.038962233510176726,651,"For starters, you are wound too tight."
5507,1612,19,53,177,249,1.3654618473895583,0.03937566831277371,651,I'd like to run a few tests to rule out some of the more serious causes of shortness of breath.
5103,1612,20,51,178,249,1.3654618473895583,0.03978480702546645,651,As soon as nurse Python has finished taking your blood pressure we'll check those hemorrhoids.
4415,1612,23,45,181,249,1.3654618473895583,0.04098772639439402,651,I see you're already familiar with health insurers and the pharmaceutical industry.
1947,1612,17,57,175,249,1.3654618473895583,0.0385443643756841,651,This is my first prescription for snake oil.
4782,1612,20,51,178,249,1.3654618473895583,0.03978480702546645,651,"Snake or no snake, bend over."
72,1619,20,55,185,260,1.3653846153846154,0.03859125734063736,651,"Unfortunately, your insurance doesn't cover snake coil."
2255,1620,15,58,168,241,1.3651452282157677,0.03853004878921626,651,Other symptoms besides tightness in the chest?
1116,1621,16,60,176,252,1.3650793650793651,0.037807467234821625,651,"Sometimes you eat the thing, sometimes the thing eats you. . .very simple really."
2424,1621,26,40,186,252,1.3650793650793651,0.04178037953431194,651,Have you been under a lot of pressure?
5455,1621,18,56,178,252,1.3650793650793651,0.03863474712970073,651,I need you to try to swallow for me.
5867,1621,20,52,180,252,1.3650793650793651,0.03944468015892292,651,"For a herpetologist, you're WAY too wrapped-up in your work."
6807,1621,19,54,179,252,1.3650793650793651,0.03904181398587703,651,"It's better than the lap band.  After the first week, you won't mind the calorie restriction at all."
4410,1626,22,52,189,263,1.3650190114068441,0.03902829825500329,651,It says here you have tightness in the chest.
8634,1626,14,68,181,263,1.3650190114068441,0.03593059526011003,651,You?  You're fine.  But I'd like to run some tests on the boa.
7103,1628,14,49,148,211,1.3649289099526067,0.04165945970629895,651,Your toenail fungus seems to have cleared up. Is there anything else I can help you with?
7050,1629,17,47,158,222,1.364864864864865,0.04173237555249073,651,Blood pressure is high - but understandable.
5640,1630,19,47,167,233,1.3648068669527897,0.041252635523551504,651,I'm impressed you managed to get your gown off.
6560,1631,24,41,179,244,1.3647540983606556,0.041989115656340344,651,"Like I told you Monty, you can't bring your human to the vet."
8843,1631,19,51,174,244,1.3647540983606556,0.03993030198349341,651,"Well right off the bat, I think we'll rule out bronchitis and pneumonia"
3125,1631,22,45,177,244,1.3647540983606556,0.041177944421232425,651,I'm going to back off on the vasoconstrictor medication.
5617,1631,20,49,175,244,1.3647540983606556,0.04035046938902555,651,"As your vet, I must advise against eating any more humans."
6281,1635,25,43,187,255,1.3647058823529412,0.0410383886492127,651,"Like I said, snake strangulations are only covered under the Double Platinum HMO plan, and you only have the Triple Gold PPO. But you can update your plan during your employer's open enrollment next January."
4861,1636,18,42,154,214,1.3644859813084111,0.04332756822268517,651,And when did this numbness start?
2016,1637,13,60,163,236,1.3644067796610169,0.0381365949301465,651,In a way I’m jealous because I could really use a hug.
4898,1637,19,48,169,236,1.3644067796610169,0.040875078385019324,651,"Unfortunately, your insurance only covers domestic serpents."
5729,1637,18,50,168,236,1.3644067796610169,0.040431547166730766,651,Any travel abroad recently?
8870,1637,22,42,172,236,1.3644067796610169,0.04217769686741055,651,"If we don't take any action, I'm afraid that this coil may be mortal."
286,1637,16,54,166,236,1.3644067796610169,0.0395295579651958,651,"I'm afraid the news will be hard to digest, Mr. Beckley. Well, for you anyway."
9067,1642,20,50,177,247,1.3643724696356276,0.03999738268090089,651,So you're telling me you can't sleep because of a hissing noise?
9034,1643,22,50,186,258,1.3643410852713178,0.03955684942748351,651,"Believe it or not, the best thing for this is good old-fashioned snake oil.  You'll slide out in no time."
3359,1643,19,56,183,258,1.3643410852713178,0.03839602568198237,651,"His blood pressure is perfect; yours, on the other hand....."""
3851,1643,22,50,186,258,1.3643410852713178,0.03955684942748351,651,"So what's the problem, sir?"
2409,1643,21,52,185,258,1.3643410852713178,0.03917373040456514,651,"So, is this your way of saying you're covered thru COBRA?"
5138,1643,27,40,191,258,1.3643410852713178,0.041419322190541195,651,"No, tapeworms are slightly different."
5550,1648,21,41,166,228,1.3640350877192982,0.04279466746723517,651,"Now, do you smoke?"
8889,1649,14,59,166,239,1.3640167364016735,0.038274954167712066,651,"Shortness of breath and constant hissing"". 'Is this all that's been bothering you?"
2609,1649,15,57,167,239,1.3640167364016735,0.03873154559604084,651,Any new sources of stress in your life?
7297,1649,19,49,171,239,1.3640167364016735,0.040506476705943165,651,Stop worrying. He's fine.
8593,1649,19,49,171,239,1.3640167364016735,0.040506476705943165,651,I am writing you a prescription for Xanax and some feeder mice.
1472,1653,22,47,181,250,1.364,0.040454446591147226,651,"You know, there are more effective treatments for constipation."
928,1653,19,53,178,250,1.364,0.039245085129571436,651,Give her one mouse three times daily.
984,1655,21,53,187,261,1.3639846743295019,0.03884977830907114,651,This shortness of breath; is it new?
5826,1655,29,37,195,261,1.3639846743295019,0.04177421238980273,651,"I can prescribe you Snake Oil, but it is not covered by insurance."
1057,1657,28,43,201,272,1.3639705882352942,0.04017390021622851,651,I think  it must have been my penmanship on that last prescription. Let’s try again.
1112,1658,18,60,186,264,1.3636363636363635,0.037394647704761204,651,"So, does it really feel like a constriction, or is it more a sharp radiating pain?"
2390,1658,19,54,180,253,1.3636363636363635,0.038913956117299905,651,What does Eve say?
2603,1658,19,54,180,253,1.3636363636363635,0.038913956117299905,651,Many of my patients prefer it to a suppository.
4321,1658,19,46,166,231,1.3636363636363635,0.0414889782734314,651,You felt fine when you got on the plane. Then what?
5147,1658,17,46,157,220,1.3636363636363635,0.04198012212925236,651,"No, Mr. Carlson, tightness in the chest and shortness of breath are not always symptoms of a heart attack."
7069,1658,21,42,168,231,1.3636363636363635,0.04238658219274153,651,Well it's not your appendix.
8477,1658,20,48,174,242,1.3636363636363635,0.04057134563485101,651,"I'm going to prescribe some snake oil, which should loosen it right up."
5021,1665,20,57,190,267,1.3632958801498127,0.037852340622416256,651,"You can't imagine how many cases like yours we see."""
251,1666,20,49,176,245,1.363265306122449,0.040213005074242726,651,He enjoys hugging all our patients.
42,1666,23,43,179,245,1.363265306122449,0.04144217408823955,651,Any other symptoms besides shortness of breath?
3321,1668,23,39,172,234,1.3632478632478633,0.04285318031351344,651,It's my fault ... on this prescription I'm writing out 'vaso-constrictor.'
6996,1668,21,43,170,234,1.3632478632478633,0.04198845296924695,651,Please make sure he is fasting when you come in for the blood tests
8339,1668,14,57,163,234,1.3632478632478633,0.0388104767033239,651,"Next time, try not to tread on it."
3136,1671,16,49,158,223,1.3632286995515694,0.04108831233947448,651,"Well, it’s good we managed to squeeze you in today."
4076,1671,17,47,159,223,1.3632286995515694,0.04157701954739382,651,So on a scale of one to ten...
9017,1673,19,56,184,259,1.3629343629343629,0.03827335168294345,651,The good news is the tightness in your chest is not a heart attack.
743,1674,24,42,182,248,1.3629032258064515,0.041468629263162006,651,I suggest you feed him two mice and call me in the morning.
1086,1674,19,52,177,248,1.3629032258064515,0.03945120908936374,651,"And for your legs, I’ll prescribe pressure socks with garters."
6713,1674,21,48,179,248,1.3629032258064515,0.04027030698112256,651,And then what happened?
7239,1677,18,50,169,237,1.3628691983122363,0.040289938465447164,651,"Tightness in the chest.... Could be anxiety, could be any number of things. We'll have to run some tests."
734,1677,19,48,170,237,1.3628691983122363,0.04073127603372027,651,Lots of things can cause chest pain.
3648,1677,16,54,167,237,1.3628691983122363,0.039392432394792856,651,"Uh-huh, tightness of the chest, difficulty breathing . . . anything else?"
4591,1677,22,42,173,237,1.3628691983122363,0.04202749058285429,651,Say this phrase twice daily for a week and it should turn back into a staff.
4647,1677,25,36,176,237,1.3628691983122363,0.04328490593785201,651,"So, how did you and my ex meet?"
8582,1682,18,46,162,226,1.3628318584070795,0.041658769189167506,651,You seem a little constricted.
1128,1682,15,52,159,226,1.3628318584070795,0.04021764476024605,651,Now tell me again about the tightness in your chest?
1532,1684,25,41,185,251,1.3625498007968126,0.04148785991058107,651,"The reports came back from the lab and it turns out, there's a snake wrapped around you."
2505,1684,17,57,177,251,1.3625498007968126,0.038291806437914695,651,"You look tense, I'll give you a few minutes to unwind."
2894,1684,19,53,179,251,1.3625498007968126,0.03911530979295759,651,You still have to bend over.
3741,1684,24,43,184,251,1.3625498007968126,0.04110194654757656,651,What is the problem?
8568,1684,14,63,174,251,1.3625498007968126,0.037022221845781314,651,It’s psychosomatic. You just need to unwind.
849,1689,18,51,171,240,1.3625,0.039931623042752114,651,And what are you here to see me about this morning?
6043,1689,19,49,172,240,1.3625,0.04036585218120883,651,Just checking.  When was the last time you fed him?
8488,1689,19,49,172,240,1.3625,0.04036585218120883,651,Thanks for squeezing me in
6298,1692,16,51,162,229,1.3624454148471616,0.04032851540945597,651,We were able to squeeze you in. Now what's the problem?
3632,1692,17,49,163,229,1.3624454148471616,0.04080066819972021,651,"First question Mr. Neeman.
Have you recently been traveling abroad?"
9005,1692,17,49,163,229,1.3624454148471616,0.04080066819972021,651,"Believe me, everybody in healthcare is feeling the squeeze nowadays."
8577,1695,23,46,185,254,1.3622047244094488,0.04035978628206285,651,"Your insurance said if we can get the parasite inside your body, they'll cover it."
7511,1695,20,52,182,254,1.3622047244094488,0.03918602522667272,651,The good news is we can rule out ringworm.
7175,1695,16,60,178,254,1.3622047244094488,0.03756400145761392,651,I'll need you to take everything off for your exam.
6088,1695,22,48,184,254,1.3622047244094488,0.039972362412601235,651,"Your stool sample confirms, it's coilitis."
5314,1695,14,64,176,254,1.3622047244094488,0.036726135404214745,651,I'd suggest putting aside  some time to unwind.
212,1695,21,50,183,254,1.3622047244094488,0.039581146584641576,651,"At any time in the last four weeks have you felt depressed, anxious or hopeless?"
5837,1701,18,52,173,243,1.3621399176954732,0.03958163161600169,651,Take two aspirin and give him four mice a day.
4634,1701,18,52,173,243,1.3621399176954732,0.03958163161600169,651,"Well, your blood pressure seems fine."
1809,1701,23,42,178,243,1.3621399176954732,0.04167440745212876,651,"If you want a second opinion, the snake is also endangered."
4088,1701,20,48,175,243,1.3621399176954732,0.040431742869005,651,I think we can squeeze you in next Tuesday
3127,1705,14,56,162,232,1.3620689655172413,0.03901740564524262,651,Shouldn't we really be talking about the elephant in the room?
2151,1705,17,50,165,232,1.3620689655172413,0.04042666139806926,651,Heart palpitations are normal for a man with your condition
1901,1705,16,52,164,232,1.3620689655172413,0.03996243171977776,651,"Let me write this down:  Tightness in chest, difficulty breathing, started on Tuesday after a trip to the Everglades.  Anything else you can tell me before I (look up from my clipboard and actually) examine you?'"
1482,1705,23,38,171,232,1.3620689655172413,0.043107180014605555,651,"Yes, your scarf too."
663,1709,14,52,155,221,1.3619909502262444,0.04031976363791034,651,Have you traveled out of the country in the past year?
5520,1710,22,53,193,268,1.3619402985074627,0.03846875395813333,651,"Have him take two rodents, every four hours, then call me in the morning."
2035,1711,15,63,179,257,1.3618677042801557,0.036851209825209445,651,Let me see if I can squeeze you in next week.
5600,1711,15,63,179,257,1.3618677042801557,0.036851209825209445,651,"Nothing serious. Just try to unwind, and you’ll be fine."
1952,1713,15,59,172,246,1.3617886178861789,0.037949958100935835,651,And you say it was there when you woke up this morning?
3790,1713,19,51,176,246,1.3617886178861789,0.039660248878449426,651,Seems like you’ve picked something up from your recent trip to Australia.
6332,1715,19,47,169,235,1.3617021276595744,0.040959424688263496,651,The good news is that you should be able to digest the human over the next few days
1697,1715,19,47,169,235,1.3617021276595744,0.040959424688263496,651,Have you been picking at it?
9035,1715,13,59,163,235,1.3617021276595744,0.03820278754196203,651,"Okay, so none of your friends thought you could manage a pet store. Then what?"
2811,1718,20,41,163,224,1.3616071428571428,0.042848091546329396,651,"As we told your wife, we can save one of you. She has the glass tank in the car."
796,1719,23,48,189,260,1.3615384615384616,0.03967782801349511,651,I said erectile not reptile!
3879,1719,20,54,186,260,1.3615384615384616,0.038538681175779854,651,"I understand your frustration, but there's no need to hiss."
11,1721,22,46,181,249,1.3614457831325302,0.040536202273374095,651,I think it still counts as a preexisting condition.
3482,1722,18,50,170,238,1.361344537815126,0.04014925565924573,651,Are you having difficulty swallowing?
2896,1722,20,46,172,238,1.361344537815126,0.04102288595061948,651,Any symptoms other than the tightness in your chest?
3002,1722,12,62,164,238,1.361344537815126,0.03740614127136482,651,"But the good news is...keep him properly fed, and you’re in no immediate danger"
6480,1725,17,48,162,227,1.3612334801762114,0.04103331199380073,651,We are done. Get dressed and get your asp out of here.
721,1725,16,50,161,227,1.3612334801762114,0.04055549109900368,651,"You're backsliding - you've gained weight, your heart rate is elevated, and your breathing is shallow."
4227,1725,17,48,162,227,1.3612334801762114,0.04103331199380073,651,Try a feather boa next time.
8151,1725,26,30,171,227,1.3612334801762114,0.04510649850380329,651,"Well, shortness of breath is a side-effect of your current medication"
9200,1729,21,53,189,263,1.361216730038023,0.0386032382787696,651,"I’m not a therapist, but I’d say this relationship is suffocating you."
121,1729,17,61,185,263,1.361216730038023,0.037068987187939696,651,The good news?  It’ll eliminate that frog in your throat.
1151,1731,17,57,178,252,1.3611111111111112,0.03816667741363131,651,"As for your pet mouse, I don't think we'll be able to save her."
6049,1731,16,46,154,216,1.3611111111111112,0.041977736330127004,651,I'm referring you to a psychoherpetologist. He might be able to help you unwind.
4538,1733,23,41,177,241,1.3609958506224067,0.04191008310212161,651,Perhaps you can prescribe me a different vasoconstrictor?
8535,1733,21,45,175,241,1.3609958506224067,0.04107674247556708,651,"Fortunately, your driver's license indicates that you're a donor."
5553,1735,21,54,191,266,1.3609022556390977,0.038291166248411,651,Have your traveled outside the continental United States in the last twenty one days?
7376,1735,23,50,193,266,1.3609022556390977,0.03902510794786548,651,Our blood pressure machine is out of order.
5445,1737,19,45,166,230,1.3608695652173912,0.041576998250237106,651,Just saw your cat scan.  Is your house pet missing?
8885,1737,13,57,160,230,1.3608695652173912,0.03874032914273768,651,"Some respiratory constriction, a perfectly normal response."
1460,1739,24,44,187,255,1.3607843137254902,0.04060828271728692,651,And how long have you had this man stuck in you Mr... Boa is it?
1892,1739,21,50,184,255,1.3607843137254902,0.0394511995490441,651,Says here you’re having tightness in you’re chest?
5898,1739,19,54,182,255,1.3607843137254902,0.038660576296783614,651,"You know, as your proctologist I will have to look at your asp."
1992,1742,15,49,155,219,1.360730593607306,0.041063294945757174,651,Other than tightness in your chest is there anything else to report.
2788,1743,18,52,174,244,1.360655737704918,0.03944700879363883,651,"Well, I most certainly can explain the crushing chest pain."
4200,1743,22,44,178,244,1.360655737704918,0.04112167258821384,651,You have Monty Python syndrome.
1714,1743,17,54,173,244,1.360655737704918,0.03901711341634219,651,I see your ex got custody of the apple.
497,1743,18,52,174,244,1.360655737704918,0.03944700879363883,651,...and avoid eating apples.
2844,1747,16,65,188,269,1.3605947955390334,0.036113693643363934,651,much less invasive than stapling
2075,1748,20,44,169,233,1.3605150214592274,0.041637690180311306,651,"Well, you shouldn't have eaten her eggs."
9080,1748,17,50,166,233,1.3605150214592274,0.0402827660347169,651,The pressure you feel in your chest is apparently not related to your heart.
2554,1750,23,47,188,258,1.3604651162790697,0.03988429714838913,651,So you have a few questions about your COBRA?
4209,1750,21,51,186,258,1.3604651162790697,0.03912072076768141,651,I'd suggest a lubricant. Snake oil should do the trick.
8374,1750,26,41,191,258,1.3604651162790697,0.04100300851740216,651,I really won't know until I get the lab results back.
2612,1753,15,50,157,222,1.3603603603603605,0.04067506747284599,651,Still single?
97,1753,12,56,154,222,1.3603603603603605,0.0391429032390199,651,"Ok, can you breathe in for me?"
9002,1755,23,43,181,247,1.360323886639676,0.0411583004485645,651,"Ok, I'll give you credit for creativity. But this is the last time I'll refill your painkillers."
5907,1755,20,49,178,247,1.360323886639676,0.039940703162109986,651,Any other symptoms besides tightening of the chest?
2062,1755,15,59,173,247,1.360323886639676,0.03782437341890692,651,So you say you started feeling badly at the zoo.
5703,1758,22,41,173,236,1.3601694915254237,0.042118783744428935,651,"Yes, I can see that, but I would still like to rule out an allergic reaction."
6481,1758,18,49,169,236,1.3601694915254237,0.04037008592220695,651,Good news is that he’ll be squeezing you less than your HMO and the drug companies
7654,1758,21,43,172,236,1.3601694915254237,0.041688486629093066,651,Could you be more specific?
351,1761,20,54,187,261,1.3601532567049808,0.03841572160990961,651,"Says here you have trouble breathing, is that correct?"
5311,1762,23,53,199,275,1.36,0.03809672319916246,651,"Yeah... it’s like worms... just much, much worse!"
1029,1762,18,54,178,250,1.36,0.03877646783593531,651,"Alright, I'm going to check your blood pressure. You may feel a gentle squeezing sensation on your arm."
2011,1762,19,52,179,250,1.36,0.039188556644606735,651,"No, actually my chart says vapor rub."
2021,1762,24,42,184,250,1.36,0.041187201193679995,651,I’m going to refer you to a sssspecialist.
4585,1762,22,46,182,250,1.36,0.0403996103205987,651,Any history of python strangulation in your family?
4586,1762,21,48,181,250,1.36,0.04,651,I also recommend you stay away from apples and sin.
4902,1762,23,44,183,250,1.36,0.040795306447095725,651,Are you sexually active?
6436,1769,23,49,192,264,1.3598484848484849,0.039222480219087696,651,I'm sorry. Your insurance considers this a pre-existing condition.
7547,1769,26,43,195,264,1.3598484848484849,0.04030903670632375,651,"I can resubmit, but this is apparently all your plan covers for constipation...."
1067,1769,18,59,187,264,1.3598484848484849,0.03734135971160767,651,The compression socks just didn't seem to be working.
2622,1772,19,48,172,239,1.3598326359832635,0.04044650611600906,651,It appears your main squeeze has some serious attachment issues.
8812,1773,19,39,156,214,1.3598130841121496,0.04376193181743022,651,I'll just renew your Emotional Support Animal prescription while you're here.
2203,1774,18,55,180,253,1.359683794466403,0.03845239545984256,651,Side effects may include shortness of breath
8304,1775,24,34,170,228,1.3596491228070176,0.04406782652989449,651,So I'm prescribing a muscle relaxant for his separation anxiety....
7435,1776,21,54,192,267,1.3595505617977528,0.038171424087911764,651,"I'll run some tests, but it looks like you have a constriction."
1384,1777,16,46,155,217,1.359447004608295,0.04181696743140796,651,Your insurance company says it’s a pre-existing condition.....
4390,1778,21,50,185,256,1.359375,0.039322054350368486,651,The good news is that the squeezing sensation in your chest is not a heart attack.
5289,1778,22,48,186,256,1.359375,0.03970971182513535,651,No way I can certify it as a support pet!
5775,1778,21,50,185,256,1.359375,0.039322054350368486,651,So you say she’s having trouble swallowing?
4434,1781,17,49,165,231,1.3593073593073592,0.04050720429971196,651,So what is your support boa’s name?
6286,1781,14,55,162,231,1.3593073593073592,0.039088400484868224,651,I suggest you take anti-HISS-tamines.
8327,1781,22,39,170,231,1.3593073593073592,0.04276740791421115,651,Feed it two white mice and call me in the morning.
8880,1781,19,45,167,231,1.3593073593073592,0.04142608637063576,651,"Before he squeezes the life out of you, please finish filling out your insurance information."
2980,1785,15,58,172,245,1.3591836734693878,0.03801529792233673,651,"I told you, everything off except your underwear"
4016,1785,14,60,171,245,1.3591836734693878,0.0375726878300057,651,I’m not a vet but I think he just might be hungry
572,1787,16,47,157,220,1.3590909090909091,0.04141333987284018,651,I'm prescribing a little snake oil.
7244,1788,16,61,182,259,1.359073359073359,0.03702564612070983,651,"Of course, there are two viewpoints to consider here."
5874,1788,25,43,191,259,1.359073359073359,0.04050025719735189,651,This is the worst case of ring worm I've ever seen.
4689,1788,22,49,188,259,1.359073359073359,0.039376135483138106,651,I’m going to refer both of us to a psychiatrist.
8207,1788,20,53,186,259,1.359073359073359,0.03860854206791087,651,And when did you first start experiencing shortness of breath?
1215,1788,21,51,187,259,1.359073359073359,0.038994227561243544,651,Anything else concerning you?
9147,1793,17,50,167,234,1.358974358974359,0.04013982609500898,651,"Well, if you can't take a deep breath and exhale for me, maybe the best thing is just to reschedule."
900,1794,22,45,181,248,1.3588709677419355,0.04061779745395575,651,"145/90 .....try to unwind more often, Bob"
4672,1794,20,49,179,248,1.3588709677419355,0.03980585062863778,651,Nice boa. First attempt at cross dressing?
6674,1794,18,53,177,248,1.3588709677419355,0.038976993451628236,651,It appears your snake is suffering from acute separation anxiety.
1420,1797,18,39,152,209,1.3588516746411483,0.043980215945318424,651,"Eve sent you, right?"
3222,1798,18,58,186,262,1.3587786259541985,0.03752195289306178,651,'C'mon Mr. Franklin.  Clothes off means everything.'
4579,1798,17,60,185,262,1.3587786259541985,0.03713016948690841,651,"Well, your blood pressure is a little high..."
7664,1798,20,54,188,262,1.3587786259541985,0.03829349650364086,651,Give her two rabbits and call me in the morning.
4796,1798,16,62,184,262,1.3587786259541985,0.03673420780885223,651,Don't you remember what happened last time you listened to Dr. Oz?
7225,1802,19,42,162,223,1.358744394618834,0.04247152948838365,651,It says here on your chart that you’re his main squeeze.
4438,1802,17,46,160,223,1.358744394618834,0.041509427001662255,651,"I'm sorry, but I'm afraid this is a preexisting condition so you are not covered."
8894,1802,17,46,160,223,1.358744394618834,0.041509427001662255,651,"So let's see...a tightness in your chest, shortness of breath, high blood pressure.  Any trouble sleeping?"
3850,1802,18,44,161,223,1.358744394618834,0.04199323366382356,651,Give him these muscle relaxants and stop calling him 'Monty'
5318,1806,15,55,167,237,1.358649789029536,0.03887193207359231,651,I'm prescribing a de-constrictor.
7196,1807,18,54,179,251,1.3585657370517927,0.03864829331730003,651,I’m going to write you a referral to my vet as well.
218,1807,17,56,178,251,1.3585657370517927,0.03823372943331449,651,Strangely your blood pressure has risen since you got your emotional support pet.
6320,1807,21,48,182,251,1.3585657370517927,0.0398661273040226,651,"According to clinical trials, the treatment is mutually beneficial.  The snake keeps you from smoking, and you keep the snake from suffocating other people."
9126,1807,15,60,176,251,1.3585657370517927,0.03739081500127511,651,I think we can rule out asthma.
7945,1811,14,67,184,265,1.3584905660377358,0.03565594522328353,651,Let's wait and see what happens when he sheds.
2397,1811,18,40,154,212,1.3584905660377358,0.04352840772335681,651,"I'm still not sure how this happened but, we're going to get that human out right away"
5901,1811,22,51,192,265,1.3584905660377358,0.03873046017361999,651,You said 'parasite' on the phone so we were kind of thinking internal.
3994,1814,20,41,165,226,1.3584070796460177,0.04252803495463557,651,Nice try Irwin. Now please drop your shorts and bend over.
7819,1814,16,49,161,226,1.3584070796460177,0.04063629276942872,651,The reason for your visit today indicates chest pains and difficulty breathing.  Could you be more specific?
7983,1814,12,57,157,226,1.3584070796460177,0.038652073980353814,651,So...you realized you were naked right after eating the apple?
3061,1817,20,46,174,240,1.3583333333333334,0.04073576565427806,651,GIVE THE SNAKE A SHOT OF WHISKEY TO UNWIND
3855,1817,21,44,175,240,1.3583333333333334,0.04116151244703006,651,how long have you been her favorite squeeze?
7252,1819,18,55,181,254,1.358267716535433,0.03832687801289537,651,This is the one time that snake oil actually does work.
8938,1819,22,47,185,254,1.358267716535433,0.0399179150980255,651,"Yeah, well, you're not the only one getting squeezed by the new Medicare plans."
8053,1819,23,45,186,254,1.358267716535433,0.040305862323769044,651,I guess you're not as charming as you thought you were.
6681,1819,20,51,183,254,1.358267716535433,0.03913048379453374,651,"If you think you're choking now, wait till you see my bill."
4306,1819,17,57,180,254,1.358267716535433,0.03791868914303222,651,Feed him two rodents and call me in the morning.
2704,1819,17,57,180,254,1.358267716535433,0.03791868914303222,651,You still need to sign this consent.
3149,1825,21,45,177,243,1.3580246913580247,0.040791878440822105,651,Looks like he found you way too charming.
3012,1825,21,45,177,243,1.3580246913580247,0.040791878440822105,651,It's not covered since it's a pre-constricting condition.
5888,1825,22,43,178,243,1.3580246913580247,0.04120664366034976,651,How are you otherwise? Stool normal?
3343,1828,15,62,180,257,1.3579766536964981,0.036793388853676216,651,"Well, it's actually helping your scoliosis."
6761,1828,22,48,187,257,1.3579766536964981,0.03957960702346095,651,This is the noninvasive lap band alternative we discussed....
733,1828,20,52,185,257,1.3579766536964981,0.038803964059899214,651,Couples therapy is on the second floor.
148,1828,19,54,184,257,1.3579766536964981,0.03841026938303251,651,Take two mongooses and call me in the morning
434,1828,21,50,186,257,1.3579766536964981,0.03919370433432868,651,"You marked ""Constricted Airway"" on your intake form. Have you been experiencing any other symptoms?"
6966,1833,26,50,209,285,1.3578947368421053,0.03810023079177181,651,"The symptoms began *after* you ate the apple, is that right?"
3840,1834,15,48,155,218,1.3577981651376148,0.04114677096260524,651,Question eight. Any family history of reptile constriction?
3421,1834,17,44,157,218,1.3577981651376148,0.04216174368951536,651,"Your insurance company does cover resuscitation, so I'll return in about half an hour."
5247,1836,18,47,167,232,1.3577586206896552,0.04082163736399969,651,So...I see from your chart that you’re due for a flu shot.
1303,1836,15,53,164,232,1.3577586206896552,0.03942650210923058,651,I'll make an exception and prescribe snake oil.
365,1836,15,53,164,232,1.3577586206896552,0.03942650210923058,651,This compression device should reduce the swelling.
3955,1839,22,44,180,246,1.3577235772357723,0.040839117309580994,651,So how long would you say he has had abandonment issues?
6852,1839,20,48,178,246,1.3577235772357723,0.04001831445734361,651,Be sure to give this muscle relaxer to your pet.
792,1841,18,43,160,221,1.3574660633484164,0.042242804901298246,651,"Yes, I think it is very clever that you named him Monty."
5367,1842,20,44,171,235,1.3574468085106384,0.041339296176264376,651,So...how was your trip to Brazil?
6135,1842,21,42,172,235,1.3574468085106384,0.04177687946083471,651,Try not to breathe.
8135,1842,15,54,166,235,1.3574468085106384,0.039077949826825276,651,Perhaps you should consider a different comfort pet.
4582,1845,14,61,174,249,1.357429718875502,0.037142028740215396,651,"We've got a couple of options here, but not necessarily a lot of time."
4670,1845,19,51,179,249,1.357429718875502,0.03926153809798022,651,Is it more of a sharp or squeezing pain?
5283,1847,25,44,194,263,1.3574144486692015,0.04002782567435595,651,I'd find a nice pair of beige pumps and go with it.
6818,1848,16,53,169,238,1.3571428571428572,0.039192568950747124,651,"They've a good python man at Special Surgery, but the earliest I can get you in is next week."
5210,1848,18,54,180,252,1.3571428571428572,0.03852090960065067,651,"Besides the tightness in your chest, any fever or loss of appetite?"
7736,1848,19,47,172,238,1.3571428571428572,0.040526893830494265,651,"Other than difficulty breathing, any symptoms?"
6599,1848,17,51,170,238,1.3571428571428572,0.03964233446483817,651,So when did you first feel the tightening in your chest?
6888,1848,18,49,171,238,1.3571428571428572,0.04008705405346127,651,"So, when did you first start
 feeling a tightness around your chest, Mr Green?"
4746,1848,23,29,158,210,1.3571428571428572,0.04633141770873215,651,"Yes, you are the last patient in my 36-hour shift...what seems to be the problem?"
5973,1848,13,64,175,252,1.3571428571428572,0.03641102455029218,651,"Well, your feet look fine...."
4230,1848,18,44,162,224,1.3571428571428572,0.041836009252494394,651,Spanx are easier.
3272,1848,17,46,161,224,1.3571428571428572,0.041354724437183396,651,Have you traveled to any foreign countries in the past six months?
1740,1848,18,44,162,224,1.3571428571428572,0.041836009252494394,651,Now let me get this straight.  You lost your job and you want to pay with your Cobra?
4677,1848,20,60,200,280,1.3571428571428572,0.03653686602846789,651,"\unfortunately, all the tests indicate that he’s hungry."
7250,1859,18,55,182,255,1.3568627450980393,0.0382021249381861,651,...and are you sexually active?
5072,1859,17,57,181,255,1.3568627450980393,0.03779581797849129,651,Difficulty breathing can have any number of causes.
5869,1861,15,56,170,241,1.3568464730290457,0.03840509924457765,651,I think some snake oil might help.
4343,1861,18,50,173,241,1.3568464730290457,0.039732682867129464,651,You seem all wound up.
5431,1861,18,50,173,241,1.3568464730290457,0.039732682867129464,651,And after the apple what happened....
1237,1864,21,55,196,272,1.3566176470588236,0.03763552463144217,651,Any tightness in the chest? difficulty breathing...?
1754,1865,17,58,183,258,1.3565891472868217,0.03749014257266473,651,I have good news.  The tightness in your chest is not a cardiac problem.
2225,1865,21,50,187,258,1.3565891472868217,0.03906614290398955,651,Charming.
1775,1867,18,51,175,244,1.3565573770491803,0.03938650922799401,651,This should keep the swelling down for now.
3207,1867,25,37,182,244,1.3565573770491803,0.042277850620849024,651,"Your blood vessels are somewhat constricted, but it's good that you do have COBRA insurance.  You're covered!"
544,1869,19,44,167,230,1.3565217391304347,0.04151242145678908,651,have you traveled out of the country recently?
4523,1869,14,54,162,230,1.3565217391304347,0.03915890363670747,651,My notes say you have been having trouble breathing. When did this start?
1746,1871,21,51,189,261,1.3563218390804597,0.038743541710183224,651,So you're calling this more of a constriction than a pain?
5498,1871,20,53,188,261,1.3563218390804597,0.03836130317107541,651,"Yeh, but first why don't you tell me how you unlaced your shoes and unbuttoned your shirt."
7950,1873,18,47,168,233,1.3562231759656653,0.04067505074063979,651,I said restrict your diet not constrict
5965,1873,18,47,168,233,1.3562231759656653,0.04067505074063979,651,Have you visited any tropical locations recently?
7540,1873,22,39,172,233,1.3562231759656653,0.0424553226927487,651,"Well, you don’t have malaria."
3349,1873,18,47,168,233,1.3562231759656653,0.04067505074063979,651,"No, cross dressing is not generally bad for your health, but that kind of boa could be fatal."
7473,1877,21,52,191,264,1.356060606060606,0.03842786734198886,651,You say your wife's name is Eve?
8783,1878,17,55,178,250,1.356,0.03830043987709692,651,"Patients hated the old colonoscopy prep, so let's give this a try."
3033,1878,23,43,184,250,1.356,0.04073935172675758,651,...and have you experienced any chest pain or shortness of breath?
8566,1878,21,47,182,250,1.356,0.03994293117691809,651,"Great news, your lab reports show you're in excellent health."
6509,1881,16,52,168,236,1.3559322033898304,0.039401786886733306,651,Your insurance company says your chest tightness and shortness of breath are preexisting conditions.
2100,1882,17,45,160,222,1.3558558558558558,0.041595750025579796,651,I do admit...It's an old method of curing constipation!
5785,1882,19,41,162,222,1.3558558558558558,0.042564491227838265,651,I'm sorry but your HMO lists having a snake as a pre-existing condition.
7215,1884,26,43,198,267,1.3558052434456929,0.03992306635772871,651,Didn't your previous vet tell you not to attempt to eat another full size human sooner than 6 months after the last one?
7922,1885,18,54,181,253,1.3557312252964426,0.03839431023716592,651,"In my expert opinion, you're under too much pressure."
6383,1885,18,54,181,253,1.3557312252964426,0.03839431023716592,651,I'm sorry.  You're not completely covered.
3118,1885,17,56,180,253,1.3557312252964426,0.037983594642960736,651,Sorry. The pharmacy keeps misreading my prescriptions.
1434,1888,18,49,172,239,1.3556485355648535,0.03994693274887092,651,These pills should help him unwind but call me in the morning if you still feel constricted.
2306,1888,13,59,167,239,1.3556485355648535,0.03768228890943541,651,"Well, I did say getting a pet would lower your heart rate."
7126,1888,16,53,170,239,1.3556485355648535,0.03905683577310575,651,Your diagnosis is coilitis.
7935,1891,18,44,163,225,1.3555555555555556,0.041679892080955176,651,I can confirm that the tightness in your chest is not viral.
5136,1891,19,42,164,225,1.3555555555555556,0.042153243571077775,651,"So, Darryl, some good news, it is not poisonous."
8281,1891,20,40,165,225,1.3555555555555556,0.04262133835586524,651,"No, I think we can rule out a tape worm."
5030,1894,18,55,183,256,1.35546875,0.03807813009154182,651,You seem pretty tightly wound!
9198,1895,20,46,176,242,1.3553719008264462,0.040452419113676176,651,Most burlesque dancers use a feather boa
2859,1895,18,50,174,242,1.3553719008264462,0.03959562423474646,651,Looks like we can rule out asthma.
8817,1897,18,45,165,228,1.355263157894737,0.041286896908067125,651,Any tightness in your chest? Shortness of breath?
4615,1898,19,54,186,259,1.3552123552123552,0.03816298607731298,651,I suggest a muscle relaxant . . . for the snake.
5974,1898,23,46,190,259,1.3552123552123552,0.03970056115838657,651,You're going to have to speak up.
3053,1900,19,49,177,245,1.3551020408163266,0.03967628344741636,651,"According to Amazon, when you ordered, you neglected to check the box labeled 'feather.'"
5628,1900,18,51,176,245,1.3551020408163266,0.03925240709621213,651,"No, it’s not a tapeworm. But it’s nothing that a box full of guinea pigs won’t help."
1314,1900,22,43,180,245,1.3551020408163266,0.04092157724549004,651,And how much do you weigh without the snake?
6415,1903,18,62,196,276,1.355072463768116,0.03615274624802892,651,"Well, the good news, it's not COPD."
274,1904,18,52,178,248,1.3548387096774193,0.03891699305755205,651,What is your chief complaint today?
646,1904,13,62,173,248,1.3548387096774193,0.03675980188043285,651,Your blood test came back fine
8313,1904,14,49,154,217,1.3548387096774193,0.04070902040000197,651,Your labs came back fine.
7991,1907,16,62,187,265,1.3547169811320754,0.03639261712349847,651,"Well, it’s been a year and he hasn’t eaten you yet."
1796,1908,19,45,170,234,1.3547008547008548,0.04097949454611862,651,Alternative therapies can sometimes come back to bite you.
1886,1908,18,47,169,234,1.3547008547008548,0.04052945266271738,651,"It may be a nice pick up line, but 'I've got a python in my pants' is intended to be pure metaphor."""
4224,1908,19,45,170,234,1.3547008547008548,0.04097949454611862,651,Take two aspirin and a very cold shower.  Then Run.
5297,1908,19,45,170,234,1.3547008547008548,0.04097949454611862,651,Your blood pressure is on the high side. Do you smoke?
1252,1912,20,49,182,251,1.3545816733067728,0.039406398468397934,651,The tightness in your chest is just a minor panic attack... Perhaps due to the python.
5017,1912,18,53,180,251,1.3545816733067728,0.038589107534767325,651,It gives more accurate blood pressure reading.
1030,1912,15,59,177,251,1.3545816733067728,0.03732963555205647,651,Crestor for cholesterol and a flute for the snake as needed.
4626,1915,16,46,158,220,1.3545454545454545,0.041341517859282736,651,You say his name is Monty.
6058,1916,15,54,168,237,1.3544303797468353,0.038805892666958455,651,I am prescribing a muscle relaxant for the snake which has worked well in clinical trials.
9133,1916,15,54,168,237,1.3544303797468353,0.038805892666958455,651,This prescription should help with the hissing.
7999,1918,14,45,147,206,1.354368932038835,0.04217928760813355,651,"Oddly enough, I prescribe snake oil in cases like yours."
2182,1919,20,50,184,254,1.3543307086614174,0.03907329549748491,651,"First the good news, we have excluded cancer."
6423,1919,18,54,182,254,1.3543307086614174,0.038268488828994404,651,And you say you're feeling contractions
8002,1919,19,52,183,254,1.3543307086614174,0.03867298578005482,651,"And would you say its more of a burning, or a squeezing pain?"
8980,1919,16,58,180,254,1.3543307086614174,0.03744638905790469,651,Do you have any shortness of breath or pressure in your chest?
5061,1923,20,39,164,223,1.3542600896860986,0.04287694921638097,651,"I told you which fruits were forbidden, Adam."
307,1923,14,51,158,223,1.3542600896860986,0.0399504432124998,651,So what Garden was that?
7497,1923,13,53,157,223,1.3542600896860986,0.039441586800444704,651,"​""On a scale of 1-10 would you say you feel more constricted than last visit?""​"
2837,1926,22,52,197,271,1.3542435424354244,0.03806021927762597,651,The good news is that your cancer is in remission.
8966,1927,18,49,173,240,1.3541666666666667,0.03980773031511014,651,"I’m afraid it’s considered a pre-existing condition, Adam."
340,1927,16,53,171,240,1.3541666666666667,0.03892197818542935,651,OK... Don’t take a deep breath.
3205,1927,18,49,173,240,1.3541666666666667,0.03980773031511014,651,"So, some good news: you don’t have the flu."
5615,1927,22,41,177,240,1.3541666666666667,0.04152258911469202,651,You seem to be wound awfully tight.
5151,1931,23,45,189,257,1.3540856031128405,0.039906987347793806,651,"So, tell me what's happened to Eve."
4419,1931,17,57,183,257,1.3540856031128405,0.03755229211470354,651,I can remove it but it's not covered under your insurance
8739,1933,17,46,163,226,1.3539823008849559,0.04104855170926007,651,"Well now, tightness in your chest could be due to any number of causes! No need to jump to conclusions."
4136,1934,19,48,176,243,1.353909465020576,0.039888074628542734,651,I’m writing you a prescription for an emotional support mongoose.
2529,1934,16,54,173,243,1.353909465020576,0.0385879267713554,651,Have you traveled out of the country in the past 3 months?
5958,1936,16,60,184,260,1.353846153846154,0.03685073598440236,651,Difficulty breathing. Any other symptoms?
5606,1937,13,55,161,229,1.3537117903930131,0.03873758304927678,651,How was your vacation to the Everglades?
636,1938,20,47,179,246,1.353658536585366,0.03995843769810273,651,"Just so you know, our veterinarian specialist is out of network."
5043,1938,24,39,183,246,1.353658536585366,0.04158620882589468,651,"Hi, so I’d first like to get to know you a bit, then we can talk about why you’re here today."
1652,1940,12,52,151,215,1.3534883720930233,0.03986907603227408,651,"I can give you something, but he looks fine to me."
4849,1940,18,40,157,215,1.3534883720930233,0.04301576560326859,651,"Well, I'm a little concerned about your blood pressure."
4040,1942,22,38,172,232,1.353448275862069,0.042547542268614486,651,Oh? Mambacare?
422,1942,17,48,167,232,1.353448275862069,0.040295140388368365,651,"Tightness in your chest, labored breathing, elevated heart rate......do you use a lot of salt Mr. McCready?"
8104,1944,17,54,178,249,1.3534136546184738,0.03836679028956636,651,I'm referring you to a herpetologist. I'm not sure what kind of snake that is.
642,1944,23,42,184,249,1.3534136546184738,0.04082078253757224,651,Amazon delivery?
6250,1946,20,54,192,266,1.3533834586466165,0.037811824528253796,651,"With this medication, you should no longer need that emotional support pet."
8318,1947,16,51,168,235,1.353191489361702,0.03947397032483116,651,Return the mouse and no one gets hurt.
4875,1947,18,47,170,235,1.353191489361702,0.040384834176681525,651,"Sorry, you need to make a separate appointment for any new issues. Now tell me more about your cough."
3009,1947,9,65,161,235,1.353191489361702,0.03610543711481977,651,The good news is it's not the poisonous kind.
3630,1950,19,51,182,252,1.3531746031746033,0.03887029989218028,651,Take this asp. Print the prescription. Go home and unwind.
3820,1950,21,47,184,252,1.3531746031746033,0.03967542464513566,651,"No, I do understand, but an emotional support snake is not on the approved list"
7392,1952,20,56,196,272,1.3529411764705883,0.03722042281275146,651,"Well, I see the snake isn’t working."
5298,1952,16,58,181,255,1.3529411764705883,0.0373251249793846,651,"You better see a pythologist about this."""
6454,1952,19,58,195,272,1.3529411764705883,0.036854134776067804,651,We don’t see this side effect very often.
1911,1952,18,48,172,238,1.3529411764705883,0.04002289464118234,651,I'm writing you a prescription for mice.
5875,1952,19,52,184,255,1.3529411764705883,0.03854608195543726,651,Next time just be a bit more careful ordering Monty Python on Amazon.
6393,1952,16,52,170,238,1.3529411764705883,0.03912694281097265,651,"Well, I think I can explain the tightness in your chest that you're feeling..."
2822,1958,25,41,192,258,1.3527131782945736,0.04052693017145336,651,I'm prescribing you change from Cobra to Aetna for better coverage.
3508,1959,17,51,173,241,1.3526970954356847,0.03923118936091061,651,"Well, I think your lifestyle choices are contributing to that tightness you feel in your chest."
1133,1959,19,47,175,241,1.3526970954356847,0.04010289904600799,651,I'm going to refer you to a specialist. How long can you hold your breath?
5063,1959,20,45,176,241,1.3526970954356847,0.04053172409984123,651,"Well, that explains your weight gain."""
3185,1959,23,39,179,241,1.3526970954356847,0.0417918065933943,651,"Before I prescribe this, have you taken rikitikitavidan before?"
8855,1963,18,37,152,207,1.3526570048309179,0.04418644771218517,651,Sheila is my comfort pet. But lately she has become a bit possessive.
5037,1964,16,54,174,244,1.3524590163934427,0.03845681663154356,651,So sorry for the delay. What seems to be the problem?
8014,1965,20,40,167,227,1.3524229074889869,0.04230276751498587,651,"I’m sorry Mr. Perkins, we don’t accept Mutual of Omaha."
6413,1966,19,36,155,210,1.3523809523809525,0.04424599556029513,651,Okay. You can go right ahead and put your shirt back on.
980,1967,20,53,191,264,1.3522727272727273,0.03799598760124005,651,How are you feeling otherwise?
6214,1967,23,47,194,264,1.3522727272727273,0.03911662765945726,651,"Well, Harry, you did say you wanted an all-natural treatment for constipation”"
6199,1969,17,53,177,247,1.3522267206477734,0.03856231783485122,651,So what’s wrong with Gladys besides being a bit clingy today?
2158,1970,15,51,164,230,1.3521739130434782,0.03957096497559346,651,"You were cutting the grass, and then what happened?"
3080,1970,15,51,164,230,1.3521739130434782,0.03957096497559346,651,Shortness of breath. Anything else?
8790,1970,14,53,163,230,1.3521739130434782,0.039088220589638206,651,"Unfortunately, I’m not much of a charmer."
2169,1973,18,64,202,284,1.352112676056338,0.03541225670693644,651,Would you say it's more of a sharp pain or a dull ache?
5346,1974,21,46,183,250,1.352,0.03988416964099675,651,"Sir, it is not customary for the pet's owner to disrobe."
1633,1974,15,58,177,250,1.352,0.037389515958547226,651,"So, Mr. Naga, what brings you in today?"
6042,1974,18,52,180,250,1.352,0.03865697150299196,651,The good news is that your blood pressure's back down where we want it
6760,1977,16,50,167,233,1.351931330472103,0.039687069297050924,651,"So Mr. Smith, Point to where it hurts."
3869,1977,21,40,172,233,1.351931330472103,0.041953030994538086,651,Have you had any other symptoms?
1130,1977,16,50,167,233,1.351931330472103,0.039687069297050924,651,This do-it-yourself gastric band seems to be working for you. You've lost another 50 pounds.
8291,1977,17,48,168,233,1.351931330472103,0.04015049361386323,651,Worst case of coilitas I've seen
5019,1981,20,49,184,253,1.3517786561264822,0.039144279317021496,651,How long have you had trouble breathing?
715,1981,22,45,186,253,1.3517786561264822,0.03993762382043996,651,There's a lot of it going around.
3311,1981,18,53,182,253,1.3517786561264822,0.03833451982319619,651,"So, how long have you been hearing this hissing sound?"
3699,1981,21,47,185,253,1.3517786561264822,0.03954294121377398,651,Our tests indicate that you may have picked up a parasite in the Amazon.
3938,1981,19,51,183,253,1.3517786561264822,0.038741515286085666,651,And have you visited any tropical regions lately?
3947,1986,24,35,177,236,1.3516949152542372,0.042845364323692015,651,"I prescribed snake OIL, not snake COIL"
8575,1986,18,47,171,236,1.3516949152542372,0.04024118641285943,651,"Don't worry, Bert is a professional at squeezing the kidney stones right out of you."
6976,1988,9,59,151,219,1.3515981735159817,0.03771991654566037,651,The good news is that your chest pain isn’t casused by a heart attack.
8775,1989,23,44,189,256,1.3515625,0.039983026231666816,651,I think we know what’s causing your chest tightness. I’d just like to run a few tests.”
5688,1989,18,54,184,256,1.3515625,0.038019154542577,651,It certainly accounts for your high blood pressure.
2310,1991,18,48,173,239,1.3514644351464435,0.03988243231945553,651,Do you feel any tightness in your chest?
1275,1991,20,44,175,239,1.3514644351464435,0.040754501875883774,651,"Shortness of breath, tightness in the chest--I'm thinking heart attack."
1813,1991,20,44,175,239,1.3514644351464435,0.040754501875883774,651,"I know this is your first”Drag Queen” event, but that’s the wrong Boa!"
9186,1994,21,55,200,276,1.3514492753623188,0.037178028470056836,651,"How long have you been hearing a rattle in your chest."""
7502,1995,16,59,184,259,1.3513513513513513,0.036908419178134574,651,'Good news.  Tests show that you don't have a tapeworm.'
1118,1995,14,50,158,222,1.3513513513513513,0.04002429722356253,651,And aside from some tightness in the chest?
1236,1995,16,59,184,259,1.3513513513513513,0.036908419178134574,651,Would you say she's your main squeeze?
4478,1998,19,47,176,242,1.3512396694214877,0.039963425054070224,651,So for how long has this man been bothering you?
7573,1998,22,41,179,242,1.3512396694214877,0.04123047989614233,651,"The good news is that you should feel some constriction for a few more minutes, but then you won't feel anything."
6980,1998,19,47,176,242,1.3512396694214877,0.039963425054070224,651,We ran out of leeches.
3327,1998,17,51,174,242,1.3512396694214877,0.039095915239868925,651,Do you have any other symptoms besides the tightness in your chest?
7546,2002,18,43,164,225,1.3511111111111112,0.04161001439629606,651,There’s a lot of that going around.
7324,2003,20,53,192,265,1.350943396226415,0.037875670065974934,651,"Shortness of breath???  

Are you a smoker?"
5530,2004,15,50,163,228,1.3508771929824561,0.039786951118122894,651,"It's quite slow moving, so come back in a month and we'll see how its progressed."
6720,2004,15,50,163,228,1.3508771929824561,0.039786951118122894,651,"Next time, get a dog."
2115,2006,21,45,182,248,1.3508064516129032,0.04009584286049743,651,"You feel a certain tightness in your chest, you say ..."
765,2007,17,47,167,231,1.3506493506493507,0.040372210132427706,651,"Since you're not feeling any pain, let's just wait and see if it goes away."
1537,2007,18,45,168,231,1.3506493506493507,0.040835754760764294,651,"Can't believe I'm saying this, but I'm literally prescribing snake oil."
5024,2007,17,47,167,231,1.3506493506493507,0.040372210132427706,651,"Let's start with the good news. We tested for pancreatitis, and it came back negative."
6007,2007,20,41,170,231,1.3506493506493507,0.041747405891744395,651,You're screwed.
8092,2007,26,29,176,231,1.3506493506493507,0.044370113749193474,651,So how much Viagra did you take?
5833,2012,22,44,185,251,1.350597609561753,0.040148610462242114,651,"I'm sorry but, your insurance doesn't cover pre-existing conditions."
2446,2012,15,58,178,251,1.350597609561753,0.03726665201393521,651,"Well you know what they say, what doesn't kill you makes you stronger."
8164,2014,24,47,200,271,1.3505535055350553,0.03871967231409069,651,Constriction of the chest? Could be a number of things.
8675,2015,17,41,156,214,1.3504672897196262,0.0425985999697814,651,"I'm sorry to have to tell you, but this is indeed a ""mortal coil""."
7600,2016,18,46,170,234,1.3504273504273505,0.0404626769339452,651,When did you start feeling short of breath?
1698,2017,16,57,181,254,1.3503937007874016,0.0373849860589267,651,"I have a hunch that a boa constrictor is the cause of your discomfort, but we'll have to run some expensive tests to be sure."
4461,2017,16,57,181,254,1.3503937007874016,0.0373849860589267,651,"I see you've met Caduceus, our new comfort animal. Do me a favor and don't exhale until I get an orderly in here"
7487,2017,19,51,184,254,1.3503937007874016,0.038613533356771444,651,"Well, the good news is this time it's not an albatross around your neck"
7954,2017,19,51,184,254,1.3503937007874016,0.038613533356771444,651,There’s something going around.
4546,2021,21,41,175,237,1.350210970464135,0.04141452482575271,651,It says here you're complaining of shortness of breath?
7411,2022,20,50,187,257,1.350194552529183,0.03868948658340389,651,Has it lasted for more than four hours?
2227,2022,19,52,186,257,1.350194552529183,0.038294615018335997,651,"On a scale of 1 to 10, what is your pain level right now?"
3472,2022,17,56,184,257,1.350194552529183,0.037492397549808876,651,Good news-only one of you has a swallowing problem.
2547,2025,15,54,171,240,1.35,0.03840436690650609,651,"Well, you consented to the use of unorthodox methods, and according to my clinical experience, this is guaranteed to help you quit smoking cigarettes..."
2900,2025,19,46,175,240,1.35,0.040179166385535446,651,"I wasn’t sure we could squeeze you in today but, well, you just seemed so wound up when you called..."
4015,2025,12,60,168,240,1.35,0.037017467323269014,651,I'm going to put you on a constricted diet.
6494,2028,22,48,193,263,1.349809885931559,0.03881563930226688,651,"Please just use the patient gown, Mr. Reynolds."
8505,2029,16,53,174,243,1.3497942386831276,0.038522584985823186,651,Something's going around.
5279,2029,13,59,171,243,1.3497942386831276,0.03717471114789275,651,"Well, I think I know what's caused that tight feeling in your chest."""
2018,2029,24,37,182,243,1.3497942386831276,0.04190549646707288,651,Tell him to take two pills and not to coil you in the morning.
477,2029,21,43,179,243,1.3497942386831276,0.040669893399063024,651,You should have gone with the feather one.
2022,2029,17,51,175,243,1.3497942386831276,0.03896151548656964,651,It’s been going around...and around....and..around.
1326,2034,18,57,191,266,1.349624060150376,0.03699696176097993,651,"Tightness in your chest, can be a symptom of a more serious condition."
5076,2034,22,49,195,266,1.349624060150376,0.038500213699427924,651,This would be easier if you weren’t a member of PETA.
5979,2034,21,51,194,266,1.349624060150376,0.038129957199845715,651,It’s recommended that you remove the snake.  That should make you feel better.
7073,2034,19,55,192,266,1.349624060150376,0.037378442963598185,651,"I can see you've been under a lot of pressure, lately"
247,2038,24,38,184,246,1.3495934959349594,0.041526968604109725,651,"The good news is: it's not herpes. 
But I do recommend you go see a herpetologist."
5471,2038,18,50,178,246,1.3495934959349594,0.03905617863526935,651,Relax. It's probably just something that ate you.
8565,2038,16,54,176,246,1.3495934959349594,0.03819708207404315,651,"So, can you describe your chest pains?"
1739,2041,18,43,165,226,1.3495575221238938,0.04145461219474337,651,Do you have any tightness in your chest?
7879,2041,16,47,163,226,1.3495575221238938,0.04049471741704806,651,"Says here you were running naked through the jungle, is that correct?"
655,2043,20,54,195,269,1.3494423791821561,0.03745800073814187,651,Don't search online.  It's almost never cancer.
927,2044,20,47,182,249,1.3493975903614457,0.0395520015241361,651,So you say you're feeling a little pressure?
2642,2044,19,49,181,249,1.3493975903614457,0.03914042934855507,651,"It says here that you've been complaining about some tightness in your chest, correct?"
3391,2044,24,39,186,249,1.3493975903614457,0.041157153502998686,651,We'll be more certain once the test results come in.
8992,2047,19,42,168,229,1.3493449781659388,0.04153005300672305,651,Bad case  of reptile malfunction.
6213,2047,19,42,168,229,1.3493449781659388,0.04153005300672305,651,"It may feel uncomfortable at first, but we're committed to this new natural way of taking blood pressure."
1896,2047,21,38,170,229,1.3493449781659388,0.04244238498914841,651,So how long have you had this shortness of breath?
6166,2047,21,38,170,229,1.3493449781659388,0.04244238498914841,651,It looks like we'll have to delay your colonoscopy.
942,2051,23,42,187,252,1.3492063492063493,0.04040635020799941,651,I strongly suggest you take precautions during mating season
5821,2051,16,56,180,252,1.3492063492063493,0.03756775562111963,651,I recommend that you switch to a feather boa.
6090,2051,20,48,184,252,1.3492063492063493,0.03921497770668475,651,"Yeah, it's been going around a lot of people lately."
2927,2054,17,47,168,232,1.3491379310344827,0.040226219631281944,651,It says here you are in a phobia treatment program.
5827,2054,19,43,170,232,1.3491379310344827,0.0411434897826694,651,And then I want you to put on the gown so that it's open in the back.
4726,2056,16,57,182,255,1.3490196078431373,0.03726343319917972,651,"Ok, good news first.  I think we know what is causing your sleep apnea."
6086,2056,11,67,177,255,1.3490196078431373,0.035130769819946346,651,If you could just slip out of that I'll take a look.
5737,2058,15,52,168,235,1.348936170212766,0.0389410739252709,651,Take the diazepam tonight and the mongoose in the morning.
2552,2058,16,50,169,235,1.348936170212766,0.03940529770969406,651,This is the one case where snake oil will help
4381,2058,19,44,172,235,1.348936170212766,0.04076626344170188,651,And what’s the last thing you remember after you took the Ambien?
3442,2061,20,50,188,258,1.3488372093023255,0.03856313083653875,651,I'm prescribing a mild sedative for your pet python's separation anxiety.
7072,2062,15,53,170,238,1.3487394957983194,0.03860274142757946,651,I see here that you have a complaint of tightness in your chest?
2101,2062,18,47,173,238,1.3487394957983194,0.039956767991338404,651,"Any known allergy to mongooses, Mr. Williams?"
3679,2062,20,43,175,238,1.3487394957983194,0.04083451665000705,651,Any difficulty breathing?
6955,2062,24,35,179,238,1.3487394957983194,0.04253571009742071,651,"Sorry, your insurance only covers snake bites"
7071,2066,18,55,188,261,1.3486590038314177,0.037469317568946156,651,Well Mr Tiles I can do your procedure your still covered under Cobra
7979,2066,19,53,189,261,1.3486590038314177,0.03786056262587871,651,"Fortunately, your test results show that it is a python, not an anaconda."
650,2066,22,47,192,261,1.3486590038314177,0.039010761747814204,651,"Constricted breath, difficulty exercising, sudden hissing. My diagnosis is asthma."
5042,2066,17,57,187,261,1.3486590038314177,0.037073943893481176,651,pressure getting to you?
7467,2070,20,36,162,218,1.348623853211009,0.04349752367099632,651,Thanks for squeezing me in Doc.
3962,2071,19,46,176,241,1.3485477178423237,0.04003844791660414,651,"Yes, an inability to touch one's toes is of some concern, but I don't think you're seeing the entire picture, Mr. Smith."
4667,2071,16,52,173,241,1.3485477178423237,0.03872134904334555,651,"Well, yes, I did say to wear a compression garment after your liposuction......"
5440,2071,15,54,172,241,1.3485477178423237,0.038272244840422624,651,So everything's fine aside from that?
4039,2074,16,53,175,244,1.348360655737705,0.038391156081162496,651,I think it's time to consider a less restrictive weight loss program.
6650,2074,18,49,177,244,1.348360655737705,0.03925994895681347,651,Good thing it already ate.
6329,2074,19,47,178,244,1.348360655737705,0.039687214005436414,651,I'm thinking this concludes our little experiment with homeopathy.
4792,2077,22,49,196,267,1.348314606741573,0.03837809275640299,651,Other than the strep throat was there any other problem you wanted to discuss?
343,2078,11,56,157,224,1.3482142857142858,0.03818619609800448,651,Think of it as a comfort animal.
3215,2079,15,41,148,204,1.3480392156862746,0.04292086563890519,651,"I'm sorry Mr. Jones, your insurance wouldn't cover the back brace, so this was the best that we could do."
83,2080,16,47,164,227,1.3480176211453745,0.040345330108492145,651,When did you start feeling this tightness in your chest?
8875,2080,16,47,164,227,1.3480176211453745,0.040345330108492145,651,"And what brings you in here today, Mr. Smith?"
2611,2082,19,49,182,250,1.348,0.0390085975488856,651,You say it came on right after you bit from the apple?
7782,2082,20,47,183,250,1.348,0.03941825968744877,651,I’m referring you to a great couples therapist I know.
7685,2084,18,59,196,273,1.347985347985348,0.036317618346425246,651,Do you want me to pull it off fast or slow?
5799,2085,20,40,170,230,1.3478260869565217,0.041833321984292265,651,The generic snake oil works just as well.
4255,2085,20,48,185,253,1.3478260869565217,0.0390840499978691,651,"Symptoms include shortness of breath, overall joint pain and paranoia.  Anything else?"
8655,2085,16,48,166,230,1.3478260869565217,0.03997671456360262,651,"I recommend you take a couple days off, get away to someplace nice, and try to unwind."
8890,2085,21,38,171,230,1.3478260869565217,0.0422847384818317,651,I did tell you there might be side effects...
9180,2085,20,48,185,253,1.3478260869565217,0.0390840499978691,651,"I'd follow her lead and just eat the apple next time, Adam."
2628,2085,16,48,166,230,1.3478260869565217,0.03997671456360262,651,I’ll need him to turn his head and slough.
5392,2091,16,65,198,279,1.3476702508960574,0.035048321629769216,651,"Well, I don’t think it’s ringworm"
2875,2092,16,57,183,256,1.34765625,0.03714261765701821,651,That’s OK. We can take your pulse at your ankle.
8542,2093,16,49,168,233,1.3476394849785407,0.03961698789097162,651,"So, for 'emergency contact' - your wife or your main squeeze?"
8204,2093,18,45,170,233,1.3476394849785407,0.040540141411313464,651,"After looking at your MRI, I think we’ve finally identified what’s causing that tightness in your chest."
802,2093,17,47,169,233,1.3476394849785407,0.040081222506322615,651,Yeah. I've been up for 72 hours. Just tell me your problem.
1597,2093,21,39,173,233,1.3476394849785407,0.04188674097841874,651,This feeling of being suffocated might not just be in your head.
4060,2093,16,49,168,233,1.3476394849785407,0.03961698789097162,651,"I'm glad you stopped smoking, but I still hear a little rattle in your chest"
7040,2093,16,49,168,233,1.3476394849785407,0.03961698789097162,651,"Sorry Howard, since Trump took office millions of swamp creatures have been coming out of hiding and heading for DC."
28,2099,21,48,190,259,1.3474903474903475,0.0388249384438506,651,"So, you’re having difficulty swallowing..."
459,2100,17,48,171,236,1.347457627118644,0.03972236741064076,651,"In time, you'll forget you even have a gastric band."
775,2101,21,49,192,262,1.3473282442748091,0.03850643965227633,651,When did you notice breathing difficulties?
1224,2101,23,45,194,262,1.3473282442748091,0.03925864007144931,651,And then Eve just dropped the apple and ran.
2807,2103,21,41,177,239,1.3472803347280335,0.04111926297305471,651,Take a deep breath for me
4124,2103,18,47,174,239,1.3472803347280335,0.03981598001172436,651,We're going to need to run some tests.
5381,2103,27,29,183,239,1.3472803347280335,0.043609137044358225,651,"Unfortunately, this will not stay in Vegas."
2492,2106,23,38,181,242,1.3471074380165289,0.04158211937771886,651,"Shortness of breath and wheezing. Okay, I'm gonna run some tests."
4119,2106,18,48,176,242,1.3471074380165289,0.03946657785924288,651,This prescription for your reptile dysfunction might lead to muscle ache. Are you okay with that?
7815,2106,20,44,178,242,1.3471074380165289,0.040326114634675045,651,I have a better solution for your constipation
8743,2106,19,46,177,242,1.3471074380165289,0.03989866093898787,651,"I'm sorry sir, but the side effects were clearly stated in the television commercial."
1789,2110,13,51,158,222,1.3468468468468469,0.03943384567346852,651,"Henry, when my nurse asked you to bring in your cobra details, I don’t think she had this in mind!"
6322,2110,12,53,157,222,1.3468468468468469,0.038913537977827616,651,I wish I could help you but this is a pre-existing condition.
6714,2112,18,50,180,248,1.346774193548387,0.03879162346241168,651,"I’m sorry, but without a referral from the vet..."
4943,2112,14,58,176,248,1.346774193548387,0.03707007687296082,651,It seems you’ve been under a lot of pressure lately.
5607,2112,12,62,174,248,1.346774193548387,0.03617859689963215,651,I’m putting you on a constricted diet.
8679,2112,17,52,179,248,1.346774193548387,0.038368479093898844,651,"Good news, Mr Jones...all the tests came back negative."""
4657,2116,21,53,200,274,1.3467153284671534,0.037298345768830815,651,How do you spell Eve?
3743,2116,22,51,201,274,1.3467153284671534,0.03765506406986828,651,It's not your colon.
112,2118,14,50,161,225,1.3466666666666667,0.03958114029012639,651,"Springtime in the everglades, my busiest time of the year."
5040,2118,14,50,161,225,1.3466666666666667,0.03958114029012639,651,The good news is we can remove the mole on your cheek!
6486,2120,23,41,187,251,1.346613545816733,0.0404840476209581,651,Contact in case of emergency?
6391,2120,18,51,182,251,1.346613545816733,0.038465511331258896,651,So you weren't lying when you told me about your 'ereptile' dysfunction.
3130,2120,15,57,179,251,1.346613545816733,0.03720185522382894,651,"So tell me, when did you first notice the constriction"""
58,2120,23,41,187,251,1.346613545816733,0.0404840476209581,651,So you had no idea your emotional support animal was afraid of flying?
163,2124,14,51,163,228,1.3464912280701755,0.039223861887137265,651,"Now, I've got to ask this : have you been travelling ?"
5109,2124,18,43,167,228,1.3464912280701755,0.04114708728445167,651,Good news - you're not dying from cancer!
281,2126,20,48,186,254,1.3464566929133859,0.03895394908664338,651,"Sir, I believe the nurse asked you to put on the gown."
7469,2126,17,54,183,254,1.3464566929133859,0.037736485975464744,651,"Not as charming as you thought, ey?"
4474,2128,17,46,168,231,1.3463203463203464,0.04030151098856074,651,How soon after you ate the apple did the pain occur?
5658,2128,18,44,169,231,1.3463203463203464,0.04076585953792054,651,"So Monte, when did you first notice the python?"
1473,2130,14,61,182,257,1.3463035019455254,0.036192130685380616,651,I have concluded your shortage of breath is not caused by any internal problem.
5968,2130,16,57,184,257,1.3463035019455254,0.03702253352915382,651,How  long have you been together?
7989,2132,20,41,173,234,1.3461538461538463,0.04129198510424786,651,So you say you are feeling some tightness in your chest?
8633,2132,12,57,165,234,1.3461538461538463,0.03757084658245133,651,Let's have you try the extended release capsule.
6207,2132,15,51,168,234,1.3461538461538463,0.039007894499316985,651,"Well sir, I have some crushing news."
2796,2132,20,50,190,260,1.3461538461538463,0.03831275052097196,651,"And also on a scale of 1 to 10, how difficult would you say it is to breathe?"
6903,2136,23,54,212,289,1.3460207612456747,0.036584184889749724,651,Looks like your coverage is good.
7277,2137,22,38,177,237,1.3459915611814346,0.041779050038058194,651,"Your penile enlargement procedure with snake stem cells went extremely well, now we just have to do little trimming"
138,2137,17,48,172,237,1.3459915611814346,0.03958156759344666,651,Where does it hurt?
346,2137,15,52,170,237,1.3459915611814346,0.038667623169563875,651,"First of all, don't exhale."
1123,2137,17,48,172,237,1.3459915611814346,0.03958156759344666,651,It’s gonna take some time to unravel what’s bothering you.
2309,2137,16,50,171,237,1.3459915611814346,0.039127263990330195,651,I think I've identified your respiratory problem.
3036,2137,17,48,172,237,1.3459915611814346,0.03958156759344666,651,We can deal with the constrictions but those pale white legs are worrying me.
6126,2137,19,44,174,237,1.3459915611814346,0.040474879922314536,651,"I need you to stand up, touch your toes and cough."
6276,2137,16,50,171,237,1.3459915611814346,0.039127263990330195,651,The good news is I've isolated the cause of your constricted breathing.
5561,2145,23,46,197,266,1.3458646616541354,0.03881133020234876,651,You might want to consider getting a different type of therapy animal.
5407,2146,18,47,175,240,1.3458333333333334,0.0396761281099166,651,"So, trouble breathing, a tightness in your chest and abdomen.  Anything else?"
6610,2147,12,50,152,214,1.3457943925233644,0.03985714887090607,651,"Take two of these at bedtime, and try not to look delicious."
5238,2148,22,49,198,269,1.345724907063197,0.038136047160601254,651,"First of all, we need to remove that mouse tattoo from your chest."
593,2149,17,50,176,243,1.345679012345679,0.03889500213504704,651,Your insurance no longer covers emotional support reptiles.
5252,2150,13,49,155,217,1.3456221198156681,0.040022166214287565,651,So its a yes to “been to places where large snakes are common”.
6528,2151,17,51,178,246,1.3455284552845528,0.03856348722413336,651,I am prescribing myself an anti-psychotic as I appear to be having an hallucination.
5300,2151,14,57,175,246,1.3455284552845528,0.03725037625256387,651,I've only seen one previous case and it didn't end well.
930,2151,15,55,176,246,1.3455284552845528,0.03769316299101225,651,And what might be the problem today?
214,2151,19,47,180,246,1.3455284552845528,0.039414598279124684,651,"Besides this, how was your Costa Rica ziplining experience?"
242,2155,17,42,161,220,1.3454545454545455,0.04169147154035187,651,"""Have you recently traveled abroad?"
3533,2155,12,52,156,220,1.3454545454545455,0.03912318746120285,651,Good news. The snake is not venomous.
1320,2155,19,57,199,275,1.3454545454545455,0.03646303601064661,651,"Do you have a family history of constriction?"""
571,2158,15,56,178,249,1.3453815261044177,0.037382884605870435,651,"On the bright side, it’s not poisonous,"
2329,2158,16,54,179,249,1.3453815261044177,0.03781359116021458,651,"Relax, we wait until he realizes you’re too big to swallow"
5675,2158,18,50,181,249,1.3453815261044177,0.038660611821127774,651,Any tightness around your chest area?
1038,2161,19,39,165,223,1.345291479820628,0.042259860048237785,651,What concerns me is that it didn't show up on your last colonoscopy
4113,2161,13,51,159,223,1.345291479820628,0.03928741414330679,651,Sure I've seen this before. Just not with that kind of snake.
625,2163,20,47,185,252,1.3452380952380953,0.03915333589124753,651,And when did you first notice the feeling of constriction?
1291,2163,16,55,181,252,1.3452380952380953,0.03750340647574878,651,Either of you allergic to muscle relaxers?
683,2165,17,44,165,226,1.345132743362832,0.04090414870008957,651,"Yes, tightness in the chest...what other symptoms?"
3732,2166,20,48,187,255,1.3450980392156864,0.03882466784456759,651,So how have your bowel movements been?
4839,2167,20,39,170,229,1.3449781659388647,0.041918923418407285,651,"To be on the safe side, I'm ordering an angiogram—a tightness in the chest can never be ignored."
1608,2168,18,53,187,258,1.3449612403100775,0.03771167839815665,651,Are you sure this was consensual?
6848,2168,18,53,187,258,1.3449612403100775,0.03771167839815665,651,When did she develop this crush on you?
403,2170,21,57,209,287,1.3449477351916377,0.03607976102910873,651,Breathe normally
6672,2171,21,48,192,261,1.3448275862068966,0.03857266181295459,651,"I’ll have to order some tests, of course, but I think you may be being strangled by a python."
2716,2171,21,48,192,261,1.3448275862068966,0.03857266181295459,651,I’ll prescribe a lotion for that scaly skin. Any other changes since your last visit?
2407,2171,19,52,190,261,1.3448275862068966,0.03780086444521436,651,Keep it wrapped two more days.
8845,2171,21,48,192,261,1.3448275862068966,0.03857266181295459,651,I don't want you to be rattled.
6759,2175,17,47,171,235,1.3446808510638297,0.03979417198651324,651,"Of course we’ll have to do some tests, but I have an idea what the problem might be"
4717,2176,13,56,169,238,1.3445378151260505,0.03760079037644519,651,We're waiting for a second opinion from your vet.
7378,2177,20,32,157,209,1.3444976076555024,0.04478616747431355,651,Any family history of poisonous snakes wrapped around the torso?
3004,2178,22,49,199,270,1.3444444444444446,0.03801611046177989,651,"Snake oil is snake oil, whether you buy it bottled or harvest it yourself."
506,2178,16,61,193,270,1.3444444444444446,0.035777138951813926,651,"Bob, you've just got to learn to unwind."
2519,2180,17,49,175,241,1.3443983402489628,0.03909747229984931,651,Would you mind filling out a short survey about your visit today?
9099,2180,20,43,178,241,1.3443983402489628,0.04040231156841784,651,"First, a few questions. What seems to be your problem?"
187,2180,21,41,179,241,1.3443983402489628,0.040827991950166384,651,Have you been on a plane recently?
8475,2183,22,50,201,273,1.3443223443223444,0.03771685478546179,651,I can't confirm what's causing your shortness of breath until I get the MRI results.
1197,2184,15,54,175,244,1.3442622950819672,0.03788093687265104,651,The good news is that your trouble breathing is not asthma.
8596,2184,18,48,178,244,1.3442622950819672,0.03919387029389802,651,The prognosis gives you another three minutes.
4373,2184,21,42,181,244,1.3442622950819672,0.04046422566761942,651,Your insurance won’t cover removal. The South American boa constrictor is out of network.
416,2187,20,55,201,276,1.3442028985507246,0.03671288103956224,651,"I see why you would think that, but we will need to see the test results in a few days."
574,2188,15,44,156,215,1.344186046511628,0.04131353196537977,651,"Snake oil, but your insurance won't cover it."
8751,2188,16,42,157,215,1.344186046511628,0.04183630880685426,651,"Believe it or not, I'm going to write you a script for snake oil."
516,2190,16,53,178,247,1.3441295546558705,0.03800187522858438,651,It's cheaper just to let nature take it's course.
3899,2191,21,54,204,279,1.3440860215053763,0.03678776705296333,651,"On the plus side, your cholesterol is down."
7294,2192,15,45,158,218,1.3440366972477065,0.04091635432346025,651,"Yes I did remove an unwanted mole for your brother, but I think you may have misunderstood"
8667,2193,17,52,181,250,1.344,0.038111230148787055,651,On a scale of 1-10 how hard is he squeezing?
9061,2194,21,34,166,221,1.3438914027149322,0.043467613582489975,651,I'm going to need to run some tests...
6475,2195,16,55,182,253,1.3438735177865613,0.03737979331637043,651,Can you point to where you're feeling the pressure?
4392,2195,18,51,184,253,1.3438735177865613,0.03820979117384113,651,"The good news is the x-rays show he's eaten recently, so come back in about a week and we'll take another look."
1900,2195,19,49,185,253,1.3438735177865613,0.03861810117206095,651,It's not the coil I meant for birth control but who am I to argue with what works.
99,2198,13,51,160,224,1.34375,0.039141995503289055,651,Do you have any constrictions I should know about?
5031,2198,17,43,164,224,1.34375,0.04113696099102599,651,This delusion you say you have about snakes. Can you elaborate?
7953,2198,16,45,163,224,1.34375,0.04064739994978486,651,You say he's not eating?
6678,2198,20,48,188,256,1.34375,0.038696199210430646,651,Just be happy you didn't have to see the proctologist for this.
3114,2202,20,49,190,259,1.3436293436293436,0.0383773780803124,651,Can you sign this release form?
581,2203,21,36,170,227,1.3436123348017621,0.04262228241696695,651,Are you having any other breathing problems
6262,2204,17,56,189,262,1.3435114503816794,0.03689491789260125,651,"Tylenol 3s for you, and a wart hog for your friend."
680,2204,19,52,191,262,1.3435114503816794,0.037679303229584744,651,No exceptions. I need the insurance card first.
1585,2204,16,58,188,262,1.3435114503816794,0.03649640398065519,651,I understand you feel some tightness.
5720,2204,19,52,191,262,1.3435114503816794,0.037679303229584744,651,My advice? That you forget about Fifi and let pythons be pythons.
7523,2204,19,52,191,262,1.3435114503816794,0.037679303229584744,651,"We are all wrapped up here, just go home and unwind."
5175,2209,18,43,169,230,1.3434782608695652,0.04084386525372826,651,Your pressure and heart rate seem elevated. Is anything causing you stress?
4952,2209,23,33,174,230,1.3434782608695652,0.043105483758355524,651,The good news is your erectile dysfunction has resolved itself.
2708,2209,14,51,165,230,1.3434782608695652,0.03894011052787342,651,"Unfortunately, according to your policy, this falls under pre-existing condition"
652,2209,17,45,168,230,1.3434782608695652,0.04037634268515764,651,Will your friend also be getting the flu shot today?
6304,2209,16,47,167,230,1.3434782608695652,0.03990334282229817,651,Switch to a feather version and your chest pain should clear right up.
7802,2209,19,41,170,230,1.3434782608695652,0.04130609651250211,651,"What goes around, comes around."
7026,2215,25,41,199,265,1.3433962264150943,0.03960766413543092,651,Lets see what the lab and x-rays show.
3210,2216,12,56,165,233,1.3433476394849786,0.03762704512660187,651,These attachment disorders can be tricky.
3010,2216,21,38,174,233,1.3433476394849786,0.0418184473335738,651,I'm going to give you a subscription for a small deer.
8529,2218,16,49,171,236,1.3432203389830508,0.0391947325070544,651,"Okay, I will note in the chart you have 'killer abs'."
3876,2219,21,51,199,271,1.3431734317343174,0.03753452619485491,651,It's the original pre-existing condition.
9033,2220,11,60,168,239,1.3430962343096233,0.03652047989488833,651,And we’ll get you some lotion for those scales.
7574,2220,15,52,172,239,1.3430962343096233,0.03839775361429192,651,They’re just having some fun with you at the gastroenterology clinic. This isn’t the colonoscopy snake.
8482,2220,15,52,172,239,1.3430962343096233,0.03839775361429192,651,You might experience some tightness when swallowing.
3100,2220,19,44,176,239,1.3430962343096233,0.04018742979458619,651,We may have to perform a Coilonoscopy.
6959,2224,20,43,179,242,1.3429752066115703,0.040260174119899156,651,So for the first two weeks you just assumed it was your mother?
7738,2224,18,47,177,242,1.3429752066115703,0.039399198806007785,651,And when did the tightness begin?
2995,2226,15,54,176,245,1.3428571428571427,0.03775216322326619,651,"Let's see, yup... you're covered for the removal, but not for the disposal."
633,2226,19,58,203,280,1.3428571428571427,0.035971932914071046,651,"My diagnosis , "" you are a riddle , inside an enigma , wrapped in a python ""."
2264,2226,15,42,153,210,1.3428571428571427,0.041970784171286794,651,"Stop wearing the Boa .
  It’s much too constricting ."
6406,2226,8,68,169,245,1.3428571428571427,0.03451135741412392,651,Come back and see me in two weeks if things don’t loosen up
8410,2226,20,44,181,245,1.3428571428571427,0.03990621323554688,651,It's the new treatment for constipation...
699,2231,17,51,180,248,1.342741935483871,0.03830237016261058,651,Take two vermin and see me in a week.
4693,2231,19,47,182,248,1.342741935483871,0.03914551424895059,651,Is it a choking sensation or just a tightness in the chest?
3352,2231,16,53,179,248,1.342741935483871,0.03787376000878531,651,You’re suffering from constrictive heart failure
3635,2231,22,41,185,248,1.342741935483871,0.04037723212933894,651,Have you traveled abroad lately?
4973,2235,19,48,184,251,1.342629482071713,0.038813860534491526,651,Give him three mice daily and pray that he molts you soon.
8035,2235,20,46,185,251,1.342629482071713,0.03922229314498475,651,"Bella, I told you not to hug the patients without their consent!"
2762,2237,20,47,187,254,1.3425196850393701,0.03889177572207686,651,"On the other hand, a squeezing feeling in the chest is often the first symptom of a heart attack."
5447,2237,20,47,187,254,1.3425196850393701,0.03889177572207686,651,All of your test results are finally back and I think I have pinpointed the cause of your tightness of the chest.
6539,2237,21,45,188,254,1.3425196850393701,0.03928985633348358,651,"It DOES appear to be a snake, alright. The Herpetologist can see you next Thursday..."
5282,2240,21,46,190,257,1.3424124513618676,0.03896063162366611,651,This is why Lady Gaga went with the meat dress.
4714,2240,19,50,188,257,1.3424124513618676,0.03817241348336992,651,"And you say it only hurts when you breathe?"""
4323,2240,17,54,186,257,1.3424124513618676,0.03736757265030352,651,I'm prescribing a muscle relaxant.
7491,2240,18,52,187,257,1.3424124513618676,0.03777213680029946,651,Have you recently traveled to any tropical countries?
1247,2240,18,52,187,257,1.3424124513618676,0.03777213680029946,651,and...have you traveled to any foreign countries lately?
1498,2240,18,52,187,257,1.3424124513618676,0.03777213680029946,651,I’m going to write you a prescription for flute lessons.
3474,2246,19,51,190,260,1.3423076923076922,0.037862124504602364,651,What about shortness of breath?
7539,2246,23,43,194,260,1.3423076923076922,0.039399753689612446,651,Lots of men recoil before the prostate exam.
8873,2248,13,51,161,225,1.3422222222222222,0.03899758053364278,651,You’re sure?  No feeling of tightness in your chest?
3920,2249,14,62,187,263,1.3422053231939164,0.035574066284016756,651,Seems like you're under a lot of pressure. Just take some time off to unwind.
7881,2249,22,46,195,263,1.3422053231939164,0.03870031758158154,651,"Let me guess.  You’re boarding a plane soon, you can’t get the snake off you, so you want a prescription for an emotional-support animal."
2909,2251,20,38,170,228,1.3421052631578947,0.04200418736042455,651,"There’s nothing wrong with you medically.  If it bites you, be sure to come right back."
3196,2251,15,48,165,228,1.3421052631578947,0.039637576143015094,651,If we aren’t seeing results by next month another option could be the lap-band.
8217,2251,19,53,194,266,1.3421052631578947,0.03726125991320801,651,Have you two always been this tight?
487,2254,20,39,172,231,1.341991341991342,0.04160860264074141,651,I'm not sure if it's a boa or a python.  I'm going to go ahead and send you to a herpetologist.
4872,2254,16,47,168,231,1.341991341991342,0.03975804006861469,651,Your blood pressure isn’t where I’d like it to be.
6819,2254,13,53,165,231,1.341991341991342,0.03831150222040915,651,You’ll need to see if your insurance covers the mongoose.
7236,2254,14,51,166,231,1.341991341991342,0.03879967420338475,651,And I'm giving you some time off so you can unwind a bit
8213,2254,14,51,166,231,1.341991341991342,0.03879967420338475,651,I see he’s your main squeeze. Any other partners?
525,2259,20,40,174,234,1.3418803418803418,0.04122264183966867,651,This is actually one of the oldest constipation remedies on the books.
1347,2259,17,46,171,234,1.3418803418803418,0.03986550990384862,651,"Yes, this is fairly common from an emotional support animal."
4498,2259,15,50,169,234,1.3418803418803418,0.03893448342616118,651,And how is Eve doing?  I haven't seen her in a while.
9210,2259,17,46,171,234,1.3418803418803418,0.03986550990384862,651,Never thought I’d be prescribing snake oil!
7226,2263,12,57,168,237,1.3417721518987342,0.037179692542905325,651,The good news is that it's not asthma or COPD.
8757,2263,18,45,174,237,1.3417721518987342,0.03996092807103647,651,One side effect is you wind up looking like a poop emoji with legs
6484,2263,18,45,174,237,1.3417721518987342,0.03996092807103647,651,"Abdominal pain, shortness of breath. I have a couple of theories."
1940,2263,15,51,171,237,1.3417721518987342,0.03859537090043002,651,"Ordinarily, a tapeworm is diagnosed well before this stage."
2730,2263,16,49,172,237,1.3417721518987342,0.03905586205331227,651,"We'll skip the 'turn your head and cough' thing this year, OK?"
919,2263,12,57,168,237,1.3417721518987342,0.037179692542905325,651,I'm not sure you're covered.
1721,2269,14,54,172,240,1.3416666666666666,0.03780578104506913,651,"Other then ""constricted breathing"" have you experienced any other symptoms?"
2661,2269,15,52,173,240,1.3416666666666666,0.0382641422733407,651,So you say you're having some tightness in the chest?
7422,2269,11,60,169,240,1.3416666666666666,0.03639607904661513,651,A couple of mice a day and your constriction should go away
8324,2269,21,40,179,240,1.3416666666666666,0.04090659610423435,651,You say you're being terminated. Have you considered getting COBRA?
1143,2273,17,49,177,243,1.3415637860082306,0.03882657252136798,651,"Sorry, but I still have to rule out a prostate problem."
1957,2273,14,55,174,243,1.3415637860082306,0.037489629615352814,651,"Tightness of the chest, neck, back, and arms as well as fatigue and anxiety... classic symptoms of a heart attack."
6269,2273,22,39,182,243,1.3415637860082306,0.04095794683401778,651,If it was a snake it would have bit you
6538,2273,19,45,179,243,1.3415637860082306,0.039692858347535505,651,It appears you caught this on your recent trip to the Amazon rain forest
8583,2273,17,49,177,243,1.3415637860082306,0.03882657252136798,651,Insurance makes us fill these out.  Question 1: What are your symptoms?
8685,2273,18,47,178,243,1.3415637860082306,0.03926210474207009,651,So you’re from Florida?
9129,2279,17,50,179,246,1.3414634146341464,0.03849609220636088,651,"So, would you say the new therapy boa is alleviating or exacerbating your anxiety?"
4242,2279,17,50,179,246,1.3414634146341464,0.03849609220636088,651,"Heart rate and cholesterol levels are fine.
Any tension at home or on the job that might be causing this pressure?"
235,2281,19,47,183,249,1.3413654618473896,0.039012277072580724,651,"I took an oath, Mr. Curran: First, do no charm."
371,2281,21,43,185,249,1.3413654618473896,0.03983381719519074,651,I'm putting you on adderall
7508,2281,17,51,181,249,1.3413654618473896,0.038173060296965204,651,"I can give him some Valium for now, but he really needs anger management."
8795,2281,15,55,179,249,1.3413654618473896,0.037314974239354294,651,"Oh, it's a surprisingly common mistake, but I'm a HEPatologist not a HERPetologist"
3194,2285,21,44,187,252,1.3412698412698412,0.03949236667259952,651,I’m going to try you on snake oil.
1351,2285,11,64,177,252,1.3412698412698412,0.035262607533817006,651,So your tests are back and I think we know what's causing the elevated blood pressure.
1970,2285,17,52,183,252,1.3412698412698412,0.03785721610572326,651,Give her a muscle relaxer twice a day and maybe she won't be so clingy.
4566,2285,18,50,184,252,1.3412698412698412,0.03827255367502065,651,"Your blood pressure's a little high, but otherwise, I see no problem."
6786,2289,16,40,155,211,1.3412322274881516,0.04233942000773196,651,"Yes, you can keep the python on in the shower."
8130,2290,15,57,183,255,1.3411764705882352,0.03671673572632151,651,"You should have specified a ""feather"" boa."
8960,2290,17,53,185,255,1.3411764705882352,0.03754831112920533,651,Everyone will feel better if you'd just learn to unwind.
6275,2292,16,42,159,217,1.3410138248847927,0.041510196979636434,651,Whatever you googled i’m telling you it’s a sore throat.
12,2293,21,47,193,261,1.3409961685823755,0.03851260142544759,651,As your veterinarian I wouldn't worry about your python.  When you leave here I suggest you visit your doctor ASAP.
6079,2294,16,58,190,264,1.3409090909090908,0.03626592760648406,651,"So if I understand you correctly, you were wearing a Mickey Mouse t-shirt?"
5714,2294,20,50,194,264,1.3409090909090908,0.03782113367812739,651,I don't think your insurance covers this.
9209,2294,16,43,161,220,1.3409090909090908,0.04111153267848705,651,"Everything looks fine physically, but you appear to have attachment issues with your pet."
5077,2297,18,55,194,267,1.3408239700374531,0.036762520355048255,651,This procedure will empty your bowel in no time and reduce your waist size by up to 5 inches.
6114,2297,23,45,199,267,1.3408239700374531,0.03863009635843666,651,My prescription is to to have a rat tossed in front of him. Then run like like hell the other way>
3268,2299,14,64,192,270,1.3407407407407408,0.03493702204620282,651,The x-rays do show some minor constriction.
4991,2299,23,46,201,270,1.3407407407407408,0.03832005981276824,651,I'm prescribing you Adderrall.
7186,2301,13,51,162,226,1.3407079646017699,0.03885416009451524,651,Emergency Contact?
4421,2301,12,53,161,226,1.3407079646017699,0.038344678768836044,651,How long have you had this numbness in your feet?
8316,2303,15,48,166,229,1.3406113537117903,0.0394923724728952,651,"I’m very sorry, sir, but your insurance company doesn’t consider the removal medically necessary."
3824,2304,22,50,204,276,1.3405797101449275,0.037368215032058616,651,Your relationship with the snake ... symbiotic or adversarial?
5592,2305,18,43,171,232,1.3405172413793103,0.04054486390604207,651,"Tightening in the chest, huh? OK, take off your snake and we'll have a look."
810,2305,24,31,177,232,1.3405172413793103,0.043218051855410354,651,"Wheezing, chest pressure, anxiety.  I’m going with the most obvious:  asthma."
8758,2305,16,47,169,232,1.3405172413793103,0.039613734783367556,651,"Please state your reason for visiting the office today."""
891,2308,14,52,169,235,1.3404255319148937,0.038324130740727075,651,"Well, we'll need some snake oil to get you out of this."
4325,2308,16,48,171,235,1.3404255319148937,0.039261679731065445,651,"I’m sorry,  but without his consent my hands are tied."
5967,2308,17,46,172,235,1.3404255319148937,0.03972215684527921,651,"Don’t worry, you’ll shed it in 3-5 days."
7041,2308,19,42,174,235,1.3404255319148937,0.040627456759110274,651,"Yes, I can certainly certify him as a comfort cobra."
8935,2308,19,58,205,282,1.3404255319148937,0.03575757452470291,651,"Yes it's somewhat rare, but it is listed by the manufacturer as a possible side effect."""
8421,2308,15,50,170,235,1.3404255319148937,0.03879573747421936,651,When did you start having trouble breathing?
5660,2314,12,57,169,238,1.3403361344537814,0.03705098472491147,651,So you would say your breathing feels constricted?
5106,2314,19,43,176,238,1.3403361344537814,0.04026134641472916,651,"I see your weight shot up 30 pounds since your last check up. Has something changed in your daily routine, Mr. Humphries?"
6591,2314,14,53,171,238,1.3403361344537814,0.03799591966003298,651,"I think I can remove it.  If not, I’ll waive the co-pay."
5257,2317,21,40,180,241,1.3402489626556016,0.04076116743649067,651,"It's all fun and games Adam, 
until someone gets hurt"
139,2317,21,40,180,241,1.3402489626556016,0.04076116743649067,651,"Mr. Moskowitz , we’ll slide you right out when it’s finished digesting Mrs. Moskowitz."
2298,2317,14,54,173,241,1.3402489626556016,0.037675267013071535,651,"Well, new pets do tend, as a rule, to be a bit clingy."
3467,2317,14,54,173,241,1.3402489626556016,0.037675267013071535,651,I said to RESTRICT your diet.
6189,2321,17,49,178,244,1.3401639344262295,0.03869245066448729,651,You were only supposed to use the oil.
2767,2321,14,55,175,244,1.3401639344262295,0.03736190102442131,651,Vitals are good. Any trouble swallowing?
8600,2323,17,50,180,247,1.3400809716599191,0.038364836449027384,651,So chest tightness.... anything else!
7634,2323,16,52,179,247,1.3400809716599191,0.037933433364915,651,okay....so other than the tightness in your chest....
1684,2323,16,52,179,247,1.3400809716599191,0.037933433364915,651,It's what's going around these days.
1626,2326,15,55,180,250,1.34,0.03719048978059421,651,"The good news is, we found out what's causing your sore throat"
4061,2326,19,47,184,250,1.34,0.03887989951562866,651,"You know, they can make these with feathers."
1805,2328,17,52,184,253,1.3399209486166008,0.03773140502218021,651,So when did you first start noticing this?
7805,2328,22,42,189,253,1.3399209486166008,0.03975558964325325,651,Tightness in chest... do you smoke?
9109,2328,17,52,184,253,1.3399209486166008,0.03773140502218021,651,"I'm sorry, but the emotional support python may be exacerbating your hypertension."
767,2328,17,52,184,253,1.3399209486166008,0.03773140502218021,651,"Besides 'difficulty in breathing,' do you have any other complaints?"
966,2328,14,58,181,253,1.3399209486166008,0.0364629967938298,651,"Yes, I realize that I recommended compression."
1522,2333,15,57,184,256,1.33984375,0.03659730385365318,651,I recommend you see a herpetologist.
364,2333,16,55,185,256,1.33984375,0.03701350975331275,651,"Pressure in your chest and difficulty breathing? It's probably nothing, but I'll order an EKG."
3529,2335,25,38,196,259,1.3397683397683398,0.040221094782975274,651,Easy mistake...although I'm surprised you didn't notice the lack of feathers.
4073,2335,21,46,192,259,1.3397683397683398,0.0387042041074025,651,"So, Mr. Anders, what brings you to my office today?"
7452,2335,16,56,187,259,1.3397683397683398,0.03672007765712734,651,"Listen, I know I'm only. medical student, but I think I know what's causing your chest pain."
2258,2335,15,58,186,259,1.3397683397683398,0.03631024429354698,651,And when did you first experience shortness of breath?
7184,2339,15,41,153,209,1.3397129186602872,0.042053578543652985,651,Any symptoms other than tightness of the chest?
7299,2340,20,49,193,262,1.3396946564885497,0.03800453454326291,651,There is no reason to be concerned.  Shedding its skin is normal.
6398,2341,22,47,199,268,1.3395522388059702,0.03814203793320777,651,So you say you’ve been feeling constricted. And about how long does that feeling usually last?
4760,2342,16,42,160,218,1.3394495412844036,0.04134894451045358,651,The x-ray shows a slight bowel constriction.
8907,2342,15,44,159,218,1.3394495412844036,0.04083451085764248,651,"Sir, your comfort snake is really just trying to eat you."
1999,2344,17,41,163,221,1.339366515837104,0.04145331643777363,651,We’ve found that squeezing every last penny out of you is more palatable than affixing leeches to suck you dry.
1996,2345,15,46,163,224,1.3392857142857142,0.04007277515348639,651,Let's get you down to radiology for a second opinion.
7846,2345,12,52,160,224,1.3392857142857142,0.038544934787901844,651,I assume you brought someone to drive you home.
3017,2345,16,44,164,224,1.3392857142857142,0.040569270949837144,651,"Tightness in the chest... feelings of impending doom... I’ll have to run a few tests first, but, yes, it could be cardiac in nature."
4894,2345,16,44,164,224,1.3392857142857142,0.040569270949837144,651,Think that’s bad? You should see the old lady who swallowed the fly.
8881,2349,14,49,164,227,1.3392070484581498,0.03921201980450252,651,Any chest pains? Palpitations? Shortness of breath?
2256,2350,20,38,172,230,1.3391304347826087,0.041691004468099306,651,"As Morty’s veterinarian, I can tell you that everything looks totally normal."
7233,2350,21,36,173,230,1.3391304347826087,0.04214394539900725,651,Looks like your cortisol levels are a little high.
8669,2350,16,46,168,230,1.3391304347826087,0.03982776333937626,651,I think that your erectile dysnfuntion might be a synptom of a much larger problem.
681,2350,13,52,165,230,1.3391304347826087,0.03837100326954039,651,You'll need to see a sssspecialist.
5143,2354,18,43,172,233,1.3390557939914163,0.04039692077718359,651,"So, the nurse tells me you're experiencing a tightness in your chest."
4258,2354,15,49,169,233,1.3390557939914163,0.03899891285836307,651,"When his skin starts to shed, give him these pills twice a day."
6969,2354,20,39,174,233,1.3390557939914163,0.041302645730920774,651,"You describe a ""squeezing sensation""  in your chest area.  I'm ordering a full cardiac work-up."
7012,2357,16,48,172,236,1.3389830508474576,0.03912156517039211,651,When did you first notice the hissing sound in your left ear?
7932,2358,17,47,175,239,1.3389121338912133,0.03923159599668751,651,You say you're feeling constipated?
5793,2358,19,43,177,239,1.3389121338912133,0.0401178157416723,651,Take two hampsters every four hours and call me in the morning.
5321,2358,18,45,176,239,1.3389121338912133,0.039677180244632286,651,How long have you been hearing this strange hissing sound?
2453,2358,14,53,172,239,1.3389121338912133,0.03786339394843142,651,"Don't worry, it's not venomous."
2443,2358,18,45,176,239,1.3389121338912133,0.039677180244632286,651,"If you'll  take off your snake, we can get on with the exam."
4465,2358,16,49,174,239,1.3389121338912133,0.038780892417910856,651,"I think I can help you, but I'm afraid your friend has already been digested."
7751,2358,21,39,179,239,1.3389121338912133,0.040984877153875096,651,"Believe me, even with this prescription, the airlines are not going to let you board."
4910,2365,18,46,178,242,1.3388429752066116,0.039329902887683156,651,A lot of that going around.
4769,2365,17,48,177,242,1.3388429752066116,0.038891501441188296,651,When exactly did you start to notice a tightness in the chest?
6388,2365,15,52,175,242,1.3388429752066116,0.03799952803313061,651,Now I can prescribe you meds but I think this is more of a lifestyle change.
2254,2365,17,48,177,242,1.3388429752066116,0.038891501441188296,651,"Apply the oil twice a day, and yes, it's really called that."
2589,2365,13,56,173,242,1.3388429752066116,0.03708610760286669,651,"Mr. Jones, I'm a hematologist, and what you really need to see is a  herpetologist."""
8042,2370,25,33,187,245,1.3387755102040817,0.041886277367821134,651,"Well, your blood pressure seems OK; now if you hop down, I'll have him take your temperature."
5219,2371,18,48,182,248,1.3387096774193548,0.03865903700774297,651,"So, Adam, how have things been since the divorce?"
4754,2371,27,30,191,248,1.3387096774193548,0.042289122811914936,651,"I know you're on a diet, but your asp keeps getting bigger."
7018,2371,17,50,181,248,1.3387096774193548,0.03823442531927824,651,"Its messy. There's Eve, God and  the whole HMO thing"
8230,2371,19,46,183,248,1.3387096774193548,0.03907903536727355,651,Tightness of chest is a common symptom of boa constriction.
3815,2371,18,48,182,248,1.3387096774193548,0.03865903700774297,651,Well that just about wraps it up.
4514,2371,13,58,177,248,1.3387096774193548,0.03648659792325343,651,"When you wrote down that you were in a toxic relationship, I just thought...."
7589,2377,18,49,184,251,1.3386454183266931,0.038334892398114245,651,We no longer recommend an apple a day.
913,2378,19,48,187,254,1.3385826771653544,0.038425059094412184,651,Swallow one mouse and call me in the morning.
8742,2378,19,48,187,254,1.3385826771653544,0.038425059094412184,651,Any recent changes in your health?
5402,2380,20,47,190,257,1.33852140077821,0.03850561471536448,651,"Any tightness in your chest or difficulty breathing"""
2923,2381,15,58,187,260,1.3384615384615384,0.03619391898562841,651,"I don't often get the chance to prescribe a snake repellent, but here goes."
5383,2381,19,50,191,260,1.3384615384615384,0.037799469445196604,651,So Adam how's Eve been
5947,2381,16,56,188,260,1.3384615384615384,0.03660190980315457,651,Obviously with this condition you'll want to avoid driving or operating heavy machinery...
4906,2384,17,56,193,266,1.3383458646616542,0.03642969395301256,651,We’ve been seeing this going around a lot lately.
8656,2385,18,55,196,269,1.338289962825279,0.036532487083900625,651,Either let go of the human or we are going to shoot you full of muscle relaxer. Your choice.
8108,2386,17,37,156,210,1.338095238095238,0.04295828676524914,651,"Okay, but I'm not prescribing you any more emotional support rabbits."
1099,2386,13,45,152,210,1.338095238095238,0.040781620067390494,651,"-and then you took a bite of an apple. And then, Adam, what happened next?"
5485,2388,17,61,203,281,1.3380782918149465,0.03509058693986451,651,"How did this happen, last time I saw you were completely wrapped up in yourself."
4608,2389,12,48,153,213,1.3380281690140845,0.039837001756988594,651,Let's see if we can figure out this hissing noise keeping you up all night
5308,2389,17,38,158,213,1.3380281690140845,0.0425257712714219,651,The good news is your ECG is fine. That's not what's causing the tightness in your chest
5719,2389,23,50,211,284,1.3380281690140845,0.036919210669266005,651,The mice don’t seem to be working. I’m prescribing weasels.
7689,2389,14,44,155,213,1.3380281690140845,0.04093370877752839,651,"...or is it: “FEED a cold, and STARVE a snake...?”"
1327,2389,19,34,160,213,1.3380281690140845,0.04355482783258917,651,And when did you get into Monty Python?
5137,2394,10,53,153,216,1.337962962962963,0.038357958527827835,651,Do you feel any tightness in the chest area?
2812,2395,13,48,158,219,1.3378995433789955,0.03963392712802179,651,Let's start with some blood thinners and a bunch of mice.
2689,2396,14,47,161,222,1.337837837837838,0.03978616822845916,651,Anything in particular making you tense?
4221,2397,18,40,167,225,1.3377777777777777,0.041386891397415276,651,"Sorry, but this is considered a pre existing condition."
8289,2397,18,40,167,225,1.3377777777777777,0.041386891397415276,651,"I think I know what’s causing the shortness of breath, but I want to get an X-ray."
6159,2397,17,42,166,225,1.3377777777777777,0.04090467259200233,651,There are better ways to clear a frog from your throat
988,2400,8,61,159,228,1.337719298245614,0.03597848184817612,651,I think you need to unwind a little...
1090,2401,14,50,167,231,1.3376623376623376,0.03872189609751009,651,"So, what seems to be your problem?"
6215,2401,19,40,172,231,1.3376623376623376,0.04108044324138062,651,"Cramps, perspiration, heaviness of breath...so basically the same side effects as your last medication?"
4005,2401,16,46,169,231,1.3376623376623376,0.039682140431120116,651,"OK chest pressure, difficulty breathing and numbness in arms and legs. When did you first notice these symptoms?"""
3757,2404,17,46,174,237,1.3375527426160339,0.03943836664310023,651,"If by long term, you’re including lunch— No, I don’t think I’d be planning that far ahead."
6400,2404,19,42,176,237,1.3375527426160339,0.04033485062631067,651,This is why we don’ t recommend “home remedy” colonoscopy.
2785,2404,18,44,175,237,1.3375527426160339,0.03988912720605951,651,"No, no, in my professional opinion I’d say what you’re experiencing is definitely a “boa constrictor”, not a bowel constriction."
9134,2404,14,52,171,237,1.3375527426160339,0.0380540621500361,651,I think the bigger concern here are your cholesterol levels.
5735,2404,17,46,174,237,1.3375527426160339,0.03943836664310023,651,Give it two mice a day and call me in the morning.
1249,2409,18,45,177,240,1.3375,0.03953673944182015,651,So how long has your python had this separation anxiety disorder?
6314,2409,19,43,178,240,1.3375,0.03997525821276365,651,I can tell you right now that your blood pressure is too high.
8963,2409,16,49,175,240,1.3375,0.038644776603273,651,"Look on the bright side - it's much cheaper than the gastric bypass, the copay is just a few rats."
2966,2412,20,42,181,243,1.337448559670782,0.040050901638865904,651,"Well, at least you're not wrapped up in yourself anymore."
5551,2412,18,46,179,243,1.337448559670782,0.03919253056445373,651,Pythons are the #1 Doctor Recommended emotional support animal thanks to their incomparable hugs.
89,2414,16,51,179,246,1.3373983739837398,0.0379925885377058,651,I’m confused. You went to a vet first and you consider me a second opinion?
3454,2414,12,59,175,246,1.3373983739837398,0.03620360151362915,651,I guess I shouldn't ask you to step on the scales.
5246,2414,18,47,181,246,1.3373983739837398,0.038856206639535665,651,So shortness of breath is your chief complaint?
8863,2414,17,49,180,246,1.3373983739837398,0.03842682382275244,651,Monty Python?
6427,2418,19,46,184,249,1.3373493975903614,0.03894553803290927,651,"On a negative note, you have Stage 4 herpatitis."
7915,2418,16,52,181,249,1.3373493975903614,0.0376774745404291,651,I can squeeze you in for a follow up tomorrow.
8123,2418,18,48,183,249,1.3373493975903614,0.03852748781969503,651,"So, troubles breathing huh?"
8591,2418,22,40,187,249,1.3373493975903614,0.04017359552742176,651,You'll have to sign this before we can proceed.
8865,2422,16,54,185,255,1.3372549019607842,0.03706794299930009,651,Sit here for a few minutes and unwind.
4454,2422,15,56,184,255,1.3372549019607842,0.03664906417727232,651,Your boa is in surprisingly good shape for not having eaten in a month.
2548,2422,15,56,184,255,1.3372549019607842,0.03664906417727232,651,I take it the snake oil isn't helping?
6779,2425,10,67,181,258,1.3372093023255813,0.0342239459593108,651,"The surgeon who specializes in python removal 
can squeeze you in next Thursday."
6981,2425,19,49,190,258,1.3372093023255813,0.037983511191006104,651,"Yeah, I've seen this before. It's a biblical thing."
8266,2425,19,49,190,258,1.3372093023255813,0.037983511191006104,651,"Just out of curiosity, how long have you had that lisp?"
728,2428,23,42,196,261,1.3371647509578544,0.03920998167643971,651,Maybe you should try a turtleneck.
7275,2428,16,56,189,261,1.3371647509578544,0.036484456419246684,651,"So, aside from that, how was your trip up the Amazon?"
2503,2430,16,57,191,264,1.3371212121212122,0.03620193793897093,651,"I'm sorry ,Boas and Anacodas are covered, but your plan has a rider on Pythons."
3964,2430,23,43,198,264,1.3371212121212122,0.03888722725693067,651,So tell me...are you sexually active?
5423,2430,14,61,189,264,1.3371212121212122,0.03539731609553305,651,"I've got some good news and bad news for you.
First the good news. You don't have intestinal parasites"
8095,2433,22,50,207,279,1.3369175627240144,0.03702566734844141,651,There's nothing in the lab results to explain your shortness of breath.
6268,2434,16,40,158,214,1.3364485981308412,0.04183488947746344,651,"Unfortunately, your policy only covers Burmese pythons - try southeast Asia next summer instead of Florida."
8665,2435,13,47,157,217,1.336405529953917,0.03985230357050257,651,"How severe is your pain on a scale of 1 to 2,500?"
4893,2436,19,36,165,220,1.3363636363636364,0.04252049805027646,651,I need to know if you bit the apple
4648,2436,15,44,161,220,1.3363636363636364,0.04052096682932336,651,"I'm optimistic.  Last week you said 'oh, gee, it's up to my knee,' and I'm not hearing any knee complaints today."
4188,2436,19,36,165,220,1.3363636363636364,0.04252049805027646,651,You Need Cobra not Python Insurance
677,2439,14,47,162,223,1.336322869955157,0.03963631599962288,651,"Annnnnd, what seems to be the problem?"
1968,2439,20,35,168,223,1.336322869955157,0.04258441507465969,651,"Take a couple of these every night, John: they'll help you unwind..."
3384,2439,12,51,160,223,1.336322869955157,0.03860361717437431,651,Your blood pressure is off the charts.
4398,2439,19,37,167,223,1.336322869955157,0.04210740153123612,651,"I am afraid I cannot find a billing code for this issue. Sorry, but you will have to pay for this visit out of pocket."
4876,2443,18,42,172,232,1.3362068965517242,0.04047040675299363,651,And you say this was a Valentines day gift from your wife?
6488,2443,14,50,168,232,1.3362068965517242,0.03858209184852185,651,Are you feeling a tightness in your chest?
6155,2445,13,53,169,235,1.3361702127659574,0.03776887079629602,651,"So, this says you’ve been experiencing shortness of breath..."
552,2445,17,45,173,235,1.3361702127659574,0.03964805919300627,651,...and how long have you been feeling constricted?
7129,2445,17,45,173,235,1.3361702127659574,0.03964805919300627,651,So when did you start having chest pain?
301,2448,12,56,170,238,1.3361344537815125,0.03697350053999905,651,"Sorry, sir, I was talking to the python. He seems to have better coverage."
3372,2448,17,46,175,238,1.3361344537815125,0.03929791147753852,651,"I suggested you go on a restrictive diet, not a constrictor diet."
1401,2448,13,54,171,238,1.3361344537815125,0.03744992607528536,651,"Yes, there is a reason that you can’t raise your arms."
4658,2448,17,46,175,238,1.3361344537815125,0.03929791147753852,651,"Honestly Bill, aren't you getting a little too defensive about having your prostate examined?"
8554,2452,16,49,176,241,1.3360995850622406,0.038509562501344075,651,"Low oxygen, rapid weight gain . . . we'll need to run a few more tests."
1162,2453,17,48,179,244,1.3360655737704918,0.03862182191924226,651,"It may take a week or two, but you've just got to unwind."
1323,2453,15,52,177,244,1.3360655737704918,0.037738341266121425,651,"Well, this certainly explains 
the tightness in your chest you called us about."
1407,2453,18,46,180,244,1.3360655737704918,0.03905606856537626,651,I won't know what's causing your chest pain until I order some lab work.
1815,2453,19,44,181,244,1.3360655737704918,0.03948553982415691,651,"So - your difficulty breathing.  Is it all the time, or does it come and go?"
1923,2453,20,42,182,244,1.3360655737704918,0.03991038985811578,651,I'm writing you a prescription to ease your constriction.
1375,2453,16,50,178,244,1.3360655737704918,0.038182636956343816,651,"Well, we'll rule out COPD."
3706,2459,14,55,178,247,1.3360323886639676,0.03698356844102106,651,A course of antiboa-otics should clear this right up.
379,2459,13,57,177,247,1.3360323886639676,0.03653585944960806,651,That's nothing. Wait until you get my bill.
2971,2461,22,40,188,250,1.336,0.04003532576658953,651,"For insurance purposes, are you one or two patients?"
5501,2461,19,46,185,250,1.336,0.03881290722257576,651,"As a precaution, I’m prescribing a potent laxative for the snake."
6211,2461,15,54,181,250,1.336,0.03712044868860523,651,You took the subway?
8610,2461,13,58,179,250,1.336,0.03624459522095569,651,"On a scale of 1 to 10, with 1 be the mildest and 10 being the most crushing, how would you rate the constriction?"
9116,2465,18,49,186,253,1.3359683794466404,0.03807814216871271,651,And when did the shortness of breath start?
7695,2465,12,61,180,253,1.3359683794466404,0.03552080139156167,651,"Yes, it's like compression socks."
5674,2465,21,43,189,253,1.3359683794466404,0.03929444872729048,651,I want you to switch to a Paleo Diet and avoid the fruit of a certain tree.
3828,2465,19,47,187,253,1.3359683794466404,0.038487848830607366,651,I'm going to prescribe you some snake oil.
1561,2469,15,56,185,256,1.3359375,0.036529386295320446,651,Boris here will be your therapy pet.
4244,2469,15,56,185,256,1.3359375,0.036529386295320446,651,I see here that your blood pressure is up a little today.
5620,2471,17,54,191,262,1.3358778625954197,0.036767620499093774,651,When did you first notice this shortness of breath?
7847,2471,15,58,189,262,1.3358778625954197,0.03596335623381351,651,I'm concerned about your circulation.
4275,2473,22,45,198,265,1.3358490566037735,0.03839054707429398,651,"Chest tightness, shortness of breath.. It might be just stress."
7988,2473,19,51,195,265,1.3358490566037735,0.037256822346425605,651,I can hear a rattling in your chest. We need to get that checked out.
4340,2475,17,56,195,268,1.335820895522388,0.03620121117093182,651,Apparently your diet is not the cause of your high blood pressure.
8726,2475,23,44,201,268,1.335820895522388,0.038447737410365584,651,"The tightness in your chest could be caused by any number of things, Mr. Albers. We’ll have to run a few tests."
8045,2477,19,56,205,280,1.3357142857142856,0.03585736827325143,651,Has your constriction lasted for more than four hours?
939,2478,13,43,150,206,1.3349514563106797,0.04125900170570582,651,Unfortuntely we can't do anything until its bitten you
4612,2479,16,41,161,218,1.334862385321101,0.04126560919829281,651,"Your date of birth here says sixth day, but no month or year. Why is that?"
4281,2479,14,45,159,218,1.334862385321101,0.0402280329150573,651,The good news is your snake will be just fine.”
5070,2481,12,50,159,221,1.334841628959276,0.03880721567997421,651,"Well...I'll tell ya, it sure is a shame that we didn't detect this earlier..."
4361,2482,13,52,168,233,1.3347639484978542,0.03795897457127337,651,When did you first notice the hissing sound?
5196,2482,17,44,172,233,1.3347639484978542,0.03986073785938212,651,"In my experience, your shortness of breath is probably asthma, but let's see what the tests say..."
7650,2482,15,48,170,233,1.3347639484978542,0.03892147333540289,651,"Trust me, after a few weeks you’ll wonder how you ever got along without it."
5506,2485,16,47,173,236,1.3347457627118644,0.03904630406664765,651,Any symptoms other than tightness in your chest?
2360,2485,19,41,176,236,1.3347457627118644,0.040407919289698696,651,"Sorry for the long wait, I see your insurance is in order... 
What seems to be the problem?"
2761,2487,16,48,175,239,1.3347280334728033,0.0387068485932722,651,Next time specifically ask for a feather boa.
4939,2487,13,54,172,239,1.3347280334728033,0.03731941324390435,651,"Well, we've gotten results back from the lab, and I'm happy to report that the tightness in your chest is not the result of a heart attack."
6905,2487,17,46,176,239,1.3347280334728033,0.039158404407486136,651,"Doctor, it's not me.  I'm here for the snake."
5293,2490,21,40,184,245,1.3346938775510204,0.04018922747909714,651,So...your insurance company wants to know if this is a pre-existing condition
9027,2490,19,44,182,245,1.3346938775510204,0.039347960489213345,651,"Actually, it's not covered by anyone's insurance."
8509,2492,20,43,185,248,1.3346774193548387,0.03942700768326391,651,"You're fine, but the snake has a skin condition."
6619,2492,16,51,181,248,1.3346774193548387,0.037734460157445575,651,The good news is that the tightness in your chest is not attributable to cardiac health.
4897,2492,19,45,184,248,1.3346774193548387,0.03901075584996496,651,Do you have any other partners
970,2492,20,43,185,248,1.3346774193548387,0.03942700768326391,651,Tell me what seems to be the problem?
3613,2492,18,47,183,248,1.3346774193548387,0.038590014370494856,651,Here's a doctor's order for your service animal.
4813,2497,14,56,181,251,1.3346613545816732,0.03656320101915534,651,I am arranging a PET scan to see if we can determine what’s causing the tightness in your chest.
308,2497,14,56,181,251,1.3346613545816732,0.03656320101915534,651,"Okay, I’m going to ask you not to take a deep breath..."
3386,2497,20,44,187,251,1.3346613545816732,0.039090954561485425,651,"I’m sorry sir, we still have to perform a prostate exam. Standard procedure."
1484,2500,16,53,185,254,1.3346456692913387,0.03712185879416029,651,"So it says here, you’re suffering from shortness of breath. Would you say that is something recent?"
1358,2501,17,54,192,263,1.3346007604562737,0.036649810622917674,651,"Your chest is a little constricted, but your blood work looks just fine."
6446,2501,19,50,194,263,1.3346007604562737,0.03743339038785616,651,Shortness of breath?  For how long?
6734,2501,10,68,185,263,1.3346007604562737,0.03376437883890408,651,How long since the move has she been this clingy?
7350,2501,16,56,191,263,1.3346007604562737,0.036251669893658314,651,"Yes, I suppose we could use a blood pressure cuff instead."
1272,2505,25,39,202,266,1.3345864661654134,0.0393632472792034,651,You have one of the worst cases of coilitis I’ve ever seen
6419,2506,19,52,198,269,1.3345724907063197,0.036848706395474835,651,"On the plus side, it looks like your blood sugar is finally under control"
2352,2506,19,52,198,269,1.3345724907063197,0.036848706395474835,651,Give him two rats and call me in the morning.
687,2506,13,64,192,269,1.3345724907063197,0.034516274241930094,651,Does it hurt when you swallow?
173,2509,16,60,199,275,1.3345454545454545,0.035173627196950025,651,I think I can explain the shortness of breath.
673,2509,26,40,209,275,1.3345454545454545,0.03876354025168886,651,"So apparently not every apple keeps the doctor away, Adam."
920,2511,16,54,188,258,1.3333333333333333,0.036705433284246636,651,Your knee reflexes are fine.
4408,2511,15,45,165,225,1.3333333333333333,0.03984095364447979,651,"I meant you should go on a restricted diet,
not a constricted one!"
4417,2511,13,51,167,231,1.3333333333333333,0.038151661584212,651,And what seems to be your problem ?
4645,2511,16,45,170,231,1.3333333333333333,0.03960403804347979,651,I'm prescribing something to make you less delicious.
4697,2511,21,35,175,231,1.3333333333333333,0.04191297423079543,651,"This should help with the swelling, but side effects may include difficulty  breathing."
4752,2511,20,44,188,252,1.3333333333333333,0.03895816435012561,651,But should you unwind the python you will be full Monty.
9062,2511,18,40,170,228,1.3333333333333333,0.04092094877616514,651,...and discontinue the support animal for your back condition.
5216,2511,13,54,173,240,1.3333333333333333,0.03718975179142452,651,We'll have the results of your stress test in just a minute.
8958,2511,16,51,182,249,1.3333333333333333,0.03760663754294953,651,"Mr. Jones, I believe we're finally beginning to understand what might be behind your unusually high blood pressure."
5366,2511,18,54,198,270,1.3333333333333333,0.03635612554328079,651,It looks like PETA has blocked all the available treatments.
5408,2511,16,52,184,252,1.3333333333333333,0.037299602617236846,651,The good news is we did find the tail...
6106,2511,14,49,168,231,1.3333333333333333,0.03864185292581896,651,Fortunately your insurance pays for wraparound services.
4169,2511,17,43,171,231,1.3333333333333333,0.040076468722353514,651,"Good morning Mr. Pivnick, what brings you in today?"
6429,2511,22,42,194,258,1.3333333333333333,0.039093067537590176,651,"Sorry, this is the best colonoscopy procedure we can do with your medical insurance"
6584,2511,17,49,183,249,1.3333333333333333,0.03803481040129968,651,This is what keeps dermatology interesting.
7102,2511,18,43,176,237,1.3333333333333333,0.03981530220691694,651,"Sorry, all our herpetologists are out of network."
7605,2511,15,48,171,234,1.3333333333333333,0.03878118158015015,651,"Chest pressure yes, but I’m pretty sure it’s not a heart attack!"
7974,2511,17,42,169,228,1.3333333333333333,0.04044602806306529,651,I'm putting you on anti-constrictor medication.
8519,2511,18,52,194,264,1.3333333333333333,0.03692484704401356,651,I’m prescribing you this emotional support animal for your anxiety issues.
8524,2511,19,47,189,255,1.3333333333333333,0.038230642266790876,651,"And, you say you’re having trouble breathing, correct?"
8598,2511,17,42,169,228,1.3333333333333333,0.04044602806306529,651,So you’re trying to leave her because she’s smothering you?
8715,2511,15,49,173,237,1.3333333333333333,0.03844457273102843,651,"So tell me, where does it hurt?"
5605,2511,20,44,188,252,1.3333333333333333,0.03895816435012561,651,Strip down to your gerbils.
4101,2511,19,41,177,237,1.3333333333333333,0.04026184292371279,651,I'm going to recommend charm school.
8182,2511,18,47,184,249,1.3333333333333333,0.038458216511414664,651,Looks like you’ve been too charming for your own good.
3758,2511,23,42,199,264,1.3333333333333333,0.0388261527665161,651,"Let's see if we can't shuffle off this mortal coil, eh?"
221,2511,22,44,198,264,1.3333333333333333,0.038453413070413354,651,They say they won't cover this because it's a pre-existing condition.
382,2511,14,46,162,222,1.3333333333333333,0.03970184970948478,651,We feel its entirely allegorical.
784,2511,19,41,177,237,1.3333333333333333,0.04026184292371279,651,Trust me--next best thing to a laxative.
1022,2511,18,48,186,252,1.3333333333333333,0.03813790060382965,651,Get rid of the apple tree.
1284,2511,19,47,189,255,1.3333333333333333,0.038230642266790876,651,"As a rescue boa, you have to expect this kind of thing. Here's a Rx for a muscle relaxant."
1410,2511,14,56,182,252,1.3333333333333333,0.03644202585395018,651,The nurse said you are having trouble breathing?
3965,2511,14,52,174,240,1.3333333333333333,0.037655612354528425,651,Is there any history of this happening in your family?
1716,2511,19,47,189,255,1.3333333333333333,0.038230642266790876,651,So he was in your neighbor's apple tree?
2043,2511,13,52,169,234,1.3333333333333333,0.03782347372361169,651,I'm going have to refer you to a herpetologist.
2012,2511,22,46,202,270,1.3333333333333333,0.0378406552078849,651,And this was after Eve bit the apple?
2344,2511,20,42,184,246,1.3333333333333333,0.039632178651278646,651,I don't care how constipated you are. Stop taking medical advice from Goop.
2403,2511,14,54,178,246,1.3333333333333333,0.03703519343530181,651,"Possible side effects include tightness,faintness,claustrophobia,hysteria,loss of blood flow,immobility,neck strain,over-heating,and the sneaking suspicion you belong in a zoo."
2472,2511,12,55,170,237,1.3333333333333333,0.03702312865108167,651,"Look, everyone has excuses for high blood pressure, I’m still recommending lowering your sodium intake."
2527,2511,19,44,183,246,1.3333333333333333,0.03921129402783625,651,Is the tightness just in your chest?
2860,2511,13,56,177,246,1.3333333333333333,0.036584444064120765,651,"Okay, I see the problem. You can get dressed."
3168,2511,16,55,190,261,1.3333333333333333,0.03641785203646149,651,"So, tingling in the feet can have many root causes..."
3380,2511,14,40,150,204,1.3333333333333333,0.042081151027953956,651,"Well, we first met on Slithr."
3402,2511,15,45,165,225,1.3333333333333333,0.03984095364447979,651,I'm pretty sure it is not an allergy.
3520,2511,18,39,168,225,1.3333333333333333,0.041307979935470175,651,"Well, the snake is in-network, but the antivenin is out of network."
2341,2511,13,48,161,222,1.3333333333333333,0.03918510078725609,651,The good news is that this should shed off in about 6 months.
44,2511,19,49,193,261,1.3333333333333333,0.03761219585116299,651,The nurse screamed something about a tightness in your chest so I'm ordering an EKG to help us figure out what might be causing that.
1845,2558,17,53,192,262,1.33206106870229,0.0367015251085179,651,I see you're over 50. I'm recommending a colonoscopy.
4182,2558,18,51,193,262,1.33206106870229,0.037097835625192116,651,"Can you please be more specific when you describe feeling a ""tightness around your chest""?"
310,2560,18,50,191,259,1.332046332046332,0.037395212997185054,651,Your wife called and asked if you could pick up a few apples on the way home.
6374,2560,19,48,192,259,1.332046332046332,0.03779328270464528,651,What we are dealing with here is a strong case of separation anxiety.
5641,2562,18,49,189,256,1.33203125,0.037699092360397674,651,I'm going to refer you to a very good anaconda man I know.
1862,2563,20,44,189,253,1.33201581027668,0.03882623472834099,651,"You do have a COBRA from you last job, but I'm afraid there is no python benefit."
398,2563,17,50,186,253,1.33201581027668,0.037594783061207684,651,"I'm sorry sir, we only deal with first world problems here."
4522,2565,22,39,189,250,1.332,0.03996866242324873,651,Just because it doesn’t have feathers doesn’t mean you’re not gay.
6855,2565,17,49,184,250,1.332,0.03790582284587014,651,You're blood pressure is abnormally high.
2170,2565,16,51,183,250,1.332,0.03747963302336704,651,The Good news is the snake is in perfect health.
5492,2568,22,38,187,247,1.3319838056680162,0.040319265012580686,651,"...Loss of appetite, shortness of breath, tightness in your chest. I'm going to refer you to one of our resident charmers."
8022,2568,18,46,183,247,1.3319838056680162,0.03865206198269397,651,"Lucky for you, this is the only affliction Snake Oil cures."
2632,2570,19,43,182,244,1.3319672131147542,0.03941457854462291,651,"Generally when they wrap themselves around you like this, it's something other than a show of affection."
8101,2570,13,55,176,244,1.3319672131147542,0.036757595423531055,651,"I am referring you to Dr. Patel, down the hall. If he has his instrument, a pungi, he will charm that snake from you in two minutes."
5494,2570,15,51,178,244,1.3319672131147542,0.03766408830920258,651,"For now, you are restricted from physical activity...well, constricted."
9236,2573,20,40,181,241,1.3319502074688796,0.04019402790240771,651,The good news is you're on the outside of it.
1939,2573,18,44,179,241,1.3319502074688796,0.039324338338958056,651,"Good news?  You look dashing in a boa. 
Bad news?  It will be hungry soon.”"
4093,2573,10,60,171,241,1.3319502074688796,0.03563395028489142,651,"Well, WebMD is no doctor."
6658,2573,11,58,172,241,1.3319502074688796,0.03611587683439868,651,I'm prescribing a steroid cream for the scaly skin.
8232,2573,15,50,176,241,1.3319502074688796,0.037982484726026305,651,Those YouTube challenges keeps getting weirder
9245,2578,18,43,177,238,1.3319327731092436,0.03967238788547492,651,You’ve got to learn to unwind.
3060,2578,16,47,175,238,1.3319327731092436,0.038768336549425485,651,It gives a much more accurate reading of your blood pressure.
675,2578,18,43,177,238,1.3319327731092436,0.03967238788547492,651,Has it been more than four hours?
6519,2581,17,44,174,235,1.3319148936170213,0.039571867331296036,651,"If it's any consolation, what doesn't kill you makes you stronger."
5345,2582,21,35,176,232,1.331896551724138,0.041756649854650926,651,You just need a dose of antihisstamines.
6907,2583,17,42,170,229,1.331877729257642,0.04029531979489205,651,Your snake is in great health -- but I think it's about time you saw an MD.
2541,2583,15,46,168,229,1.331877729257642,0.03933321823277058,651,I’m going to pull it’s tail. Your legs will either spin like a top or your head will pop like a cherry.
7602,2583,20,36,173,229,1.331877729257642,0.04169686929028863,651,I checked and neither your primary nor your secondary covers this.
8625,2583,15,46,168,229,1.331877729257642,0.03933321823277058,651,Frankly I don't think your problem is asthma.
9235,2583,13,50,166,229,1.331877729257642,0.038346985744917315,651,"I see you’re fully covered, but unfortunately your snake is not."
157,2588,13,49,164,226,1.331858407079646,0.038688077550113935,651,This should reduce your swelling.
1069,2589,16,40,161,217,1.3317972350230414,0.04134169201113047,651,My wife has a similar handbag
773,2589,19,34,164,217,1.3317972350230414,0.042861914223089596,651,"I see here you’re complaining of difficulty swallowing, a tightness in you chest and a compacted bowel... anything else"
547,2589,14,44,159,217,1.3317972350230414,0.040296360919156886,651,"Uh huh, and have your contractions increased since your last visit?"
6946,2592,18,35,161,214,1.3317757009345794,0.04278590024155859,651,"So, when did you first notice the contractions?"
4767,2593,12,68,198,278,1.330935251798561,0.03333172327944588,651,Trust me.  It'll do wonders for your back pain.
176,2594,21,49,205,275,1.3309090909090908,0.03695210636658361,651,I just need you to fill out this form and then the doctor can see you.
7896,2595,15,57,191,263,1.3307984790874525,0.03578131663022001,651,"Mr. Ralston, I'm confident you have what we used to call grippe"
2168,2596,14,58,188,260,1.3307692307692307,0.03564373557668306,651,Just feed it three mice daily and you'll be just fine See you in a year.
3584,2596,21,44,195,260,1.3307692307692307,0.038449656614340647,651,Well we're out of rodents so let's give the clarinet a try.
3835,2598,18,48,188,254,1.330708661417323,0.03788231861721266,651,This is not what I meant when I suggested you constrict your activity.
3805,2598,12,60,182,254,1.330708661417323,0.0353317776580701,651,The good news:  We’ve killed your tapeworm.
6102,2600,22,39,190,251,1.3306772908366533,0.03983107454952533,651,Your cholesterol is ok but your pressure is through the roof!
658,2600,22,39,190,251,1.3306772908366533,0.03983107454952533,651,Do you feel out of breath when you go up stairs?
7075,2600,15,53,183,251,1.3306772908366533,0.036924340617656655,651,How long have you been feeling constricted?
1831,2603,18,46,184,248,1.3306451612903225,0.03851915917035433,651,I can see that you are feeling a bit constricted.
4047,2603,14,54,180,248,1.3306451612903225,0.036784863350416135,651,"...and his name is Monty, you say?"
6016,2603,17,48,183,248,1.3306451612903225,0.03809298833539469,651,There is nothing I can do until you sign this consent form.
4558,2606,18,45,182,245,1.3306122448979592,0.038848516435357715,651,And you say Eve ate the whole apple.
717,2607,18,44,180,242,1.3305785123966942,0.039185519496925954,651,Are you currently feeling any discomfort?
8058,2607,18,44,180,242,1.3305785123966942,0.039185519496925954,651,"The herpetologist can see you a week from Thursday.""You OK with that"
7926,2607,19,42,181,242,1.3305785123966942,0.039620667776409324,651,‘My prescription for you...Get out of Florida immediately.”
7,2607,14,52,176,242,1.3305785123966942,0.037394323513408004,651,I have some good news regarding your scoliosis.
9100,2607,15,50,177,242,1.3305785123966942,0.03785007011658043,651,I'm admitting the snake to the hospital.  You just have to go along.
7009,2607,16,48,178,242,1.3305785123966942,0.03830039405325605,651,So...it says here you feel a tightness in your chest?
7361,2613,14,51,174,239,1.3305439330543933,0.037709607645597484,651,I have your test results. It’s not a goiter.”
2323,2614,19,40,177,236,1.3305084745762712,0.040333164220140855,651,"On the plus side, all of your vitals look good..."
6873,2614,19,40,177,236,1.3305084745762712,0.040333164220140855,651,"Sorry, your health plan doesn't cover pre-existing conditions."
3556,2616,16,45,172,233,1.3304721030042919,0.039315224081060286,651,Apparently not all pets lower your blood pressure.
5578,2616,14,49,170,233,1.3304721030042919,0.038362605600351006,651,I think that we might have figured out what is causing the tightness in your chest.
6359,2618,14,48,168,230,1.3304347826086957,0.03870088900764111,651,Tightness in chest...any other symptoms?
46,2618,17,42,171,230,1.3304347826086957,0.04014568034904928,651,Your blood pressure is a little high. Are you exercising
4046,2618,15,46,169,230,1.3304347826086957,0.03918840504814128,651,You need to unwind. Literally.
172,2621,19,37,171,227,1.330396475770925,0.04146837613875908,651,Is there a reason you didn't  come in earlier?
9232,2621,17,41,169,227,1.330396475770925,0.04051736109110705,651,"Well, yes, that constricted feeling in the chest is a common symptom of a panic attack. However, it could also be caused by your pet snake."
4982,2621,12,51,164,227,1.330396475770925,0.038035935315054815,651,I reccomend three aspirin and eight live rats daily.
1509,2621,17,41,169,227,1.330396475770925,0.04051736109110705,651,"When did this relationship start, and why do you think she's become so possessive?"
9203,2625,14,46,164,224,1.3303571428571428,0.03940256194695839,651,And are you feeling any shortness of breath?
6656,2625,13,48,163,224,1.3303571428571428,0.038891174462652445,651,"Now, let's talk about that so-called 'companion animal' of yours."
4013,2627,12,49,160,221,1.330316742081448,0.03871838164877361,651,"Whatever you do, don't exhale."
5732,2627,11,51,159,221,1.330316742081448,0.03818347472725742,651,Have you tried gyrating counter clockwise?
4367,2629,13,45,157,215,1.330232558139535,0.03998301322970297,651,We'll get your blood pressure down one way or another.
5733,2630,15,40,157,212,1.330188679245283,0.04145879867086471,651,... and how long have you been feeling this tightness in your chest?
7045,2631,20,49,201,270,1.3296296296296297,0.03704323230575369,651,How bad is the pain on a “scale” of 1 to 10 feet?
6098,2632,17,53,194,264,1.3295454545454546,0.036466200128252683,651,"Sssso, what sssseems to be the problem?"
8012,2632,20,47,197,264,1.3295454545454546,0.03763242268906966,651,OK...Tightness in your chest.  Have you been exercising?  How about alcohol consumption?  Getting enough sleep?  Problems at home or at work?
4975,2632,20,47,197,264,1.3295454545454546,0.03763242268906966,651,Just relax and let him take your blood pressure.
7941,2632,20,47,197,264,1.3295454545454546,0.03763242268906966,651,I don't know what's causing your shortness of breath. All your blood test results look fine.
1073,2636,14,58,189,261,1.3295019157088122,0.03552951626354677,651,"Eugene, I think we can rule out cancer."
2789,2637,20,45,193,258,1.3294573643410852,0.038247299394118264,651,"Aside from the tightness in your chest, are you experiencing any other symptoms?"
4212,2637,11,63,184,258,1.3294573643410852,0.0345164781745163,651,I think you should probably see a vet.
6073,2637,19,47,192,258,1.3294573643410852,0.03785092770493569,651,I think I know what's causing your shortness of breath.
1799,2640,14,56,185,255,1.3294117647058823,0.036082995730636204,651,Has he shown signs of discomfort?
2190,2640,20,44,191,255,1.3294117647058823,0.03856492628897821,651,Would you say you feel.. mmh.. constricted?
7844,2640,20,44,191,255,1.3294117647058823,0.03856492628897821,651,"Your cholesterol is high, but it won't kill you."
1870,2640,22,40,193,255,1.3294117647058823,0.03935747103071274,651,"Yep, it's herpes."
6296,2644,18,47,187,252,1.3293650793650793,0.03806792350088918,651,You say you first used it as a small scarf and then it grew on you?
3234,2644,20,43,189,252,1.3293650793650793,0.03888966323759257,651,That feeling of a constriction and shortness of breath can be a false indicator.  Let's get you downstairs for an EKG.
3050,2644,17,49,186,252,1.3293650793650793,0.037650328632531836,651,Your insurance says you’re fine.
6339,2644,15,53,184,252,1.3293650793650793,0.03680092579098845,651,"Well
It appears we can rule out
Asthma"
4497,2648,13,56,180,249,1.3293172690763053,0.03621647927612381,651,Good news- your cholesterol is fine.
4850,2648,14,54,181,249,1.3293172690763053,0.03666089178039643,651,Good news! She views the relationship as symbiotic.
5857,2648,20,42,187,249,1.3293172690763053,0.039221762785348356,651,"Just to be safe, let’s order another test."
2542,2651,25,31,190,246,1.329268292682927,0.04160566663901967,651,Next time I strongly suggest a feathered one.
1031,2651,14,53,179,246,1.329268292682927,0.03695953784983499,651,I'm no expert when it comes to relationships. But I think someone's got a crush on you.
1655,2651,15,51,180,246,1.329268292682927,0.03740576751495451,651,"We’re short on time, so I’ll skip the good news/ bad new routine"
1661,2651,17,47,182,246,1.329268292682927,0.03828262600712897,651,This is the homeopathic way to take your blood pressure
7931,2651,12,57,177,246,1.329268292682927,0.03605051216632717,651,It’s not as bad as it looks.
5317,2656,7,66,170,243,1.3292181069958848,0.033920587482377584,651,Sorry to make you wait but I am up to my neck with patients today.
9158,2656,19,42,182,243,1.3292181069958848,0.03948072789846286,651,With chest pain we always have to rule out a heart condition.
6174,2658,17,45,178,240,1.3291666666666666,0.0389443675136903,651,I’d like to prescribe him a muscle relaxer. Any known allergies?
3041,2658,16,47,177,240,1.3291666666666666,0.03849410678993118,651,So you say you've had difficulty breathing recently?
2325,2658,17,45,178,240,1.3291666666666666,0.0389443675136903,651,So where do you feel the tightness?
1617,2658,19,41,180,240,1.3291666666666666,0.039829621740795844,651,I have your diagnosis but it may be difficult to swallow
4915,2662,19,40,178,237,1.3291139240506329,0.040186825450449916,651,Have you tried using a gentle wind instrument?
5900,2662,15,48,174,237,1.3291139240506329,0.03836600209355338,651,"If you’d just taken the apple, none of us would be here."
6045,2662,14,50,173,237,1.3291139240506329,0.037897129322112845,651,I’m prescribing two mice a day.
8809,2662,17,44,176,237,1.3291139240506329,0.03928696384570505,651,So it says here you're feeling constricted?
2681,2662,18,42,177,237,1.3291139240506329,0.03973944179274958,651,I’m not sure why you’re having trouble breathing. Let’s order some tests.
6557,2662,14,50,173,237,1.3291139240506329,0.037897129322112845,651,Can you tell me when the shortness of breath started?
545,2662,14,50,173,237,1.3291139240506329,0.037897129322112845,651,"I'm afraid your insurance company is about to put the squeeze on you too."""
7555,2662,13,52,172,237,1.3291139240506329,0.03742238240774294,651,"Good news, the constriction you're experiencing in your chest is not heart-related"
1234,2662,20,38,179,237,1.3291139240506329,0.04062928310431438,651,I am referring you to Dr. Charmer.
2065,2662,16,46,175,237,1.3291139240506329,0.03882921351802195,651,"Next of Kin? Eve, you say?"
7483,2662,15,48,174,237,1.3291139240506329,0.03836600209355338,651,"Besides that, any allergies?"
5149,2673,13,51,170,234,1.329059829059829,0.03774152942342329,651,"Whether it's your insurance company, or this boa, you're getting squeezed either way."
8148,2673,19,39,176,234,1.329059829059829,0.040552653229038234,651,"I wish I could help you with the boa constrictor, but it looks like your insurance only covers pythons."
8298,2673,15,47,172,234,1.329059829059829,0.03870126514018578,651,"Your blood pressure today
seems slightly elevated."
2680,2673,15,47,172,234,1.329059829059829,0.03870126514018578,651,The good news is that it looks like he already had lunch.
932,2677,16,44,171,231,1.329004329004329,0.03952371984720495,651,I still need you to sign your insurance information form.
3202,2678,18,39,171,228,1.3289473684210527,0.04084114137130732,651,Sorry.  We were out of gowns.
4740,2678,14,47,167,228,1.3289473684210527,0.03890279395953517,651,"Surprisingly, your blood pressure is normal."
7195,2678,18,39,171,228,1.3289473684210527,0.04084114137130732,651,"I wanted your diet to be restrictive, not constrictive."
3837,2681,14,45,163,222,1.3288288288288288,0.039615034184270065,651,I'm going to prescribe you some mice.
6377,2682,18,35,163,216,1.3287037037037037,0.042444176500425194,651,I won't be able to look at that neck of yours unless you take off your boa.
6178,2683,22,46,206,274,1.3284671532846715,0.037365653074493764,651,"OK, I'll order some tests, but I'm not going to ask you how you had the foresight to get undressed before this happened."
270,2684,17,54,197,268,1.328358208955224,0.0360713383480565,651,"Physically, he's fine."
7177,2685,18,51,196,265,1.3283018867924528,0.036740738604439896,651,It says here that you've been experiencing some tightness in your chest.
2792,2686,10,45,143,198,1.3282828282828283,0.040399233165283294,651,"Look, I don't know what you want from me. Your snake is in perfect health."
6703,2687,26,33,200,259,1.3281853281853282,0.0404074173539314,651,"It will be just a few minutes, we’re waiting for PETA to call us back so we don’t injure him."
9135,2687,15,55,189,259,1.3281853281853282,0.03610438324971601,651,I'm writing a referral to a snake oil salesman._
8400,2687,21,43,195,259,1.3281853281853282,0.038511142086061094,651,I put your odds at about one serpent.
7095,2690,20,44,192,256,1.328125,0.0384355321909808,651,Looks like you caught something during your recent trip to the Amazon Rain Forest
174,2690,13,58,185,256,1.328125,0.03553631031058509,651,Effects may include shortness of breath.
7032,2690,16,52,188,256,1.328125,0.03680680800064138,651,It's working. You've lost 17 pounds !
595,2693,16,51,186,253,1.3280632411067195,0.03710345705345388,651,Can you be more specific about the shortness of breath?
3621,2693,14,55,184,253,1.3280632411067195,0.03624813556782639,651,When did you notice you were having trouble breathing?
4733,2693,12,59,182,253,1.3280632411067195,0.035372137890853375,651,Anything beyond the sudden chest tightness?
823,2696,15,52,183,250,1.328,0.036974755308459874,651,I'm pretty sure your insurance won't cover this.
3759,2696,16,50,184,250,1.328,0.03740669785181133,651,So you are feeling some tightness in your chest?
7512,2696,13,56,181,250,1.328,0.03609536676649833,651,Scaly skin is just the symptom of a much larger issue.
3151,2699,15,51,181,247,1.3279352226720649,0.037277862514703886,651,I'm just your Primary you'll need a Specialist for this.
4081,2699,16,49,182,247,1.3279352226720649,0.03771676474162835,651,"It isn’t actually venomous, so you should be fine."
4004,2699,20,41,186,247,1.3279352226720649,0.03942354091423087,651,The Full Monty Python
1500,2702,24,32,188,244,1.3278688524590163,0.041429804758304746,651,The cost for the procedure includes a wallet for you to take home if you like.
561,2702,16,48,180,244,1.3278688524590163,0.0380339034932989,651,The ankle rash should clear up in a week or so.
8152,2702,13,54,177,244,1.3278688524590163,0.03667947279708974,651,"Other than feeling short of breath, anything else you've noticed?"
8420,2702,12,56,176,244,1.3278688524590163,0.03621674144992529,651,I recommend you see this veterinarian for a second opinion.
5815,2706,21,37,183,241,1.3278008298755186,0.04054941967985905,651,And has Jane done this to you before?
8800,2706,15,49,177,241,1.3278008298755186,0.03790496744102665,651,I'm going to need you to completely shed.
4318,2708,18,42,178,238,1.3277310924369747,0.039596270958160665,651,Does it interfere with your sleep?
6036,2708,22,34,182,238,1.3277310924369747,0.041348440807897374,651,"Let me get this straight, you wanted to have a snake skin jacket but you are a member of PETA."
7105,2708,17,44,177,238,1.3277310924369747,0.03914597620355187,651,When did you first feel constricted ?
1277,2708,15,48,175,238,1.3277310924369747,0.03822947830147558,651,just how did you wind up around this guy?
1743,2708,10,58,170,238,1.3277310924369747,0.03583583272212114,651,"""Next we'll try a comfort gecko."""
5410,2708,16,46,176,238,1.3277310924369747,0.038690441094229214,651,"Most importantly, you shouldn't have tread on him."
8107,2708,17,44,177,238,1.3277310924369747,0.03914597620355187,651,Okay.  We are done here.  You can get dressed now.
7441,2715,12,53,170,235,1.327659574468085,0.037119950938823004,651,"So, are you having trouble sleeping?"
7210,2715,16,45,174,235,1.327659574468085,0.039030395261199356,651,"If this doesn’t work, we’ll try the oil."
2824,2715,20,37,178,235,1.327659574468085,0.04085159422581057,651,You noted that you have been feeling a little constricted near your heart.  Can you elaborate?
3089,2715,17,43,175,235,1.327659574468085,0.03949356913956575,651,And how long have you had this rattle?
8494,2719,16,44,172,232,1.3275862068965518,0.039378533631336324,651,We can deal with the tightness in your chest but separation anxiety will be a separate issue
4024,2719,14,48,170,232,1.3275862068965518,0.038419147638668376,651,That's not what I meant by a restrictive diet.
362,2719,14,48,170,232,1.3275862068965518,0.038419147638668376,651,"Other than the tightness, any other irregulatities?"
5183,2719,14,48,170,232,1.3275862068965518,0.038419147638668376,651,"Don't worry Mr. Johnson, the snake is going to be fine."
6661,2723,20,35,174,229,1.3275109170305677,0.0416185690116326,651,The results are in and you probably know this already but you've got snake
4014,2724,19,35,169,223,1.3273542600896862,0.04194575196386713,651,"So, you think you may have contracted this on a plane?"""
1131,2725,15,42,163,220,1.3272727272727274,0.04034830804054124,651,Thought so: compression fracture.
5295,2726,22,45,205,272,1.3272058823529411,0.037539986002083595,651,"If you want to fly, you'll  have to get a different support animal."
6440,2727,16,39,162,217,1.327188940092166,0.04125360676496401,651,"On the bright side, we were able to retrieve your wedding ring."
7397,2728,19,49,198,266,1.3270676691729324,0.037008492233584,651,At least it's not an invasive species.
6434,2728,19,49,198,266,1.3270676691729324,0.037008492233584,651,I'm prescribing a feather boa instead.
2623,2730,21,43,196,260,1.3269230769230769,0.038383496706874756,651,Have you noticed any other problems besides feeling constricted?
9042,2730,17,51,192,260,1.3269230769230769,0.03680343327254329,651,I think it's time we addressed your blood pressure issue.
1648,2730,14,57,189,260,1.3269230769230769,0.03557235740777461,651,I usually specialize in internal medicine...
6806,2733,16,52,189,257,1.3268482490272373,0.03668553496718497,651,It might take a couple hours for the muscle relaxant to take effect.
7387,2733,15,54,188,257,1.3268482490272373,0.036268852244642734,651,"Actually, you're my third exotic animal selfie case this week."
6252,2733,15,54,188,257,1.3268482490272373,0.036268852244642734,651,"With these prescriptions, the hissing that you’re hearing should stop."
5184,2733,15,54,188,257,1.3268482490272373,0.036268852244642734,651,It looks healthy to me.
5160,2737,16,51,187,254,1.3267716535433072,0.03697965426895335,651,Love your boa!”
6380,2738,21,40,190,251,1.3266932270916334,0.03935964632742142,651,"I'm scheduling a hearing test. I said compression socks, not constrictor snake."
8124,2738,14,54,183,251,1.3266932270916334,0.036415301581870535,651,We had so many complaints about the paper gowns that open in the back that we decided to try this.
1811,2740,18,45,185,248,1.3266129032258065,0.03844646127531532,651,"I would have suggested Mira-Lax, 
but I'm sure your shaman knows best."
5838,2740,14,53,181,248,1.3266129032258065,0.03670873102018125,651,You're in luck. My Veterinarian's license doesn't expire until next week.
943,2740,18,45,185,248,1.3266129032258065,0.03844646127531532,651,"Well, we've ruled out anything you've eaten"
1636,2740,15,51,182,248,1.3266129032258065,0.03715078459444151,651,"With your lack of insurance Mr. Smith, I’m unable to remove the snake; however I can send you home with some mice"
8755,2744,13,54,178,245,1.3265306122448979,0.036553958571679895,651,Take 3 rats and call me in the morning
2961,2744,15,50,180,245,1.3265306122448979,0.03745802848477228,651,Weight gain around the middle is the most dangerous.
1549,2746,17,45,180,242,1.3264462809917354,0.03866952086500997,651,You seem to have high blood pressure
4470,2746,21,37,184,242,1.3264462809917354,0.04040422442205749,651,"It's anybody's guess why you came to a vet, but if I have to sacrifice you to save the snake, that's all she wrote."
5609,2746,17,45,180,242,1.3264462809917354,0.03866952086500997,651,"Next time,I recommend just taking the apple."
8097,2746,14,51,177,242,1.3264462809917354,0.03731560951553026,651,Systolic is a little high. Have you been under a lot of stress lately?
3768,2750,15,48,176,239,1.3263598326359833,0.03809387480429697,651,"Difficulty breathing? Okay, any other symptoms?"
124,2750,14,50,175,239,1.3263598326359833,0.037629546766971826,651,"These pills will relax him, but unfortunately he's not covered on your plan."
885,2750,17,44,178,239,1.3263598326359833,0.0390059522770681,651,How would you rate the feeling of tightness... on a scale of one to ten?
1191,2750,16,46,177,239,1.3263598326359833,0.03855261087557084,651,It's one of the occupational hazards of being a snake oil salesman.
2046,2750,15,48,176,239,1.3263598326359833,0.03809387480429697,651,Tightness..in..the...chest. OK. Any changes to your diet or exercise?
924,2755,17,59,209,285,1.3263157894736841,0.03455614133000551,651,Can you be more specific than just a squeezing sensation?
7035,2756,17,43,176,236,1.326271186440678,0.03935036813201722,651,I checked the computer. The results are negative. You are good to go.
5331,2756,19,39,178,236,1.326271186440678,0.04025637248308739,651,So you say something you disagreed with is about to eat you?
9058,2756,20,37,179,236,1.326271186440678,0.04070181264001611,651,"Just as I expected,  the lab results show you're  wound too tight."
6898,2756,12,53,171,236,1.326271186440678,0.03698839464880542,651,The test results hint at a possible cause of your chest tightness.
604,2756,14,49,173,236,1.326271186440678,0.03795082860844513,651,When did you first notice this sensation of tightness in your chest?
339,2756,12,53,171,236,1.326271186440678,0.03698839464880542,651,The therapy boa thing doesn't seem to be working.
2486,2756,16,45,175,236,1.326271186440678,0.038889451596022494,651,I'll step out for a moment while you undress. Just put on that gown there.
1306,2763,11,54,168,233,1.3261802575107295,0.036801383148396136,651,I'm afraid you have a pretty serious boa obstruction.
8944,2763,16,44,173,233,1.3261802575107295,0.03923436174929836,651,"You're fine, but Freddy appears to have separation anxiety"
2435,2765,13,49,168,230,1.326086956521739,0.03812171564027608,651,"Mr. Cecil, I’m not Dr. Dolittle. I’m your primary care physician."
4771,2765,20,35,175,230,1.326086956521739,0.0414616830942265,651,"Next time the snake says don't eat the apple, I'd suggest listening."
6134,2765,15,45,170,230,1.326086956521739,0.03910511173528247,651,"No, COBRA doesn't cover boa removal."
6394,2765,12,51,167,230,1.326086956521739,0.03762037909328722,651,"So, this all started with needing a hug."
4791,2769,15,44,168,227,1.3259911894273129,0.0394587004970756,651,Perhaps a less clinging support animal would be applicable.
8129,2769,17,40,170,227,1.3259911894273129,0.04043462272256739,651,This should get rid of that frog in your throat.
9048,2771,13,47,164,224,1.3258928571428572,0.03880260100486025,651,"Don't worry, I am pretty sure your chest pains are not heart related."
4112,2771,9,55,160,224,1.3258928571428572,0.036680895533570165,651,"I'll just stand over here, if you don't mind."
1269,2771,13,47,164,224,1.3258928571428572,0.03880260100486025,651,I'll be back to talk once my assistant finishes with your blood pressure.
5204,2774,16,55,196,267,1.3258426966292134,0.03572658394750885,651,I still can't believe Samuel Jackson slept through your entire flight.
3709,2775,13,46,162,221,1.3257918552036199,0.039155783336340275,651,"Good news, the tests were all negative."
1578,2776,18,50,196,264,1.3257575757575757,0.03679163475128673,651,This treatment gets you used to dealing with health insurance...
7424,2776,16,54,194,264,1.3257575757575757,0.03600019533144327,651,Your therapy python seems to have turned on you.
6814,2778,17,37,164,218,1.3256880733944953,0.0416026106387596,651,I suggest an elimination diet. Let’s start with Apples.
427,2779,17,51,193,261,1.3256704980842913,0.03668354399431489,651,"So Monty, what has you rattled today?"
7014,2779,16,53,192,261,1.3256704980842913,0.036279608001152513,651,So this   helps  with the constipation  problem?
7553,2781,19,32,164,215,1.3255813953488371,0.04303456209339583,651,This is the New Cervical Collar -- Just don't forget to feed it.
1096,2781,18,48,192,258,1.3255813953488371,0.03738083708033754,651,"Mr Boa, I’ll give the guy a muscle relaxant so he goes down easier."
7825,2783,18,47,190,255,1.3254901960784313,0.03768512305537536,651,I'm afraid you have the Full Python
7259,2783,21,41,193,255,1.3254901960784313,0.03889478087208346,651,"Mr. Python, I am afraid we will have to remove your Monty"
6520,2783,18,47,190,255,1.3254901960784313,0.03768512305537536,651,So you feel a tightening in your chest?  Any other symptoms?
7913,2783,16,51,188,255,1.3254901960784313,0.036856634591884714,651,So your chest has been constricted since Saturday?
1729,2783,17,49,189,255,1.3254901960784313,0.037273180794899274,651,We're going to have to run a few more tests.
6891,2788,16,50,186,252,1.3253968253968254,0.037154670707582986,651,I might be able to squeeze you in on Thursday.
6047,2788,16,50,186,252,1.3253968253968254,0.037154670707582986,651,"So, describe what you’re feeling right now."
5964,2790,13,42,154,209,1.325358851674641,0.04066173683263105,651,It says here you’re experiencing a tightness in your chest.
2217,2791,19,43,187,249,1.3253012048192772,0.038734558459732726,651,And when did the chest pains start?
6318,2791,14,53,182,249,1.3253012048192772,0.03658453148791558,651,"I cant really examine you unless you're willing to take off everything, Mr. Johnson."
7214,2791,16,49,184,249,1.3253012048192772,0.037459353626862715,651,"Congratulations, it says 120 over 80."
521,2794,20,40,186,246,1.3252032520325203,0.03948896631823461,651,It says here you identify as a rabbit
84,2795,17,45,181,243,1.3251028806584362,0.03853348297792742,651,"No, I don't think its asthma."
1283,2795,15,49,179,243,1.3251028806584362,0.037640523911998756,651,It's PETA I'm most worried about.
2630,2795,14,51,178,243,1.3251028806584362,0.03718600415948874,651,Good news! The tests show he's non-venomous.
5873,2795,16,47,180,243,1.3251028806584362,0.03808962031039409,651,"As a vet, I assure you your snake is fine."
7985,2795,14,51,178,243,1.3251028806584362,0.03718600415948874,651,"How long have you been, as you say, feeling tight in the chest?"
4718,2800,17,44,179,240,1.325,0.03886688292831647,651,"And your ex-spouse's name is Eve, correct?"
2428,2800,18,42,180,240,1.325,0.03931287438041397,651,Why did you come to the podiatrist?
752,2800,18,42,180,240,1.325,0.03931287438041397,651,OK Garden of Eden.  Are you married Adam?
4899,2803,11,55,171,237,1.3248945147679325,0.036369401442361435,651,I think I can squeeze you in.
611,2804,14,48,172,234,1.3247863247863247,0.03814127160267242,651,"This will get you a muscle relaxer for the snake.
You'll have to get someone with hands to administer it."
2295,2804,12,52,170,234,1.3247863247863247,0.03716707843289532,651,"Don’t worry, it’s not poisonous."
2793,2804,14,48,172,234,1.3247863247863247,0.03814127160267242,651,Why don’t you take your snake off and we’ll start the exam?
3991,2804,20,36,178,234,1.3247863247863247,0.04092494642836231,651,"I have no issues with cross dressing, but I think you wanted a feathered boa."
6458,2804,16,44,174,234,1.3247863247863247,0.039091194401049696,651,"By any chance, do you have a wife named Eve?"
387,2809,17,41,173,231,1.3246753246753247,0.03991553067080991,651,"Ah yes, I see we have you scheduled for your hissterectomy."
5152,2809,18,39,174,231,1.3246753246753247,0.04038431755814072,651,"I'm going to refer you to one of my peers, St Patrick"
7919,2809,17,41,173,231,1.3246753246753247,0.03991553067080991,651,"I said calorie restriction Keith,not boa constriction."
8337,2809,14,47,170,231,1.3246753246753247,0.03847491443810123,651,"Ereptile dysfunction is a psychological, not medical, condition."
4661,2813,13,61,194,268,1.3246268656716418,0.03441644004036976,651,"No, no, it’s not poisonous, so just be patient and it will  fall off on its own at some point."
7644,2813,17,53,198,268,1.3246268656716418,0.0360040538394644,651,It says here it's the third time this year.
8962,2815,18,38,172,228,1.3245614035087718,0.04075909864117385,651,Are you feeding him enough?
3596,2816,15,43,167,225,1.3244444444444445,0.03967015679812731,651,and any shortness of breath?
7533,2816,13,47,165,225,1.3244444444444445,0.03865690444180609,651,"Well, we can rule out a heart attack."
4064,2816,14,45,166,225,1.3244444444444445,0.0391668073846397,651,"So ..shortness of breath and tightness in your chest, I'm going to recommend you get an EKG."
8572,2816,11,51,163,225,1.3244444444444445,0.037616368533629714,651,So how was your trip to the Amazon?
5704,2820,15,55,192,262,1.3244274809160306,0.03575556154454193,651,Any  constrictions?
599,2820,17,51,194,262,1.3244274809160306,0.036564396712249106,651,"The good news is that when he sheds his skin, he will loosen up a little."
1821,2820,19,47,196,262,1.3244274809160306,0.0373557228881458,651,Could you be more specific than “ tightness in the chest”
1772,2820,17,51,194,262,1.3244274809160306,0.036564396712249106,651,"On a scale of 1-10, 10 being the worst constriction of your life, how would you rate your constriction?"
4422,2824,14,56,189,259,1.3243243243243243,0.03561454743075765,651,I can find nothing physically wrong with Ivan. What we have here is a severe case of separation anxiety.
7049,2824,8,56,158,222,1.3243243243243243,0.03630003982945142,651,"Aside from being a little short-winded, how do you feel?"
2830,2826,17,49,190,256,1.32421875,0.03714906127378301,651,It appears her separation anxiety has worsened.
4109,2826,17,49,190,256,1.32421875,0.03714906127378301,651,"It’s a bit hard to swallow, isn’t it."
7349,2828,10,51,158,219,1.3242009132420092,0.037735127212269196,651,The good news is that he does seem fond of you...
7994,2828,18,35,166,219,1.3242009132420092,0.041941322201101014,651,"You're fine, but your friend needs a colonoscopy."
8284,2828,11,49,159,219,1.3242009132420092,0.03828618107107893,651,"I wasn’t able to listen to your lungs, but you show signs of constricted breathing."
3798,2831,14,54,185,253,1.3241106719367588,0.03617280401252289,651,Says here that you are experiencing some tightness in your chest.
7609,2831,20,42,191,253,1.3241106719367588,0.038687069282259144,651,When did you first notice the tightening in your chest?
5917,2831,17,48,188,253,1.3241106719367588,0.037451041906592604,651,"I'm writing you a prescription for 10 mice, twice per day. 
If it doesn't clear up in two weeks, we'll up the dose."
2638,2831,19,44,190,253,1.3241106719367588,0.03827949494263647,651,"There's no good way to tell you this, but Mr. Slithers has developed a heart murmur."
3269,2831,15,52,186,253,1.3241106719367588,0.03660384333257069,651,I've prescribed a new muscle relaxant for you
4118,2831,17,48,188,253,1.3241106719367588,0.037451041906592604,651,I don't think this was the boa you were supposed to wear.
7570,2837,13,44,159,216,1.3240740740740742,0.03973285436614495,651,I think I can explain that feeling of tightness in your chest.
3068,2838,19,43,188,250,1.324,0.03860124641639953,651,Blink once if your experiencing any shortness of breath.
2989,2838,18,45,187,250,1.324,0.038182819576916695,651,Describe the severity on a scale of one to ten.
2675,2840,15,50,182,247,1.3238866396761133,0.03720092523294113,651,"First and foremost Mr. Hanover, do not completely exhale"
7355,2840,19,42,186,247,1.3238866396761133,0.038930323320357514,651,That constriction can probably be eased with a mouse or two.
7775,2840,18,44,185,247,1.3238866396761133,0.0385052563284209,651,"It's just a hissy fit, nothing to worry about."
1860,2843,16,47,181,244,1.3237704918032787,0.037956586714262365,651,"I don't know what the problem is, your labs look fine."
3348,2843,15,49,180,244,1.3237704918032787,0.03750961358872694,651,We're seeing a lot of this going around.
627,2845,8,51,148,207,1.3236714975845412,0.03791936675215919,651,"Frankly, I don't think he likes it one bit either."
1971,2846,17,44,180,241,1.3236514522821576,0.03872875911882118,651,"Yes, tightness in the chest can be an indicator of a heart attack, but I'd like to run some tests first."
6309,2846,20,38,183,241,1.3236514522821576,0.0400456142756944,651,Maybe you shouldn't have felt so entitled to the apple.
6431,2846,17,44,180,241,1.3236514522821576,0.03872875911882118,651,Let's wait for your blood test results before we conclude what the problem might be .
8709,2846,16,46,179,241,1.3236514522821576,0.03827974185221646,651,"Trouble breathing, you say?"
8776,2846,19,40,182,241,1.3236514522821576,0.039611527061025525,651,I'm afraid we don't have time to address your erectile dysfunction at this visit.
4141,2851,14,49,175,238,1.3235294117647058,0.037680938465978676,651,So it says here you've been feeling tightness in your chest.  Any idea what could be causing it?
6233,2851,12,53,173,238,1.3235294117647058,0.03672790059274848,651,"Yes, I wrote the emotional support animal letter for the peacock lady."
6361,2853,18,51,200,269,1.3234200743494424,0.036274684140275563,651,When did you first notice this?
5683,2854,16,44,175,235,1.323404255319149,0.038949021894314845,651,"No, it’s a phone number for an agent of novelty acts."
5284,2855,17,52,197,266,1.3233082706766917,0.036165217401031145,651,Any family history of reptile codependency?
7647,2856,14,47,171,232,1.3232758620689655,0.03833426881476336,651,"No, not COBRA. Do you by chance have a PYTHON plan?"
2764,2856,15,45,172,232,1.3232758620689655,0.038817974810631,651,"Now, about this squeezing sensation you're feeling in your chest. Could you be a bit more descriptive?"
8745,2856,13,49,170,232,1.3232758620689655,0.03784438086065478,651,"So, other than a tightening in your chest, what other symptoms are you experiencing?"
1687,2859,17,51,195,263,1.3231939163498099,0.03644598509413213,651,"The police report says it was an amphibious assault, but actually it's a reptile."
6978,2860,10,54,165,229,1.3231441048034935,0.036638240788163315,651,Nothing serious - just a mild case of the grippe.
5468,2860,14,46,169,229,1.3231441048034935,0.038672757461851115,651,And exactly when did you lose feeling in your arms?
5825,2860,21,32,176,229,1.3231441048034935,0.041996663707890944,651,We have a guest performing your colonoscopy today.
1936,2860,15,44,170,229,1.3231441048034935,0.039164876357727633,651,"So, it says here you've had a tightening feeling in your chest and shortness of breath.  We'll do an EKG today and I'd like you to come back next week for a stress test."
631,2864,16,52,192,260,1.323076923076923,0.036326232473916316,651,"So, how long have you had this human invading your private space?"
9071,2865,9,55,162,226,1.323008849557522,0.036412461259187574,651,She’s never gotten so attached to a patient!
7266,2865,18,37,171,226,1.323008849557522,0.040985968767820916,651,"Don't you think that its finally time to admit that you've taken this  entire ""Don't Tread on Me"" thing just a bit too far?"
8215,2867,14,55,188,257,1.3229571984435797,0.03577300738901003,651,I’ ll check your blood pressure after you’ve unwound a bit
2673,2867,20,43,194,257,1.3229571984435797,0.03823743000991457,651,Is this a preexisting condition?
8498,2867,15,53,189,257,1.3229571984435797,0.036195398745406726,651,"So, I see in the notes you really don’t like getting your prostate checked..."
3766,2867,17,49,191,257,1.3229571984435797,0.03702572829410167,651,First we'll run an expensive battery of tests to see if we can pin point that tightness in your chest you're experiencing.
4143,2871,19,34,170,223,1.3228699551569507,0.041861447499424234,651,Your theatrics for painkillers are starting to get out of hand.
1489,2872,20,42,192,254,1.3228346456692914,0.03855557829074814,651,"'Tightness in the neck, other than that, all good?"""
1241,2873,14,43,163,220,1.3227272727272728,0.03973928202983353,651,He gives much more detailed results than our CAT scan.
9206,2874,15,51,185,251,1.3227091633466135,0.03677444066681857,651,Yes eventually we will get to the exam but history is the key to diagnosis...is it a stabbing pain or more of a tight squeezing sensation?
4681,2874,18,45,188,251,1.3227091633466135,0.038052293179752485,651,You were right to come in
3760,2874,22,37,192,251,1.3227091633466135,0.03969215358327732,651,Any pain or discomfort?
5086,2874,12,57,182,251,1.3227091633466135,0.035450556504473686,651,I'm worried about those feet of yours.   They may not be getting proper blood circulation.
309,2874,18,45,188,251,1.3227091633466135,0.038052293179752485,651,"Yes, it counts as a pre-existing condition. It takes months to digest someone your size."
1514,2874,16,49,186,251,1.3227091633466135,0.03720526839464431,651,"He’s doing fine Mr. Blum, but next time you might want to bring him in a pet carrier."
7031,2880,21,49,212,282,1.322695035460993,0.03616387768170304,651,It says here you've been having difficulty breathing.
3361,2881,14,52,182,248,1.3225806451612903,0.036630643481139924,651,"OK. So, first date, and you thought she said ""Pie-A-Thon""..."
4173,2881,17,46,185,248,1.3225806451612903,0.0379440855793641,651,"I'm sorry, I can't examine you until you take off that snake."
6331,2881,17,46,185,248,1.3225806451612903,0.0379440855793641,651,"Now, about that hissing sound that you keep hearing..."
6675,2881,17,36,164,217,1.3225806451612903,0.041678020685167703,651,"No pets in the exam room, sir."
7316,2885,17,55,204,276,1.3224637681159421,0.035248174274602785,651,Some muscle relaxant should help it unwind
8040,2886,8,63,174,245,1.3224489795918368,0.034103372123120486,651,"Take aspirin, drink plenty of fluids, get some rest, and call a herpetologist if there's no improvement."
5034,2886,14,51,180,245,1.3224489795918368,0.03692933823243786,651,It's just a temporary crush.
7096,2886,15,49,181,245,1.3224489795918368,0.03737956698035382,651,"Personally, I'd rethink this whole therapy snake thing."
2045,2889,17,35,162,214,1.3224299065420562,0.04209018746296774,651,You're welcome to a second opinion but I'm fairly certain that Buttercup's symptoms are showing all the signs of separation anxiety.
8970,2890,23,42,208,273,1.3223443223443223,0.03771685478546179,651,"So, it looks like ""Python for Dummies"" didn't work out so well."
406,2891,14,50,178,242,1.322314049586777,0.03723482633193371,651,What can I help you with today?
5288,2892,15,38,158,211,1.3222748815165877,0.04143807066240893,651,"As your medical doctor my advice is that we tell the HMO this as an emotional support animal and monitor the co-pay closely."""
678,2893,22,43,205,270,1.3222222222222222,0.03765219547558206,651,"You think you're squeezed now, wait until you get my bill."
8112,2894,10,57,172,239,1.3221757322175731,0.035625298946458786,651,I prescribe a small dog.
7845,2894,19,39,181,239,1.3221757322175731,0.039819674715950916,651,So the only thing that brings you in today is a cold?
3357,2894,9,59,171,239,1.3221757322175731,0.035128356313764895,651,"So, describe your symptoms."
2292,2894,17,43,179,239,1.3221757322175731,0.038926667967457446,651,I think you might feel less constricted with a feather boa.
8495,2898,13,50,173,236,1.3220338983050848,0.03738799205188854,651,Gobble two mice and call me in the morning
4919,2898,18,40,178,236,1.3220338983050848,0.03972621405447011,651,"Yes, it's been going around a lot."
6827,2898,17,42,177,236,1.3220338983050848,0.03926970914605402,651,Well can you blame him?  You hurt his feelings when you called Trump a snake.
6531,2898,11,54,171,236,1.3220338983050848,0.036410683820827655,651,"As soon as we get that co-pay cleared up, I can deal with your first concern."
6109,2898,22,32,182,236,1.3220338983050848,0.04150205042940864,651,You passed your stress test.
7085,2898,15,46,175,236,1.3220338983050848,0.03834039649043655,651,Your blood pressure is a bit high... are you experiencing undo stress?
3568,2898,16,44,176,236,1.3220338983050848,0.038807834643661575,651,Visited any tropical countries recently?
2964,2898,16,44,176,236,1.3220338983050848,0.038807834643661575,651,I recommend you stick to a diet of the smaller mammals.
2688,2898,12,52,172,236,1.3220338983050848,0.03690257339246385,651,"In the past thirty days, have you traveled to Brazil?"
1611,2898,18,40,178,236,1.3220338983050848,0.03972621405447011,651,When you were told you would look good in a boa. . .
5014,2898,15,46,175,236,1.3220338983050848,0.03834039649043655,651,How is the Pet Therapy working for you?
4619,2909,12,51,170,233,1.3218884120171674,0.03721330372927268,651,"Ordinarily, crushing chest pain and difficulty breathing would indicate a heart problem..."
8144,2909,21,33,179,233,1.3218884120171674,0.04144656785402927,651,I'm sure the casting director didn't think she'd need to specify 'feather' boa.
3563,2909,15,45,173,233,1.3218884120171674,0.03867590953799214,651,"So, Mr. Hanna, what would you like to discuss with me today? '"
2030,2909,13,49,171,233,1.3218884120171674,0.037707143122955505,651,"Your blood pressure's still too high, so we're going to run a few more tests."
8500,2913,17,50,194,261,1.3218390804597702,0.03661267571496013,651,And don’t take any more apples from this thing.
8846,2913,15,54,192,261,1.3218390804597702,0.03579864713194813,651,One of you have separation anxiety.
5213,2915,17,40,173,230,1.3217391304347825,0.039980844176191875,651,Giving a snake an apple has always been a bad idea.
5427,2915,16,42,172,230,1.3217391304347825,0.03950310900176728,651,Were you sorted into Slytherin?
6224,2915,17,40,173,230,1.3217391304347825,0.039980844176191875,651,So you say this happened shortly after you ate an apple.
8260,2915,11,52,167,230,1.3217391304347825,0.037022077462351664,651,I'm afraid that's not covered.
3158,2919,12,59,187,258,1.321705426356589,0.034799833446047375,651,I'm still going to need you to fully disssssrobe.
4099,2920,14,45,168,227,1.3215859030837005,0.03887331521220064,651,We haven't seen a case of the grippe this bad in quite some time.
7206,2920,22,29,176,227,1.3215859030837005,0.04269676000331762,651,"Hard to breathe, tightness in the chest, sounds like you might have a slight cold."
1927,2922,17,48,190,255,1.3215686274509804,0.03720001156885384,651,"Candidly, the bill is probably going to squeeze you more than this snake."
7209,2922,15,52,188,255,1.3215686274509804,0.03636047131795446,651,"Adderall is the name of the drug,not the dosage."
1706,2922,19,44,192,255,1.3215686274509804,0.038021018489539836,651,I can see that there is clearly an attachment issue here.
3892,2922,18,46,191,255,1.3215686274509804,0.03761275520155888,651,Let me clarify what I meant by Hug Therapy.
5621,2926,15,51,186,252,1.3214285714285714,0.03665059877029879,651,"Your insurance insists it’s a preconstrictor condition, so they won’t cover it."
4942,2926,14,44,166,224,1.3214285714285714,0.03922524610856946,651,My wife wears a boa...
4334,2926,14,44,166,224,1.3214285714285714,0.03922524610856946,651,Your insurance still doesn't recognize him as a dependent.
870,2926,13,46,165,224,1.3214285714285714,0.03871151631463717,651,And when did you first notice the python?
987,2926,15,51,186,252,1.3214285714285714,0.03665059877029879,651,Now please give me your comfort animal... and put on your examination gown.
977,2926,17,47,188,252,1.3214285714285714,0.03750340647574878,651,So how long have you two been together?
3070,2926,19,43,190,252,1.3214285714285714,0.03833724826261066,651,"On the plus side, nobody will notice that nasty psoriasis anymore."
4213,2933,15,50,184,249,1.321285140562249,0.03694715748849689,651,Let's start by testing your knee reflexes.
3478,2933,16,48,185,249,1.321285140562249,0.037382884605870435,651,We usually treat it with snake oil....
7081,2933,17,46,186,249,1.321285140562249,0.03781359116021458,651,Have you tried Viagra?
5,2933,15,50,184,249,1.321285140562249,0.03694715748849689,651,You need to take a vacation and unwind.
3737,2933,13,54,182,249,1.321285140562249,0.03605991148807392,651,I'm afraid you'll need to be on a constricted diet for awhile.
6140,2938,11,49,161,221,1.3212669683257918,0.03799533552118086,651,You'll feel a little pressure
6803,2938,16,39,166,221,1.3212669683257918,0.04061184799577605,651,Besides a shortness of breath and feeling a tightness in the chest do you have any other concerns?
799,2940,16,47,183,246,1.3211382113821137,0.03769316299101225,651,"The good news is, we've almost ruled out a heart attack."
6150,2940,14,51,181,246,1.3211382113821137,0.036802262507190146,651,Many folks find that dogs provide great emotional support.
7202,2940,12,55,179,246,1.3211382113821137,0.035889253475507844,651,"Apart from your recent high blood pressure, I don’t see any other health issues."
4372,2943,17,36,165,218,1.3211009174311927,0.041512777501522755,651,And how long have you had this tightness in your chest?
4978,2944,17,53,201,271,1.3210332103321034,0.035664701026235854,651,That's nothing.  The last patient came in here with a giraffe stuck up his ass.
5716,2945,18,42,183,243,1.3209876543209877,0.03889500213504704,651,"Okay, we’ll run a few tests, but most of the time chest pain like this is attributable to heartburn."
8288,2945,20,38,185,243,1.3209876543209877,0.03975979704583244,651,'I see Eve has joined #MeToo'
7496,2945,16,46,181,243,1.3209876543209877,0.038010536973908195,651,Any family history of constriction?
2120,2945,17,44,182,243,1.3209876543209877,0.038455312455694314,651,Would you describe the chest pain as similar to an elephant sitting on your chest?
1742,2945,14,50,179,243,1.3209876543209877,0.03710499496030649,651,When did you realize that your snake skin jacket was alive?
5576,2945,17,44,182,243,1.3209876543209877,0.038455312455694314,651,Do you have any pre existing conditions?
1268,2951,10,66,192,268,1.3208955223880596,0.03310116440980028,651,"Yeah, there's a lot of this going around."
2359,2952,13,51,176,240,1.3208333333333333,0.03694577270641409,651,I don't even need google for this one.
1195,2952,16,45,179,240,1.3208333333333333,0.038335266157081306,651,So Eve's not so happy with Eden?
2327,2952,11,55,174,240,1.3208333333333333,0.035989652872742625,651,"""I don't normally fill out a patient's paperwork for them, but I guess I have to make an exception in your case."""
5986,2952,18,41,181,240,1.3208333333333333,0.03923426612424099,651,Well... after several tests I’m afraid that you have a human growing out of your ass.
6420,2952,7,63,170,240,1.3208333333333333,0.033996839558310565,651,Call me in two weeks if things don't loosen up.
8753,2952,18,41,181,240,1.3208333333333333,0.03923426612424099,651,"Well, Adam from Eden ... tell me how this all started."
8976,2958,17,42,178,237,1.3206751054852321,0.039127263990330195,651,"Your labs all came back normal, but your blood pressure appears quite elevated."
7691,2959,15,45,174,234,1.3205128205128205,0.03853483350364872,651,"So this constricting feeling, is it continual or intermittent?"
2288,2959,17,41,176,234,1.3205128205128205,0.03947528686894829,651,You say your chest feels constricted?
93,2959,11,53,170,234,1.3205128205128205,0.03658146569904303,651,"I see a slight digestive inconvenience in the future, but fortunately it's not your problem."
523,2959,13,49,172,234,1.3205128205128205,0.03757084658245133,651,I suspect it’s a circulation problem.
53,2963,16,51,192,259,1.3204633204633205,0.03637225198086001,651,How long have you been feeling a tightness in your chest?
535,2963,18,47,194,259,1.3204633204633205,0.03718603553937929,651,There’s a thirty dollar copay for an unwinding.
2998,2963,18,47,194,259,1.3204633204633205,0.03718603553937929,651,It will unwrap when you tell him that he's no longer giving you joy.
5472,2963,18,47,194,259,1.3204633204633205,0.03718603553937929,651,"Yes, as a matter of fact, this is my first certification of an emotional support snake."
2311,2967,15,44,172,231,1.3203463203463204,0.03887520083868282,651,Somtimes getting too close to an emotional support animal can be dangerous.
2378,2967,17,40,174,231,1.3203463203463204,0.03983174954802634,651,It's going around . . . and around . . . and around.
3449,2967,13,48,170,231,1.3203463203463204,0.037894514226193145,651,I'm writing you a prescription for snake oil.
8673,2970,18,46,192,256,1.3203125,0.037486593804632734,651,"It's symbiotic. You get a snakeskin coat, and he gets legs."
4140,2970,17,48,191,256,1.3203125,0.037075699051691106,651,I'm going to recommend a herpetologist.
7020,2970,16,50,190,256,1.3203125,0.03666019919844419,651,"Yeah, that 'apple a day' advice doesn't really work."
1581,2973,18,37,173,228,1.3201754385964912,0.040674807059542614,651,"I'm sorry, but as a Pediatrician  I'm only familiar with rattlers"
5307,2973,14,45,169,228,1.3201754385964912,0.03872813549188695,651,The good news is that constricting feeling you have experienced - is probably not a mental condition.
410,2975,16,49,188,253,1.3201581027667983,0.03695444994566819,651,Have you visited any jungles or rain forests in the last three months
6237,2975,17,47,189,253,1.3201581027667983,0.03737647612300929,651,I had to squeeze you in at the last minute.
7975,2975,17,47,189,253,1.3201581027667983,0.03737647612300929,651,"Good try, but the snake we use goes inside of you."
8644,2975,17,47,189,253,1.3201581027667983,0.03737647612300929,651,Animal assisted therapy does have its limits.
7353,2979,25,39,214,278,1.3201438848920863,0.03788200819656135,651,"Congrats on the new yacht, but next time I’d recommend disabling autocorrect before requesting another “boat contractor”."
2280,2980,22,44,209,275,1.32,0.037122798787012565,651,Your blood pressure's fairly high. Any family history of hypertension?
3525,2980,17,46,187,250,1.32,0.03768395310055913,651,"Side effects of this treatment may include sudden chest pains, shortness of breath, cardiac arrhythmia, dizziness or fainting, circulatory irregularities, difficulty in passing stools, excessive sweating, easy bruising, and immediate weight gain."
5448,2980,17,46,187,250,1.32,0.03768395310055913,651,Do you feel safe in your relationship?
8531,2983,17,53,202,272,1.3198529411764706,0.035552935284865854,651,Feeling a bit constricted?
4968,2983,17,53,202,272,1.3198529411764706,0.035552935284865854,651,A little snake oil should clear that right up.
6290,2985,15,49,183,247,1.319838056680162,0.037122033650496926,651,"Have you tried walking it off?"""
2598,2986,13,45,164,222,1.3198198198198199,0.038913537977827616,651,He won't start to constrict if you pay in advance
5499,2986,13,45,164,222,1.3198198198198199,0.038913537977827616,651,"Ignoring the chest constrictions for a moment, are you experiencing any pain in your left arm?"
2984,2986,20,31,171,222,1.3198198198198199,0.042421888978233034,651,"I'm not an asp doctor, I'm a proctologist."
7492,2989,15,48,181,244,1.319672131147541,0.03742936719131971,651,"According to the boa, your blood pressure is a little high."
7895,2989,14,50,180,244,1.319672131147541,0.03697602148583499,651,"Your health is fine, Jack, but you seem a little tightly wound."
5691,2991,17,51,198,266,1.3195488721804511,0.03609510181272619,651,"Under your plan, I can only help you if it's lasted more than four hours."
6937,2991,15,55,196,266,1.3195488721804511,0.035300293726709495,651,I’m going to recommend a really good charmer.
9063,2993,17,43,181,241,1.3195020746887967,0.03864902635322919,651,I believe a trip to the Everglades will take care of it.
6027,2993,13,51,177,241,1.3195020746887967,0.03681622810130389,651,The good news is the EKG shows the tightness in your chest is not a heart problem.
4509,2993,16,45,180,241,1.3195020746887967,0.03819907186622815,651,"‘So, what are you here for?’"
4069,2993,15,47,179,241,1.3195020746887967,0.03774375371938941,651,....are you feeling any other symptoms?
2570,2993,17,43,181,241,1.3195020746887967,0.03864902635322919,651,When would you say you started having shortness of breath?
3834,2993,13,51,177,241,1.3195020746887967,0.03681622810130389,651,Your systolic is off the charts
2901,2999,12,45,159,216,1.3194444444444444,0.03908909337381308,651,Hmm. That little pimple on your nose should be looked at.
2819,3000,18,48,197,263,1.3193916349809887,0.03677156363583339,651,"And, how's your breathing?"
7965,3000,13,58,192,263,1.3193916349809887,0.03474223149337651,651,"You might experience some slight discomfort at first, but this should take care of the snoring."
2953,3002,16,44,178,238,1.319327731092437,0.03852837809745235,651,I see you've met our new collections specialist.
7111,3002,15,46,177,238,1.319327731092437,0.03806545281429366,651,"So, tell me--how long have you been together?"
8581,3004,19,45,196,260,1.3192307692307692,0.03746176075370903,651,"So. . . Shortness of breath, sudden weight gain—how long since your last checkup?"
2737,3004,22,39,199,260,1.3192307692307692,0.03863267539102389,651,"The good news, it's not so much herpes as it is herpetology."""
6723,3004,21,41,198,260,1.3192307692307692,0.03824635378919399,651,The tests are all normal...is there anything else you have concerns about?
485,3007,13,49,173,235,1.3191489361702127,0.03743548242477931,651,I'd suggest one small rodent a day: live is best. Your snake will be fine!
935,3007,17,41,177,235,1.3191489361702127,0.03933060310903949,651,"Well, I think you should have listened to your wife, Eve."
4400,3007,17,41,177,235,1.3191489361702127,0.03933060310903949,651,"OK, so a feeling of tightness in your chest. Any other concerns today?"
4336,3010,20,42,195,257,1.3190661478599222,0.03816621565681773,651,And how would you rate your pain?
9141,3010,15,52,190,257,1.3190661478599222,0.036120158556387796,651,Worst case of ringworm I've ever seen.
5713,3012,16,42,174,232,1.3189655172413792,0.03921069463481772,651,What seems to be your problem??
4542,3013,11,59,184,254,1.3188976377952757,0.03465334298973892,651,The good news is that the growth is benign
8489,3013,17,47,190,254,1.3188976377952757,0.03725036552439724,651,"I think 5 days of anti-boatics will fix you up, Mr. Schmidt."
4515,3015,14,60,202,276,1.318840579710145,0.03403904388159213,651,"Just a few more tests, I think we'll have a handle on what's causing your shortness of breath."
1271,3015,18,30,159,207,1.318840579710145,0.04357196412668148,651,Turns out it actually was a python in your pocket.
1098,3017,18,37,174,229,1.3187772925764192,0.04052092650223752,651,"Usually this tight feeling in your chest could be heart-related, but we’ll need to do some more tests"
4683,3017,17,39,173,229,1.3187772925764192,0.04004547557698377,651,"I understand these visits can be stressful, its good you brought your emotional support animal"
8645,3019,16,48,187,251,1.3187250996015936,0.037128396158529954,651,"Well, the good news is, you don't have COPD."
5044,3019,19,42,190,251,1.3187250996015936,0.03839447005996071,651,Ok.  We need to have a serious conversation about “eREPTILE-dysfunction”
6533,3019,13,54,184,251,1.3187250996015936,0.035817597231308854,651,"Don't worry, it's perfectly normal to feel short of breath in your situation."
4095,3019,13,54,184,251,1.3187250996015936,0.035817597231308854,651,It says you're feeling a bit constricted ?
313,3023,15,42,169,226,1.3185840707964602,0.03943104380296625,651,I'm going to need to refer you to a specialisssssssssssssst.
2545,3023,15,42,169,226,1.3185840707964602,0.03943104380296625,651,"So, I see here that you can't turn and cough."
4041,3023,22,28,176,226,1.3185840707964602,0.04277998109801369,651,"It's a simple case of a constricted bowel.  And after surgery, we can make you a nice set of boots."
2797,3026,17,45,186,248,1.3185483870967742,0.03786680718665893,651,Just when did you start having problems swallowing?
8228,3026,13,53,182,248,1.3185483870967742,0.03610118606125428,651,Have you visited a tropical area?
5211,3026,15,49,184,248,1.3185483870967742,0.03699453149818838,651,....and you mentioned shortness of breath
2136,3029,16,54,200,270,1.3185185185185184,0.03532025495945297,651,"The first few days are tough, but if you make it to the second week the pounds start to melt away."
415,3030,13,67,212,292,1.3184931506849316,0.0324326613801543,651,I’m surprised you weren’t able to charm your way out of this one!
376,3031,12,47,164,223,1.3183856502242153,0.038240558296579505,651,Your prognosis might be hard to digest.
8039,3032,15,48,182,245,1.3183673469387756,0.037299109938276176,651,You should see significant weight loss within two to three weeks.
6842,3032,11,56,178,245,1.3183673469387756,0.03545983052378803,651,Luckily we caught this early.  Once they start to constrict our treatment options become limited.
3786,3032,16,46,183,245,1.3183673469387756,0.037744928235997136,651,"I’m prescribing you an emotional support mouse, see if that helps you breathe easier in stressful situations"
159,3032,15,48,182,245,1.3183673469387756,0.037299109938276176,651,"Senator, you're no Lady Gaga."
1894,3032,15,48,182,245,1.3183673469387756,0.037299109938276176,651,"I said, 'restrict' not 'constrict'."
2122,3032,13,52,180,245,1.3183673469387756,0.03639109219962615,651,I noticed this has been going around.
4042,3038,12,53,177,242,1.3181818181818181,0.03621717013762035,651,I'm going to prescribe an oil I think may help.
589,3038,21,35,186,242,1.3181818181818181,0.04025313408939814,651,"As your snake's veterinarian, I'm giving you a potent neurotoxin that will slowly render you defenseless."
8816,3038,23,31,188,242,1.3181818181818181,0.04109622315527717,651,"Bad news - only ""in-network"" herpetologists are covered under your medical insurance policy."
7099,3038,15,40,165,220,1.3181818181818181,0.040165512883860874,651,Tell me more about this shortness of breath
5756,3038,19,39,184,242,1.3181818181818181,0.03939200490467316,651,But is anything else bothering you?
3142,3038,13,51,178,242,1.3181818181818181,0.0366875427029663,651,"No need to worry, it's not poisonous."
764,3038,14,49,179,242,1.3181818181818181,0.03715196046491507,651,"I don't think you can blame this on climate change, Mr. Pierce."
630,3038,15,54,195,264,1.3181818181818181,0.035453526180319626,651,Let's not rush to a conclusion.  Breathing difficulties can have many causes.  How have you been coping with stress lately?
532,3038,13,51,178,242,1.3181818181818181,0.0366875427029663,651,"I'm referring you to a veterinarian, he'll help your pet unwind"""
6844,3038,20,37,185,242,1.3181818181818181,0.03982489707726098,651,I'm afraid this is outside my purview. But I strongly recommend couples counseling for you and Eve
901,3038,15,54,195,264,1.3181818181818181,0.035453526180319626,651,Now exhale...
2154,3049,19,45,197,261,1.318007662835249,0.03733799152776372,651,I'm positive that your crushing chest pain is not due to a myocardial infarction. Your mental health is a different matter.
5075,3049,17,49,195,261,1.318007662835249,0.036540124860162455,651,You say you feel like you're being crushed to death by a python?
7354,3049,17,49,195,261,1.318007662835249,0.036540124860162455,651,And would you say you’re experiencing any work-related pressure or strain?
8006,3049,16,51,194,261,1.318007662835249,0.036134585669835975,651,This wasn't what I had in mind when I told you to get a support animal.
7968,3049,16,51,194,261,1.318007662835249,0.036134585669835975,651,"Personally, I think the constriction diet is a fad."
423,3054,14,48,177,239,1.3179916317991631,0.037463021859003735,651,"Blood pressure monitoring sales reps went on strike, so we’re improvising."
6729,3054,17,42,180,239,1.3179916317991631,0.0388453282900452,651,Are you certain this is the same snake that bit you?
8131,3054,18,40,181,239,1.3179916317991631,0.03929529281834044,651,"Your insurance company requires that I refer you to a snake charmer before we schedule the serpentectomy, and there aren't many in-network."
241,3057,15,52,191,258,1.317829457364341,0.03600113288118421,651,"First, I'm obliged to ask if you'd be willing to take part in a clinical trial for a new drug that treats patients with your condition."
50,3058,15,45,176,236,1.3177966101694916,0.03825561111963134,651,And when did you first notice the problem...
4166,3058,14,47,175,236,1.3177966101694916,0.03778134136648091,651,I'm afraid I'll have to refer you to a specialist. Humans are quite difficult to get rid of.
1709,3060,12,44,158,214,1.3177570093457944,0.03929764982804876,651,These special socks should help.
8878,3061,12,64,201,277,1.3176895306859207,0.03315562186227435,651,Any change at home or work that accompanied your chest tightness?
2786,3062,17,47,191,255,1.3176470588235294,0.03712506730965684,651,"So, the nurse tells me you are having trouble breathing."
7286,3063,11,52,170,233,1.3175965665236051,0.03662187896048639,651,I'm guessing this is not a pre-existing condition?
7034,3063,13,48,172,233,1.3175965665236051,0.03761860383762821,651,Do you have any pets?
6543,3063,20,34,179,233,1.3175965665236051,0.04091637851799775,651,And for about how long have you've experienced this tightness in the chest?
6277,3063,15,44,174,233,1.3175965665236051,0.03858959303735032,651,"Look, just because you have access to WebMD doesn’t mean you know what’s going on here.."
2647,3063,15,44,174,233,1.3175965665236051,0.03858959303735032,651,Last time it was that orangutang hanging on your neck—problem seems to be getting worse.
6414,3063,11,52,170,233,1.3175965665236051,0.03662187896048639,651,I'm recommending that you see a herpetologist.
1683,3063,14,46,173,233,1.3175965665236051,0.038107191220822956,651,This should resolve on its own.
566,3070,16,48,188,252,1.3174603174603174,0.03700238989172131,651,Frankly I think you should try to relax more and not be so wound up!
2417,3070,11,58,183,252,1.3174603174603174,0.0348005616339656,651,"Aside from that, how did you like the Reptile House?"
5268,3070,16,48,188,252,1.3174603174603174,0.03700238989172131,651,"Good new Mr. Goldbaum, the tests are back and its not poisonous."
6921,3070,16,48,188,252,1.3174603174603174,0.03700238989172131,651,No sign of  poison.Come back if  it bites you
8279,3074,15,43,172,230,1.317391304347826,0.03893163007684938,651,So...the snake needs a shot.
5678,3074,8,57,165,230,1.317391304347826,0.035353441965283186,651,Are you sure you haven't traveled to any remote or exotic locations in the last six months?
3332,3076,14,58,199,271,1.3173431734317342,0.03442423333116231,651,"You’re my first patient on my first day of residency. I’d call that serpent-dipity, wouldn’t you?"
4941,3077,12,42,154,208,1.3173076923076923,0.04004877075647526,651,You say you can’t lift your arms anymore.
596,3078,16,47,186,249,1.3172690763052208,0.03730451551791581,651,You don't know what it's like to be squeezed by these insurance companies.
2000,3078,22,35,192,249,1.3172690763052208,0.03982401998646822,651,Any unusual bowel movements?
7947,3078,14,51,184,249,1.3172690763052208,0.036425974909044714,651,Trouble breathing?
136,3081,15,42,170,227,1.3171806167400881,0.03928203351016801,651,So you're feeling constricted. Could you be more specific?
2023,3081,19,34,174,227,1.3171806167400881,0.04121913992662704,651,This is the newest non-surgical gastric bypass procedure.
4294,3083,12,54,180,246,1.3170731707317074,0.035805526351679794,651,Everything looks pretty good but I recommend you see a specialist about that snake.
2958,3083,15,48,183,246,1.3170731707317074,0.03716971526995006,651,And when exactly did you start feeling the constriction in your chest?
8064,3083,16,46,184,246,1.3170731707317074,0.0376134515640163,651,"Trouble swallowing, yes, anything else?"
396,3086,18,48,199,265,1.3169811320754716,0.036533149671938554,651,"Your running a fever of  101.6° and, not surprisingly, so is Ralph."
7911,3086,14,56,195,265,1.3169811320754716,0.034933078410082606,651,I’m writing a prescription for a pair of pants.
348,3088,15,47,181,243,1.316872427983539,0.03747842809238516,651,Have you been feeling under pressure lately?
3626,3088,18,41,184,243,1.316872427983539,0.038815756817776895,651,I’m going to proscribe three or four mice a day...
1009,3088,12,53,178,243,1.316872427983539,0.03609158028149193,651,I think I’ve discovered the cause of your crushing chest pains!
7791,3088,15,47,181,243,1.316872427983539,0.03747842809238516,651,"I've told you before,stop using Google as your primary physician."
3259,3088,14,49,180,243,1.316872427983539,0.03702191833570823,651,She's more effective than leeches and you need only one.
1689,3093,14,36,152,202,1.316831683168317,0.04202955777594769,651,"We’re ALL feeling the squeeze, Mr Patient."
1097,3094,11,48,162,221,1.3167420814479638,0.03789723224483626,651,"So, all wound up again?"
5012,3094,17,36,168,221,1.3167420814479638,0.041024531969748916,651,You may experience some shortness of breath.
3020,3094,15,40,166,221,1.3167420814479638,0.04000926833661153,651,You're just having a hissy fit!
4045,3097,18,40,182,240,1.3166666666666667,0.039153644827790816,651,A fig leaf would be less constraining
2779,3097,17,42,181,240,1.3166666666666667,0.03870581868161478,651,"Besides a shortness of breath, are you experiencing any other symptoms?"
345,3097,15,46,179,240,1.3166666666666667,0.0377942507908351,651,We're going to have to do something about that blood pressure.
5820,3097,19,38,183,240,1.3166666666666667,0.03959640648831079,651,"Snake oil.  If it doesn't help, don't worry. That's normal."
6300,3097,14,48,178,240,1.3166666666666667,0.03733012040368727,651,And do you notice a rattle whenever you speak?
1711,3097,19,38,183,240,1.3166666666666667,0.03959640648831079,651,I thought I was clear yesterday - the muscle relaxant is not for you.
1005,3097,12,52,176,240,1.3166666666666667,0.03638410205543471,651,"Personally, I prefer this method to gastric banding."
3425,3104,18,46,195,259,1.3166023166023166,0.03711293411684983,651,"Actually, you're the third person tonight who came in complaining about a problem with their pet boa constrictor; however, as luck would have it, you are the first who was still alive when I saw them."
6066,3104,16,50,193,259,1.3166023166023166,0.03629751167483567,651,I think I can explain the weight gain and shortness of breadth.
1817,3106,14,47,176,237,1.3164556962025316,0.03764547761679015,651,I'm going to prescribe a muscle relaxant for you and an antacid for your friend. One or both of you come back to see me in a week.
2814,3106,18,39,180,237,1.3164556962025316,0.03949952921413919,651,Will I be needing to update your emergency contact?
6813,3106,13,49,175,237,1.3164556962025316,0.037167516452012925,651,"Aside from this, how was your Florida vacation?"
6567,3106,12,51,174,237,1.3164556962025316,0.03668332827627633,651,I don't think a probiotic's gonna help.
7531,3106,10,55,172,237,1.3164556962025316,0.03569525405223867,651,"Fang, skin, squeeze, all seem in perfect working order, Mr Snake."
7572,3106,13,49,175,237,1.3164556962025316,0.037167516452012925,651,Call me if you feel any tightness in your chest.
2061,3106,14,47,176,237,1.3164556962025316,0.03764547761679015,651,This will help your anxiety. Just bring the snake back when you're done.
6173,3113,16,49,191,256,1.31640625,0.03658422112251307,651,In general everything looks good  but you'll have to excuse me if I don't check your prostate today.
774,3113,15,51,190,256,1.31640625,0.03616307481726313,651,"You're not the first guy who bought the wrong thing, when his wife asked him to buy her a boa."
7493,3115,16,42,176,234,1.3162393162393162,0.03892240260151513,651,And here’s the last question.  Are you allergic to anti-snake venom?
8639,3115,19,36,179,234,1.3162393162393162,0.040311297977393155,651,I think we discovered the reason for your headaches and breathing difficulties.
955,3115,14,46,174,234,1.3162393162393162,0.03796825705826644,651,"His attachment issues are, as you said, sssssssevere."
8449,3115,15,44,175,234,1.3162393162393162,0.038448289742958865,651,Good news is you're only at stage one.
1579,3119,15,50,188,253,1.316205533596838,0.03644939246659801,651,"Yeah, well, everyone is afraid of the scale."
2413,3119,22,36,195,253,1.316205533596838,0.03934647871529302,651,Still constipated?
3724,3121,14,45,172,231,1.316017316017316,0.03829873951874344,651,It seems the internet isn't the answer to all medical issues.
5172,3121,20,33,178,231,1.316017316017316,0.04114188308950957,651,"No, I said aspirin, not put an asp on."
7579,3121,18,37,176,231,1.316017316017316,0.0402165079580774,651,"Well, Mr. Philipps, the good news is you just have a little frog in your throat..."
4818,3124,11,57,182,250,1.316,0.03494941841275128,651,It’s a common enough condition. I am going to prescribe a ten day supply of mice until it sheds you.
5994,3124,19,41,190,250,1.316,0.0384511373022874,651,This one is a little constricting but doesn't have that embarrassing opening in the back.
5614,3124,11,57,182,250,1.316,0.03494941841275128,651,I am going to need you to get fully undressed for the exam.
5441,3124,20,39,191,250,1.316,0.038866675621868955,651,Yes I've performed many hissterectomies before.
3447,3124,14,51,185,250,1.316,0.03630216783551959,651,"Get this filled, and next time try using a feather boa"
3322,3124,13,53,184,250,1.316,0.03585692228150665,651,I think I’ve discovered the problem.
2259,3124,20,39,191,250,1.316,0.038866675621868955,651,Blood pressure fine. I'll summon the colonoscopy weasel.
2142,3124,21,37,192,250,1.316,0.03927781801413881,651,So it says here that you're short of breath
1773,3124,12,55,183,250,1.316,0.03540607802970817,651,"So, you have some tightness in your chest?"
123,3124,13,53,184,250,1.316,0.03585692228150665,651,I'm going to write you a referral to a herpetologist.
3312,3134,18,49,202,269,1.3159851301115242,0.03613653234518407,651,It is really quite dangerous and it's just a matter of time before...   well this is awkward... I see you have a DNR.
1682,3135,12,54,181,247,1.3157894736842106,0.035683367826200116,651,I've written you a prescription for a muscle relaxer.
850,3135,18,42,187,247,1.3157894736842106,0.03835093992174035,651,So your wife asked you to wear a boa?
995,3135,12,48,168,228,1.3157894736842106,0.037623783361083546,651,I'll let you know when the cultures come back from the lab.
2854,3135,12,54,181,247,1.3157894736842106,0.035683367826200116,651,"Of course, we'll have to run a few more tests....."
3287,3135,17,44,186,247,1.3157894736842106,0.037919378739251046,651,"Other than shortness of breath, any other symptoms?"
7121,3135,16,46,185,247,1.3157894736842106,0.037482849078753204,651,"I’m sorry, only service animals are allowed in the examination room"
5085,3141,18,47,198,263,1.3155893536121672,0.03669946246129562,651,"On a scale of 1 to 10, how painful is the slow cutoff of vital blood flow to your heart and brain?"
2580,3142,14,49,181,244,1.3155737704918034,0.036892740998674116,651,"Chest tightness may be caused by a variety of conditions, Mr. Delaney. I suspect it's not a heart attack."
2979,3142,12,53,179,244,1.3155737704918034,0.03596681264098656,651,You're fortunate the snake took the Valium. Here's another prescription.
5538,3142,16,45,183,244,1.3155737704918034,0.037795992714025506,651,Your chart looks fine; elevated heart rate but that might just be the snake.
6162,3142,18,41,185,244,1.3155737704918034,0.03867815652383252,651,Yep. The tests confirm it's a boa.
8811,3142,12,53,179,244,1.3155737704918034,0.03596681264098656,651,It should go away naturally in a week or two.
6002,3147,14,43,168,225,1.3155555555555556,0.03898401065077519,651,Lab results show the snake is not venomous.”
7112,3147,21,29,175,225,1.3155555555555556,0.04239729784075314,651,...you heard correctly. But the snake takes the Viagra not you.
1229,3149,15,58,206,279,1.3154121863799284,0.03411018017113314,651,I recommend you speak to Eve about this relationship.
8838,3150,18,46,196,260,1.3153846153846154,0.03698996515412897,651,So how would you describe this tightness in your chest?
5255,3150,15,52,193,260,1.3153846153846154,0.03576531046983356,651,"I meant to say ""some"" pets will help you decompress."
1847,3150,19,44,197,260,1.3153846153846154,0.03738927054388338,651,Your provider allows me to prescribe an asthma inhaler.
5739,3153,14,48,179,241,1.3153526970954357,0.03719811521570336,651,I'm just glad you didn't consult Web MD about this.
5117,3153,13,50,178,241,1.3153526970954357,0.036730391081356596,651,Your breathing is a bit constricted.
2815,3153,18,40,183,241,1.3153526970954357,0.03901297684163705,651,"I don't think your HMO covers "" attempted strangulation by emotional support animal"" ."
132,3153,18,40,183,241,1.3153526970954357,0.03901297684163705,651,You're test results say that you're breathing is slightly constricted.
3555,3157,15,40,167,222,1.3153153153153154,0.039854185719416096,651,We're going to run a few more tests to figure what's causing that tightness in your chest.
5173,3157,15,40,167,222,1.3153153153153154,0.039854185719416096,651,I’m going to prescribe snake oil.
2592,3159,12,40,151,203,1.3152709359605912,0.040669019875640915,651,I'm going to need you to sign this release form.
4487,3160,19,43,195,257,1.3151750972762646,0.037692198997694944,651,"So, you are saying you  feel constricted?!"
5638,3161,14,47,177,238,1.315126050420168,0.03751054319244007,651,I’m glad to see your temperatures back to normal but the nurse couldn’t find a pulse
6841,3161,17,41,180,238,1.315126050420168,0.038902602910100996,651,"I know you are trying to save money, Mr. Jones, but when I suggested compression therapy, this isn't what I had in mind."
4745,3161,16,43,179,238,1.315126050420168,0.03844418411564966,651,Trust me. It’s herpes. I’m a herpetologist.
4385,3161,10,55,173,238,1.315126050420168,0.03556981820504284,651,"I can't check your blood pressure, but your reflexes are good."
8954,3161,16,43,179,238,1.315126050420168,0.03844418411564966,651,And what did your primary care doctor say?
3471,3166,15,39,165,219,1.3150684931506849,0.04022794222333942,651,"If the snake doesn’t kill you, PETA probably will :("
1466,3166,14,41,164,219,1.3150684931506849,0.03970384742368214,651,Don't worry -- it is not venomous
7770,3168,13,54,187,254,1.31496062992126,0.0354598607483111,651,Your test results came back positive.
344,3168,15,50,189,254,1.31496062992126,0.036326944656391344,651,"It's like a mammogram, only less painful."
7270,3168,17,46,191,254,1.31496062992126,0.03717380921895717,651,I'm just a doctor. You need a couples therapist.
5380,3168,15,50,189,254,1.31496062992126,0.036326944656391344,651,In order to complete your exam you will have to take your pyth off.
2585,3172,17,40,178,235,1.3148936170212766,0.03924590882071593,651,When did you notice that your boa had lost its feathers?
3838,3172,15,44,176,235,1.3148936170212766,0.03830797385521108,651,"This time I will write the prescription more clearly, oil not coil."
6231,3172,13,48,174,235,1.3148936170212766,0.03734649063324588,651,At some point we may want to move you off a constrictive diet.
2694,3175,17,45,189,251,1.3147410358565736,0.03747731492704257,651,"So, you were cleaning his enclosure while naked?  That's interesting."
2826,3175,13,53,185,251,1.3147410358565736,0.03573596359831494,651,"No need to worry, says here he identifies as a rabbit."
2853,3175,15,49,187,251,1.3147410358565736,0.03661699215146445,651,"On the other hand, it could just be asthma, which is covered by your plan."
7148,3175,12,55,184,251,1.3147410358565736,0.03528720142402811,651,We're thinking it might be a case of Coilitis.
7182,3175,14,51,186,251,1.3147410358565736,0.0361791598058917,651,So you'd say your pain level is at about five?
971,3180,18,37,177,232,1.3146551724137931,0.04006594718905896,651,"Well, let's wait and see what the blood test tells us."
8705,3181,15,54,198,267,1.3146067415730338,0.03511468269749817,651,"I respect your commitment to natural remedies, but an 'organic tourniquet' wasn't the best choice this time."""
2847,3182,16,46,186,248,1.314516129032258,0.03735311268188583,651,"Well, I was glad to be able to squeeze you in, but....."
6437,3182,23,32,193,248,1.314516129032258,0.0402964522894968,651,It's cancer.
2056,3184,19,34,176,229,1.314410480349345,0.040905078118708346,651,"Go home, you’re fine."
6407,3184,15,42,172,229,1.314410480349345,0.03898722783484233,651,Good news Mr. Haast. We have ascertained the cause of  your COPD symptoms as well as your anal leakage.
8052,3184,14,44,171,229,1.314410480349345,0.038492837825145766,651,"If the prescription doesn't help, try mice."
8345,3187,17,49,198,264,1.3143939393939394,0.03618384978131645,651,...and 50mg a day for viper-tension.
502,3187,14,55,195,264,1.3143939393939394,0.0349693508567409,651,"Yes, Mr. Johnson, this should cure your constipation rather quickly."
6375,3189,17,43,185,245,1.3142857142857143,0.03810499484737534,651,Good news. We've sold the movie rights.
8728,3189,15,36,159,210,1.3142857142857143,0.041408650076312156,651,Well? Is it working?
248,3189,14,49,182,245,1.3142857142857143,0.036764420521199825,651,"No, what I prescribed during your last visit was a ""restrictive"" diet."
1004,3189,9,59,177,245,1.3142857142857143,0.03441427886059527,651,When did you first notice that your breathing felt constricted?
4584,3189,13,40,157,210,1.3142857142857143,0.04029316775708098,651,... take one of these in the morning and one before bed and that should help you unwind.
5333,3189,12,53,180,245,1.3142857142857143,0.03584285989641029,651,"So, it says here you were complaining of a tightness in your chest? Tell me a little more about that."
7003,3189,17,43,185,245,1.3142857142857143,0.03810499484737534,651,And when did you first notice this tightening in your chest?
6444,3189,16,45,184,245,1.3142857142857143,0.03766343886271593,651,Try the snake oil.
6502,3189,13,40,157,210,1.3142857142857143,0.04029316775708098,651,Your insurance may not cover this.
3746,3198,15,52,194,261,1.314176245210728,0.03564850093361618,651,He's a little tense.  Give him two these and he will relax.
1908,3198,14,54,193,261,1.314176245210728,0.03523270037264369,651,She's a lot more clingy than I thought she'd be.
2620,3200,13,50,179,242,1.3140495867768596,0.03660150215446003,651,"As a veterinarian, all I can tell you is that the snake will be fine.  Anything else you'll need a referral."""
923,3200,18,40,184,242,1.3140495867768596,0.03887327930579209,651,"So, tightness in the chest. Any other symptoms?"
269,3200,14,48,180,242,1.3140495867768596,0.03706699794652351,651,"So, that's ""somewhat happy"" with your emotional support snake?"
6305,3200,13,50,179,242,1.3140495867768596,0.03660150215446003,651,"You know, these fad diets only work for a time"
7861,3200,15,46,181,242,1.3140495867768596,0.037526719994854525,651,"Here is a prescription for some cold medicine, because no matter what happens, I don't want  you to sneeze and startle him."
5258,3205,13,39,155,207,1.3140096618357489,0.040686550987774954,651,"We won't know until the test results come back, but it looks like a constricted artery."
6934,3206,19,43,196,258,1.313953488372093,0.03756568914371816,651,Time to remove your boa
5698,3206,18,45,195,258,1.313953488372093,0.03716204808703919,651,"The ultrasound is indicating you may have a boa constriction, but I'd like to follow up with a thorough physical exam and barium enema."
5400,3206,15,51,192,258,1.313953488372093,0.035923923359876216,651,"In this case, getting right back into the rat race will be exactly what you need."
620,3209,18,34,171,223,1.3139013452914798,0.041198392138996544,651,Now keep this eco-friendly torso brace on for 3 months or until it gets hungry.
2922,3210,16,54,204,274,1.313868613138686,0.03488040414589304,651,"As I believe I mentioned, this experiemental weight loss protocol comes with certain risks."
6778,3210,14,58,202,274,1.313868613138686,0.03410525014351283,651,"We should have your blood pressure information in just another minute or two."""
1674,3212,15,50,190,255,1.3137254901960784,0.0362052800898053,651,He has extreme separation anxiety if I leave him home alone.
3242,3212,22,36,197,255,1.3137254901960784,0.03907648600230065,651,It appears that you are constricted.
1728,3212,17,46,192,255,1.3137254901960784,0.037048337245284335,651,You definitely are constricted
7416,3215,15,39,166,220,1.3136363636363637,0.04007027111737457,651,"Mr. Burke, how long have you felt this tightness in your chest?"
373,3216,15,44,177,236,1.3135593220338984,0.03816863576329683,651,"For your hypertension,  try getting less wrapped up in your work at the zoo."
5393,3216,17,40,179,236,1.3135593220338984,0.039102030758044026,651,"Alas, your plan does not cover preexisting conditions."
8185,3216,17,40,179,236,1.3135593220338984,0.039102030758044026,651,The HMO requires us to try motivational interviewing first  to show the snake the advantages of releasing you
8797,3216,16,42,178,236,1.3135593220338984,0.03863815190607751,651,I think we can rule out claustrophobia.
2386,3220,14,51,187,252,1.3134920634920635,0.036056943716321864,651,I’m prescribing one medium sized goat for tension and the hissing sound.
3617,3220,14,51,187,252,1.3134920634920635,0.036056943716321864,651,"As long as the head is pointing away from you, you'll be OK"
5180,3220,14,51,187,252,1.3134920634920635,0.036056943716321864,651,"If you like your snake, you can keep your snake."
4308,3220,18,43,191,252,1.3134920634920635,0.03777011257978481,651,She’s going to read your blood pressure.
2634,3220,13,53,186,252,1.3134920634920635,0.03561577791695836,651,A muscle relaxer should do the trick.
8008,3225,15,54,199,268,1.3134328358208955,0.03500310268524947,651,"Sorry I can't be of more help.  Like I said, I'm just an internist."
2841,3226,15,38,164,217,1.3133640552995391,0.04044977865113828,651,"Well, I have the medical degree, and I think it’s angina."
8425,3226,13,42,162,217,1.3133640552995391,0.039380779549291145,651,"As a new patient, I have a few forms for you to fill out..."
7179,3226,15,38,164,217,1.3133640552995391,0.04044977865113828,651,"From personal experience I can tell you, just talk to him and he’ll loosen up."
3570,3229,13,47,173,233,1.3133047210300428,0.03752774006415856,651,"I can squeeze you in next Tuesday, but leave the snake at home."
559,3229,11,51,171,233,1.3133047210300428,0.03652853594420601,651,I think I've found the source of that hissing sound that's been bothering you.
3930,3231,13,52,184,249,1.3132530120481927,0.03589541445541536,651,Technically I suppose this is a pre existing condition.
3353,3231,17,44,188,249,1.3132530120481927,0.037656755553687506,651,"Adam, which garden were you in when you ate that apple?"
9191,3231,14,50,185,249,1.3132530120481927,0.03634375316202325,651,This type of thing is going around
1149,3234,14,39,161,214,1.3130841121495327,0.04029839244480695,651,Any trouble breathing?
5200,3235,18,36,176,230,1.3130434782608695,0.04028116239815955,651,And any tightness in the chest?
2711,3235,9,54,167,230,1.3130434782608695,0.035788566917774864,651,It's a real shame that the name 'asp'bergers syndrome is already taken
1238,3235,12,48,170,230,1.3130434782608695,0.03734619609457346,651,I don’t think diet and exercise are going to do it this time.
104,3235,14,44,172,230,1.3130434782608695,0.03834948400181142,651,Take two asps and call me in the morning.
2385,3239,15,47,184,246,1.3130081300813008,0.037087060293452996,651,A large dose of mongoose should clear it up.
6521,3239,16,45,185,246,1.3130081300813008,0.03753177382591527,651,Don't worry. You do not  have Caduseus syndrome. That would be with two serpents.
7476,3239,14,49,183,246,1.3130081300813008,0.03663694905284523,651,"I will write you a script for the shortness of breath, but you will need to see a specialist about the snake."
7484,3239,12,53,181,246,1.3130081300813008,0.03571971479844002,651,The tests we ran are inconclusive.
3015,3239,14,49,183,246,1.3130081300813008,0.03663694905284523,651,She told me to taste the fruit and the next thing I knew?
8704,3244,18,40,185,243,1.3127572016460904,0.0387345427775377,651,I would say you have a have a case of coiltus interruptus.
9021,3244,15,46,182,243,1.3127572016460904,0.03739430971584032,651,"Sir, I had referred you to a ""Hepatologist"", not a ""Herpetologist""."
2271,3244,17,42,184,243,1.3127572016460904,0.03829301070906624,651,"Well, your blood pressure is up, but I think we found the cause."
5356,3244,17,42,184,243,1.3127572016460904,0.03829301070906624,651,In your condition I think we'll try some good old fashioned snake oil.
305,3248,14,53,192,259,1.3127413127413128,0.035385052035777145,651,Are you feeling any tightness?
2776,3248,18,45,196,259,1.3127413127413128,0.03703812842906974,651,"So Adam, you say you've had this condition for what seems like an eternity?"
4080,3248,16,49,194,259,1.3127413127413128,0.03622102197000328,651,I'm afraid we have to run a few more tests.
7274,3248,16,49,194,259,1.3127413127413128,0.03622102197000328,651,"The good news is that, no, that crushing sensation doesn't mean you are having a heart attack!"
7089,3252,16,38,170,224,1.3125,0.04005046664251431,651,Could you be a bit more specific about your symptoms?
7465,3252,11,53,176,240,1.3125,0.0358115953654963,651,"I see you took my advice to ""Apply pressure to wound"" quite seriously."
6449,3252,19,47,206,272,1.3125,0.03617044686473499,651,I’m sorry to inform you but you have a stage four snake.
8194,3252,14,47,179,240,1.3125,0.03724342724672754,651,and you said you're just here for a check up today?
8924,3252,12,56,188,256,1.3125,0.03478752030006524,651,"I take it was your first time in the Amazon, right?"
6080,3252,16,38,170,224,1.3125,0.04005046664251431,651,"So, you feel a tightening in your chest?"
5682,3252,20,35,185,240,1.3125,0.03995344658477901,651,"Patients complained the drape sheet was too cold and revealing, so we're trying something new."
4917,3252,16,43,181,240,1.3125,0.038168152693781085,651,"No, the tightening in your chest is definitely not a heart attack."
2156,3252,14,52,190,256,1.3125,0.03565734255986237,651,We're going to need a few more tests to determine the cause of  your shortness of breath problem.
576,3252,17,36,171,224,1.3125,0.04054723560469413,651,I see you are experiencing some attachment issues with your emotional support anaconda?
538,3252,15,50,191,256,1.3125,0.03608439182435161,651,Besides pressure on your chest are there any other symptoms?
6974,3252,15,40,169,224,1.3125,0.039547458090043265,651,"So, first question... have you recently been on a vacation or business trip outside of the United States or Canada?"
3277,3252,18,44,194,256,1.3125,0.03733624375910378,651,I'm going to refer you to an excellent snake charmer.
8642,3265,22,35,196,253,1.3122529644268774,0.03927235457388375,651,"Sooooo, Mr. Plissken...What seems to be the problem?"
7106,3265,14,51,188,253,1.3122529644268774,0.035935512533995455,651,Come back if you start feeling any tightness in your chest.
2121,3265,20,39,194,253,1.3122529644268774,0.03846529137550984,651,Your first mistake was naming him Monty.
5816,3265,22,35,196,253,1.3122529644268774,0.03927235457388375,651,"Well I can’t help with the snake, but I can give you something for the high blood pressure."
8547,3265,14,51,188,253,1.3122529644268774,0.035935512533995455,651,I see here you're complaining of a tightness in your chest...
8939,3265,17,45,191,253,1.3122529644268774,0.03722190015087768,651,"Unfortunately, your insurance only covers snake bites."
1842,3271,16,42,179,237,1.3122362869198312,0.03849751725963337,651,I’m prescribing a muscle relaxant;  and in the meantime I would avoid stressful situations.
7296,3272,14,41,166,221,1.3122171945701357,0.03939511105824237,651,"If you won't undress, I can't tell if anything's wrong."
7499,3272,11,47,163,221,1.3122171945701357,0.0377964121251251,651,Good news. The chest pain and shortness of breath you're experiencing is not a heart attack.  It's an anaconda.
5949,3272,12,45,164,221,1.3122171945701357,0.03833672005773689,651,Would it be fair to say he's developed an unhealthy attachment to you?
5296,3275,14,60,208,282,1.3120567375886525,0.03342640028161214,651,That's not what I meant when I said keep some pressure on it.
3926,3276,17,49,200,266,1.3120300751879699,0.035950010168122014,651,I think I have snake oil somewhere...
8802,3276,16,51,199,266,1.3120300751879699,0.03555320537235039,651,Have you been taking the snake oil I prescribed for you?
1905,3278,13,52,185,250,1.312,0.03577349538258108,651,"I'm prescribing you pills. As soon as you're able to swallow, take two a day."
2871,3278,16,46,188,250,1.312,0.037096206194922744,651,There are much easier ways to take care of constipation.
7345,3278,14,50,186,250,1.312,0.03621976650868659,651,"Again Mr. Thompson ? Wait a sec, I just have to get the flute..."
4116,3281,13,47,174,234,1.311965811965812,0.03739100068688551,651,"Now, please run down your symptoms for me again."
8019,3281,14,45,175,234,1.311965811965812,0.03787834965362917,651,A little snake oil and the anaconda will slide right off.
6535,3281,11,51,172,234,1.311965811965812,0.036396731338608414,651,The good news is that I don't think the tightness in your chest is due to your heart. The bad news is....
453,3281,15,43,176,234,1.311965811965812,0.03835950746032209,651,"A couple hours a day for the blood pressure, and I'll see you in 6 months."
2481,3281,13,47,174,234,1.311965811965812,0.03739100068688551,651,Your arteries are constricted.
3960,3281,14,45,175,234,1.311965811965812,0.03787834965362917,651,Let’s lay off the Viagra until this thing clears up.
4312,3281,15,43,176,234,1.311965811965812,0.03835950746032209,651,"So, Mr. Jones, what brings you in today?"
3021,3288,16,36,166,218,1.311926605504587,0.040810757431830734,651,If the mice don't work I'll up the prescription to rats.
5624,3289,16,50,197,263,1.311787072243346,0.03582447123177745,651,"Patients kept complaining about the open-back gowns, so we're trying something different."
2760,3289,19,44,200,263,1.311787072243346,0.03701983096783829,651,"About that tightness in your chest, I am going to refer you to veterinarian."
3935,3291,16,45,186,247,1.311740890688259,0.03740098927170804,651,"Then he said ""Don't eat the apple""."
412,3291,19,39,189,247,1.311740890688259,0.0386985778192551,651,"As you suspected, it's syphilis."
1339,3291,14,49,184,247,1.311740890688259,0.03651031882471135,651,Any changes in your medical history that I should be aware of?
5996,3291,16,45,186,247,1.311740890688259,0.03740098927170804,651,And how long have you been experiencing this shortness of breath?
6485,3291,9,59,179,247,1.311740890688259,0.03418225908466556,651,Mice and chicken diet seem to be working out ?
1771,3296,14,44,173,231,1.3116883116883118,0.03820714873112457,651,I’ve got some crushing news for you. . .
779,3297,15,37,163,215,1.3116279069767443,0.04067484689072551,651,"I said please undress, sir."
6346,3298,13,55,192,260,1.3115384615384615,0.03484561917595435,651,You are not alone. Anaconda Syndrome is going around.
4811,3298,17,47,196,260,1.3115384615384615,0.03651050937135438,651,So how long have you not been comfortable in your own skin?
6389,3300,18,40,186,244,1.3114754098360655,0.03859675792425699,651,I Know. There's a lot of it going around.
4757,3300,13,50,181,244,1.3114754098360655,0.03634629149108816,651,"It’s one thing to embrace your fear of snakes, and quite another when your phobia embraces you."
229,3300,14,48,182,244,1.3114754098360655,0.03680739421063188,651,"Yes, it could be sleep apnea, but I’m thinking along different lines here."
7288,3303,24,37,212,273,1.3113553113553114,0.03787738331029502,651,You refused to eat the apple?
8413,3304,15,36,161,212,1.3113207547169812,0.04107036940934855,651,This is the 3rd prescription I have written for a comfort snake this month.
1243,3305,19,42,196,257,1.311284046692607,0.03761680824166396,651,Your CT Scan indicates a constriction in your upper body area. We will need to keep an eye on you until we find the source of the problem.
5774,3305,21,38,198,257,1.311284046692607,0.03841642783575495,651,Any concerns with your emotional support animal?
143,3307,15,45,181,241,1.3112033195020747,0.03757421219144156,651,I see you're having shortness of breath. Any other symptoms?
3117,3307,10,55,176,241,1.3112033195020747,0.03519844724914392,651,You seem to have an upper-respiratory problem
8947,3307,13,49,179,241,1.3112033195020747,0.03664239523536626,651,"Unfortunately, it has a Do Not Regurgitate..."
3072,3310,14,42,169,225,1.3111111111111111,0.03888888888888889,651,When did you first notice constriction in your chest and difficulty breathing?
5571,3310,16,38,171,225,1.3111111111111111,0.039896249928751765,651,All right. I'll take you off the antihisssssstamines and we'll try something else.
5585,3310,17,36,172,225,1.3111111111111111,0.040390509999998325,651,"Congratulations on being a newbie to drag.  However, in the future, you might consider wearing the feather kind of boa."
7064,3310,14,42,169,225,1.3111111111111111,0.03888888888888889,651,"So, tell me, how long have you had this tightness in your chest?"
9246,3310,13,44,168,225,1.3111111111111111,0.0383752933451955,651,"Good news Mr. Slithers, you'll be good as new as soon as we get this human out."
8240,3315,15,49,190,254,1.311023622047244,0.03624674796896149,651,So if I have this right all you said was: “I don’t want a bite of the fruit I’m still full from lunch?”
7281,3315,14,51,189,254,1.311023622047244,0.03581485929660985,651,"Hmm ... tight in the chest, short of breath ... we'd better have the cardiologist run some tests."
1965,3315,9,61,184,254,1.311023622047244,0.03357217876439803,651,"I'm not going to prescribe anything right now, I just think you need to loosen up."
2571,3315,14,51,189,254,1.311023622047244,0.03581485929660985,651,"It says here you’re experiencing difficulty in swallowing, a tightness in your chest and a compacted bowel... anything else?"
4163,3315,16,47,191,254,1.311023622047244,0.036673550826377126,651,The X-Ray doesn't show anything.
338,3320,16,42,180,238,1.3109243697478992,0.03835786341672461,651,"It says here that you've been out of the country recently, is that right?"
2567,3320,14,46,178,238,1.3109243697478992,0.037422068945610724,651,"Safe sexual practices are for everyone, Phil."
4050,3320,14,46,178,238,1.3109243697478992,0.037422068945610724,651,Being unfaithful to a professional snake charmer is clearly not a good idea!
4218,3320,14,46,178,238,1.3109243697478992,0.037422068945610724,651,We’ve diagnosed the tightness in your chest.
6987,3320,12,50,176,238,1.3109243697478992,0.03646226545956772,651,"Yeah, we'll sort out your chest tightness with a few tests including an EKG, stress test, echocardiogram, chest CT, some blood work and have both our cardiologist and pulmonary people take a look at you."
6579,3325,14,50,187,251,1.3107569721115537,0.03609658494961376,651,Well at least it’s not a elephant on your chest.
6929,3325,16,46,189,251,1.3107569721115537,0.036969020340617643,651,When did you first start feeling rattled?
4527,3325,12,54,185,251,1.3107569721115537,0.03520253435626992,651,"If you can't sign the form, I'm afraid I can't treat you."
3801,3325,16,46,189,251,1.3107569721115537,0.036969020340617643,651,"Your chest sounds a little tight, Mr. Jones. Do you smoke?"
1554,3325,17,44,190,251,1.3107569721115537,0.0373976065397929,651,"No, I don't think you have asthma."
875,3325,17,44,190,251,1.3107569721115537,0.0373976065397929,651,"So, it says here, you're experiencing some tightness in your chest."
8222,3331,10,44,152,206,1.3106796116504855,0.038964972963279484,651,"The good news is, usually, it's not fatal"
2550,3332,13,47,175,235,1.3106382978723403,0.03725520921756692,651,"Well, we’ve got the results of your colonoscopy."
2657,3332,14,45,176,235,1.3106382978723403,0.037740175714759065,651,"Generally, taking a bite from an apple does not cause this kind of constriction, but I suggest you avoid that Garden."
6303,3332,13,47,175,235,1.3106382978723403,0.03725520921756692,651,Exactly how long have you been experiencing this numbness in your right toe?
2430,3335,18,46,200,264,1.3106060606060606,0.03650582390562423,651,"And the BAD news is,we found a Boa Constrictor."
2736,3336,22,47,224,293,1.310580204778157,0.035320973902273206,651,"And finally, would you describe this as a pre-existing condition?"
7383,3337,17,43,188,248,1.310483870967742,0.037706538433115326,651,Your cat scan was negative.
161,3337,13,51,184,248,1.310483870967742,0.03593304313755933,651,"Feed it a big, fat rat. That should release the pressure"
6989,3339,17,52,208,277,1.3104693140794224,0.03493377800453437,651,"So, other than tightness in your chest, do you have any other complaints?"
7211,3340,14,44,174,232,1.3103448275862069,0.038065821937529325,651,I can squeeze you in...on Friday.
7208,3340,14,53,194,261,1.3103448275862069,0.03515408987385091,651,I suppose you were your usual charming self.
6270,3340,12,48,172,232,1.3103448275862069,0.0370724802799489,651,So your wife bought it for you as a present?
7827,3340,16,40,176,232,1.3103448275862069,0.03903389303479961,651,Does it seem like the pressure is more in your chest or your back?
2671,3340,15,51,195,261,1.3103448275862069,0.03557080935436153,651,Have you noticed a rattling sound?
226,3340,13,46,173,232,1.3103448275862069,0.037572434003447855,651,So the two aspirins didn't help?
3646,3340,14,44,174,232,1.3103448275862069,0.038065821937529325,651,Bad news is you're both allergic to muscle relaxants.
3241,3340,12,48,172,232,1.3103448275862069,0.0370724802799489,651,Sorry but compression bandages are not covered by your insurance policy so you will have to wear the snake until the swelling reduces.
7623,3348,20,36,189,245,1.310204081632653,0.03932018708854856,651,It says here you recently relocated with your wife from Eden.
7199,3348,9,58,178,245,1.310204081632653,0.034322894018364636,651,Are you feeling any shortness of breath ?
2293,3348,18,40,187,245,1.310204081632653,0.038459915522171116,651,I'm ordering an EKG and we'll see what's going on
4233,3348,15,46,184,245,1.310204081632653,0.03713215703286918,651,"She may be your main squeeze, but I sense control issues."
1535,3348,18,40,187,245,1.310204081632653,0.038459915522171116,651,How long has your chest felt tight ?
1570,3353,20,40,198,258,1.310077519379845,0.03789028863624266,651,"Next time you come to the vet, put the snake in a crate."
3968,3353,19,42,197,258,1.310077519379845,0.03749014257266473,651,"...and, other than the tightness in your chest?"
7903,3353,16,48,194,258,1.310077519379845,0.036263221611731844,651,This is the worst case of constipation that I have seen in all my years as a veterinarian.
4823,3356,11,49,169,229,1.3100436681222707,0.036872615056695666,651,You’re blood pressure seems a little on the high side
34,3356,17,37,175,229,1.3100436681222707,0.039867555274895536,651,I've never had a patient actually ask me for snake oil...
1048,3356,17,37,175,229,1.3100436681222707,0.039867555274895536,651,So that’s your main squeeze.
5631,3359,18,48,205,271,1.3099630996309963,0.035835390375655876,651,I see you are  feeling a bit constricted
6877,3359,15,54,202,271,1.3099630996309963,0.034672386467727453,651,You’ll feel a little squeeze as we check your blood pressure.
7263,3359,19,46,206,271,1.3099630996309963,0.036214759560779214,651,I noticed your cholesterol is a little high.
6232,3362,12,51,179,242,1.3099173553719008,0.03604067215664669,651,That crushing chest pain - The good news it's not a heart attack.
5934,3362,13,49,180,242,1.3099173553719008,0.03651331847843365,651,You have high blood pressure.
3902,3362,12,51,179,242,1.3099173553719008,0.03604067215664669,651,With this certificate you'll have no more trouble taking your emotional support animal into  family restrooms.
5902,3365,17,32,164,213,1.3098591549295775,0.04197207473379947,651,I typically ask if you feel safe at home. I think I know the answer
4056,3366,21,37,197,255,1.3098039215686275,0.038604155772692605,651,That's a big fuckin' snake
4983,3366,18,43,194,255,1.3098039215686275,0.03738509547311215,651,The good news is your blood pressure has gone way down!
5806,3366,20,39,196,255,1.3098039215686275,0.0382021249381861,651,"He does seem clingy, but like I said, this is an issue for your therapist to take on.”"
4285,3366,15,49,191,255,1.3098039215686275,0.036124920541713366,651,"Medically speaking, Mr. Breen, if you want to wear a boa, your best bet is a costume store, not the pet store."
4731,3366,17,45,193,255,1.3098039215686275,0.03696981025653465,651,"So, you ordered a snakeskin belt . . ."
8586,3366,12,55,188,255,1.3098039215686275,0.034819167203660954,651,"Son, I'm afraid not all boas were meant to be worn."
4211,3372,17,36,173,226,1.3097345132743363,0.04023495011593514,651,I'm afraid you have post-coiltil syndrome.
6960,3372,17,36,173,226,1.3097345132743363,0.04023495011593514,651,"So, which one of you is getting the prostate exam?"
3429,3372,14,42,170,226,1.3097345132743363,0.038740897131284965,651,He just has some separation anxiety.
4376,3375,16,42,181,239,1.3096234309623431,0.03821918077070614,651,You say you have tightness in the chest? Any other symptoms?
4263,3375,12,50,177,239,1.3096234309623431,0.03633268154035686,651,"If you turndown your theremostat, she'll be less active."
7169,3375,15,44,180,239,1.3096234309623431,0.0377563937772953,651,I’m writing you a prescription for a feather boa.
1818,3378,16,55,210,281,1.309608540925267,0.03420683389690434,651,"Frankly, when you called I assumed that it was a feathered boa."
5523,3378,20,47,214,281,1.309608540925267,0.035662097063959376,651,"Well, I’ve been able to rule out asthma as a source of your breathing difficulties."
8967,3380,13,39,158,210,1.3095238095238095,0.0401866663997095,651,There’s nothing I can do and you’re going to die.
9089,3380,15,48,189,252,1.3095238095238095,0.03641102455029218,651,Have you considered getting a cat?
5050,3382,13,56,196,265,1.3094339622641509,0.03436644068692578,651,I think we'll try mongoose therapy
619,3383,14,41,168,223,1.3094170403587444,0.03909094694916911,651,It says here that you're having trouble breathing. We'll run some tests.
2108,3383,15,39,169,223,1.3094170403587444,0.03960430881761366,651,And when did you begin to feel the tightness in your chest?
7444,3383,14,41,168,223,1.3094170403587444,0.03909094694916911,651,"Unfortunately sir, your insurance constricts what I can do for you."
8408,3383,17,35,171,223,1.3094170403587444,0.04061156933679398,651,So just increase your fiber and Arnie will do the rest.
7251,3383,17,35,171,223,1.3094170403587444,0.04061156933679398,651,What Ralph won't do to avoid that prostate exam.
3714,3388,12,57,193,262,1.3091603053435115,0.034194802790026214,651,"Oh no, you'd be surprised how many of these I've seen"
3366,3388,18,45,199,262,1.3091603053435115,0.03667109644589873,651,"I understand, but we cannot jump to conclusions.  I advise we wait a week and do another round of tests."
2879,3388,15,51,196,262,1.3091603053435115,0.03545457553259657,651,Well it's a good thing the wait was only an hour.
6517,3388,12,57,193,262,1.3091603053435115,0.034194802790026214,651,You're too wrapped up in your work.
3618,3392,10,48,162,220,1.309090909090909,0.03728593757940303,651,Let's see if this works better than the weighted blanket.
647,3393,12,48,173,233,1.3090128755364807,0.036937050956174174,651,"Well, let's run some tests to see what's wrong."
3477,3393,10,52,171,233,1.3090128755364807,0.03592141975539256,651,I'm going to go out on a limb here and suggest your high blood pressure isn't work-related..
6947,3395,13,50,183,246,1.3089430894308942,0.03609445170967234,651,Can one of you squeeze my hand?
1267,3395,15,46,185,246,1.3089430894308942,0.0370023979606829,651,"Unfortunately, that boa virus keeps going around and around."
3154,3395,17,42,187,246,1.3089430894308942,0.0378885928144558,651,When did the tightness in your chest start?
7478,3395,15,46,185,246,1.3089430894308942,0.0370023979606829,651,Do you feel constricted from normal activities?
4044,3399,16,48,195,259,1.308880308880309,0.036142771759496525,651,"Good news, Ted. We have a handle on what's causing the tension in your shoulders."
2118,3400,13,41,163,217,1.3087557603686637,0.03927828710639025,651,Let’s give it a couple weeks and see if it clears up on its own.
9227,3401,9,53,168,230,1.308695652173913,0.03568809056474494,651,"Your cholesterol is still higher than I'd like it, and your Vitamin D is a little low, but your snake looks fine."
2410,3401,14,43,173,230,1.308695652173913,0.03825573433270596,651,I'm just saying that lowering your cholesterol intake certainly wouldn't hurt.
860,3401,15,41,174,230,1.308695652173913,0.03874885146130148,651,Just be sure to put a plastic bag over it when you shower
3629,3404,19,37,187,243,1.308641975308642,0.039088832249759814,651,"Give it to me straight. It's cancer, isn't it."
3854,3405,16,47,193,256,1.30859375,0.036426861854306034,651,"Of all the side effects, cottonmouth is actually quite treatable."
1328,3405,14,51,191,256,1.30859375,0.03557585915686049,651,When did you first notice the feeling of tightness in your chest?
8691,3405,18,43,195,256,1.30859375,0.03725843225843806,651,"Don't be a hypochondriac, Phil.  Squeezing chest pain doesn't necessarily signify heart attack."
5562,3405,20,39,197,256,1.30859375,0.03807184371895508,651,"My prescription was for ""snake oil"" not ""snake coil""."
9249,3405,12,55,189,256,1.30859375,0.03470399465399989,651,I'm glad you came in ... I heard that there's something nasty that's been going around.
2506,3405,17,45,194,256,1.30859375,0.03684499313956588,651,"Everything came back negative, but you still have to let me check that prostate."
4877,3405,13,53,190,256,1.30859375,0.03514263080429258,651,So you feel tightness in your chest?  We'll do some scans to see what's up.
5382,3412,16,38,173,227,1.3083700440528634,0.03959122561788251,651,You appear to have Asp Urgers Syndrome.
7799,3412,17,36,174,227,1.3083700440528634,0.040080543669282986,651,"So, let's start from the beginning. There was an old woman that swollowed a fly..."
4226,3412,14,42,171,227,1.3083700440528634,0.03859398238233038,651,Some patients have unexpected side effects....
6716,3415,12,50,178,240,1.3083333333333333,0.0362039717237316,651,"Well, we might try a muscle relaxant."
74,3415,9,56,175,240,1.3083333333333333,0.03472931122427431,651,"It says here you suffered ‘the fall of man.’ So, you fell?"
1990,3415,14,46,180,240,1.3083333333333333,0.03715457677791873,651,"Okay, the nurse wrote that you're experiencing some tightness in your chest. Anything else?"
5128,3415,12,50,178,240,1.3083333333333333,0.0362039717237316,651,Are you experiencing tightness in your chest?
5396,3415,14,46,180,240,1.3083333333333333,0.03715457677791873,651,Good news is we've found the cause for the constriction of your arteries.
7146,3415,14,46,180,240,1.3083333333333333,0.03715457677791873,651,This will have you pooping in no time.
8956,3421,14,50,189,253,1.308300395256917,0.03585260823237887,651,You say it started as a cute little snake skin belt.
5338,3421,19,40,194,253,1.308300395256917,0.03797706544744315,651,Describe your symptoms for me.
7067,3421,11,56,186,253,1.308300395256917,0.034515224572693674,651,"Well, your pressure looks good, but the snake’s is slightly elevated."
1212,3424,17,48,201,266,1.3082706766917294,0.03587501445432267,651,The good thing is that your cancer is in remission.
7769,3424,15,52,199,266,1.3082706766917294,0.03507521952060681,651,It's not hungry. I am referring you to an animal psychologist who's great with attachment issues.
2090,3424,15,52,199,266,1.3082706766917294,0.03507521952060681,651,There's nothing wrong with your snake that eating a medium size man wouldn't cure.
5921,3427,18,50,211,279,1.3082437275985663,0.035087854283193845,651,Has she done this before in the three years you've been together?
1007,3428,13,43,168,224,1.3080357142857142,0.03842301379583991,651,"Eyes are clear, nose is cold, I'm gonna say she just has a need for some warm male companionship."
7583,3428,13,43,168,224,1.3080357142857142,0.03842301379583991,651,"As your vet I must say, you seem tightly wound, have you been eating lately"
6762,3430,13,47,177,237,1.3080168776371308,0.036986433729025395,651,Your blood pressure has dropped off significantly since you got your emotional support animal.
6273,3430,14,45,178,237,1.3080168776371308,0.03746670502962843,651,"So, feeling any tightness in the chest?"
5276,3430,17,39,181,237,1.3080168776371308,0.03887193207359231,651,"The side effects should resolve in a few days.  Meanwhile, sleep in a dry warm place and eat plenty of live mice."
5983,3430,16,41,180,237,1.3080168776371308,0.038409235833955065,651,"Well Monty, what seems to be the problem?"
2540,3434,14,49,187,250,1.308,0.03613539910216978,651,I also can't help but notice you're slouching.
4590,3434,16,45,189,250,1.308,0.037013836553180246,651,"Do you have any constrictions, dietary  or otherwise?"
8699,3434,13,51,186,250,1.308,0.03568807299668711,651,I am writing a prescription for a muscle relaxer for both of you! Good Luck!
3486,3437,21,43,212,276,1.3079710144927537,0.03644666248685934,651,I'm glad it stopped your choking but next time have a person perform the Heimlich.
5509,3438,15,46,186,247,1.3076923076923077,0.036873506107693584,651,We need you to sign some release papers
7914,3438,16,40,178,234,1.3076923076923077,0.0387447844049985,651,At least try to say 'Aah.'
6689,3438,18,40,189,247,1.3076923076923077,0.03818902171311329,651,"Evidently, you left out ""feathered"" in you Amazon Prime order"
6397,3438,20,32,182,234,1.3076923076923077,0.04059418774964564,651,So when did your therapy snake first exhibit signs of anxiety and abandonment issues?
5879,3438,17,42,188,247,1.3076923076923077,0.037755609788407134,651,"Do you have any symptoms besides shortness of breath, tightness in the chest, and the snake around your torso?"
5736,3438,15,46,186,247,1.3076923076923077,0.036873506107693584,651,Any history of compression?
4501,3438,14,44,176,234,1.3076923076923077,0.03778615405618811,651,I'm prescribing an anti-constrictor medication.
1859,3438,9,50,162,221,1.3076923076923077,0.03658525008799156,651,Have you felt any unusual tightness in your chest or extremities?
1582,3438,16,44,187,247,1.3076923076923077,0.03731716443654703,651,How was your trip to the Everglades?
1011,3438,17,34,170,221,1.3076923076923077,0.04083580788994807,651,"Yes, this condition could be one causes of your ED"
514,3438,11,46,164,221,1.3076923076923077,0.03769285336117247,651,Sorry. Shortage on blood pressure cuffs.
892,3438,8,60,179,247,1.3076923076923077,0.033604289760429354,651,"Well, your vitals are fine but I'm going to write you a prescription for a mild muscle relaxer."
3181,3438,14,52,194,260,1.3076923076923077,0.03518895816480384,651,I call this nature's Heimlich Maneuver.
1297,3451,16,47,194,257,1.3073929961089494,0.03630470875586615,651,And what did your herpetologist recommend?
4094,3452,13,49,182,244,1.3073770491803278,0.03625775216479978,651,So you're feeling a bit constricted?
6142,3452,12,51,181,244,1.3073770491803278,0.03578956871243818,651,"Other than a tightness in your chest, what are your symptoms?"
7307,3452,12,51,181,244,1.3073770491803278,0.03578956871243818,651,Do you recall exactly when the tightness started?
2831,3452,11,53,180,244,1.3073770491803278,0.035315178963168575,651,Could you describe this 'tightening' feeling?
790,3452,13,49,182,244,1.3073770491803278,0.03625775216479978,651,"Sir, I'm sorry to say that you may have a bad case of Serpes."
1594,3452,19,37,188,244,1.3073770491803278,0.038948848154654075,651,"It's not legally required, but you really should notify previous partners."
8940,3458,17,37,177,231,1.3073593073593073,0.03956698836618516,651,Soo...is this considered a pre-existing condition?
526,3458,12,47,172,231,1.3073593073593073,0.03711238322781096,651,"My diagnosis was to make dietary restrictions, not constrictions."
3390,3458,16,39,176,231,1.3073593073593073,0.039088400484868224,651,Apply the snake oil twice a day for seven days and it should fall off on its own.
3547,3458,12,47,172,231,1.3073593073593073,0.03711238322781096,651,Normally I advise against fad diet plans
2700,3458,12,47,172,231,1.3073593073593073,0.03711238322781096,651,Have you tried removing the boa constrictor to ease the pain?
7786,3463,14,39,165,218,1.3073394495412844,0.03965997641643493,651,"So, you say your name is Caduceus?"
3967,3464,18,46,203,267,1.307116104868914,0.03615064885040556,651,"Yes, it only gets worse."
6578,3465,16,46,192,254,1.3070866141732282,0.03659243952761869,651,When did you first notice a shortness of breath?
6315,3465,16,46,192,254,1.3070866141732282,0.03659243952761869,651,"Since you're a lawyer, perhaps he would be willing to withdraw as a professional courtesy."
5987,3465,16,46,192,254,1.3070866141732282,0.03659243952761869,651,About time to shed this mortal coil.
6026,3465,16,46,192,254,1.3070866141732282,0.03659243952761869,651,"I’m sorry there is nothing I can do for you, but I will prescribe muscle relaxers for you emotional support reptile."
963,3469,18,38,185,241,1.3070539419087137,0.03884528135372589,651,When did the tightness in your chest begin?
1806,3469,14,46,181,241,1.3070539419087137,0.03702220005624676,651,"I'm not sure your airline will allow a snake on your flight as an ""emotional support animal"", but here is the note you asked for."
7709,3471,10,50,168,228,1.3070175438596492,0.036382516851595284,651,"Well, that got rid of the tapeworm!"
9004,3472,13,40,162,215,1.3069767441860465,0.03948691107362131,651,So you took a bite of the apple and then...
522,3473,14,34,154,202,1.306930693069307,0.04180850112959904,651,You might want to re-think your choice of a spirit animal.
1294,3474,16,53,208,277,1.3068592057761732,0.034484826494729476,651,Got your test results....your BOA is slightly elevated.
1309,3475,11,59,194,264,1.3068181818181819,0.03354890411799246,651,Perhaps we should have opted for more aggressive treatment last visit.
3778,3476,14,45,179,238,1.3067226890756303,0.03733138971199146,651,"'With the sudden increase of your blood pressure,I'm writing you a prescription for a feather boa."""
6490,3476,12,49,177,238,1.3067226890756303,0.0363691932286451,651,"It says here you, ""feel a slight tightening in your chest?"""
6092,3476,8,57,173,238,1.3067226890756303,0.034364070373726234,651,So it says here you've been feeling a little out of breath.
294,3476,10,53,175,238,1.3067226890756303,0.03538083908525159,651,This should help with the scaliness.
325,3476,18,37,183,238,1.3067226890756303,0.03918496575576782,651,Your Veterinarian will likely send you to a behaviorist for the attachment issues.
4189,3481,12,45,168,225,1.3066666666666666,0.037754427891266276,651,Honestly it's not as uncommon as you'd think.
5266,3481,19,31,175,225,1.3066666666666666,0.04126953601840712,651,"According to the lab results, you're in excellent health."
618,3483,18,44,199,261,1.3065134099616857,0.03671585142677081,651,"No no no - I recommended dietary ""re""strictions…"
3849,3483,20,40,201,261,1.3065134099616857,0.03750998043886189,651,I'm hoping that this clinical trial will help to relieve your constipation.
4711,3483,15,50,196,261,1.3065134099616857,0.035491356922440535,651,"On a scale of 1 to 10, how would you rank the pain?"
399,3486,14,48,186,248,1.3064516129032258,0.0362984841286131,651,Here's a prescription. He should be fine in a couple of days.
5100,3486,14,48,186,248,1.3064516129032258,0.0362984841286131,651,I think we can rule out COPD for your shortness of breath.
3764,3486,15,46,187,248,1.3064516129032258,0.036745473366195096,651,"How intense is the pain, on a scale of 1 to 10?"
4621,3486,14,48,186,248,1.3064516129032258,0.0362984841286131,651,Are you still having hallucinations about being choked by a snake?
3121,3490,23,26,186,235,1.3063829787234043,0.04176946958502957,651,"Difficulty breathing?  Hard to say, we'll have to run some tests."
1204,3490,14,44,177,235,1.3063829787234043,0.037647793390700214,651,Try not to exhale.
4307,3490,18,36,181,235,1.3063829787234043,0.03953273762002421,651,Consider wearing something less constricting
7592,3490,16,40,179,235,1.3063829787234043,0.038601772568902376,651,"Stiff, achey, hard to breathe... we'll run some tests."
5663,3490,12,48,175,235,1.3063829787234043,0.0366690039258832,651,Most men are aware of the fashion and health risks of wearing a boa.
4797,3490,14,44,177,235,1.3063829787234043,0.037647793390700214,651,These lab tests I'm ordering should help me identify your problem.
1618,3496,12,44,166,222,1.3063063063063063,0.03808723382821435,651,"No, I don't think your asthma is getting worse.  I believe there's a more obvious reason you're short of breath."
216,3496,13,42,167,222,1.3063063063063063,0.038618675887867715,651,"Well, the good news is, he's not venomous."
384,3496,11,46,165,222,1.3063063063063063,0.03754827071967464,651,Could you point to where you're experiencing tightness?
503,3499,12,55,191,258,1.306201550387597,0.034475808737436754,651,"Now if the snake doesn't help, then come back in three or four days."
5993,3499,18,43,197,258,1.306201550387597,0.037007573346743865,651,I don’t recommend the Everglades Diet
4946,3499,15,49,194,258,1.306201550387597,0.03576410122675353,651,Are you experiencing any dizziness or shortness of breath?
5048,3502,14,47,184,245,1.3061224489795917,0.03659129663919936,651,"Everything checks out OK, but your blood pressure seems a bit high."
6208,3503,17,37,178,232,1.3060344827586208,0.039418341384256386,651,So how did you two meet?
8523,3503,17,37,178,232,1.3060344827586208,0.039418341384256386,651,I'm gonna set you up with the herpetologist. I'll fast track it so you'll get in within a month or so.
7311,3505,18,46,204,268,1.3059701492537314,0.03603373238743175,651,"Roger, your pressure is up"
1530,3506,13,41,165,219,1.3059360730593608,0.03896956313171899,651,I prescribe a snake charmer for your congestion.
4165,3506,13,41,165,219,1.3059360730593608,0.03896956313171899,651,So you're experiencing some tightness around the chest.
5802,3508,11,56,188,255,1.3058823529411765,0.03428647542779654,651,"Yes, well that tightness in your chest could be a number of things, but my gut tells me it's stress."
6200,3508,15,48,192,255,1.3058823529411765,0.036042702032159535,651,we'll hold off on the prostate exam until your next visit
7563,3508,17,44,194,255,1.3058823529411765,0.03688947486801767,651,"Well, I guess that wraps it up for now."
9162,3508,14,50,191,255,1.3058823529411765,0.03561176598611057,651,I’m sorry. I don’t sign off on therapy animals.
320,3512,15,44,183,242,1.3057851239669422,0.037352616270148964,651,And how long have you been suffering from scaly skin?
1788,3512,16,42,184,242,1.3057851239669422,0.0378088656141603,651,Has this happened on other flights into LAX?
2518,3512,16,42,184,242,1.3057851239669422,0.0378088656141603,651,"Okay, you can get dressed now."
6635,3512,10,54,178,242,1.3057851239669422,0.034982224889246474,651,"So, you can breath now, it's not cancer."
8587,3516,17,36,176,229,1.3056768558951966,0.039775142737167535,651,And do you have a family history of respiratory problems?
6580,3516,17,36,176,229,1.3056768558951966,0.039775142737167535,651,"When your friend suggested a boa as a fashion statement, she didn't mean an actual reptile."
4172,3516,16,38,175,229,1.3056768558951966,0.03929066822222701,651,Let's run some tests
1340,3519,18,45,202,265,1.3056603773584905,0.036311007580311784,651,Does the snake have any known allergies?
6967,3519,18,45,202,265,1.3056603773584905,0.036311007580311784,651,Just give me a moment to update your hissssssstory!
2868,3521,16,45,191,252,1.3055555555555556,0.03675998847963885,651,Fart and the snake will let you go..
6428,3521,14,49,189,252,1.3055555555555556,0.0358895200017968,651,The only treatment option left is snake oil.
6735,3521,17,43,192,252,1.3055555555555556,0.03718758269308567,651,Do you want the good news or the bad news?
6860,3521,18,41,193,252,1.3055555555555556,0.03761031587326792,651,"So, when did you first notice this sense of pressure in your chest?"
7442,3521,11,44,161,216,1.3055555555555556,0.038218661573229354,651,"My advice? Lighten up and let your wife eat the apple. If the problem persists after that, you may have to move, no matter how nice your garden is."
7886,3521,16,45,191,252,1.3055555555555556,0.03675998847963885,651,Of course you're always encouraged to seek a second opinion.
8383,3527,17,50,208,275,1.3054545454545454,0.03500721665704421,651,Describe your pain on a scale of 1 to 10.
1572,3528,16,41,182,239,1.3054393305439331,0.03813054529391711,651,"If you think you're choked now, wait until you get my bill."
3639,3528,17,39,183,239,1.3054393305439331,0.03858884543659211,651,The CAT scan showed an actual cat.
2066,3530,10,49,167,226,1.3053097345132743,0.0365508033500981,651,"I hate to say it, Mr. Anderson, but we’re all feeling the squeeze."
8377,3530,12,45,169,226,1.3053097345132743,0.03761148706269846,651,"So, it only hurts when you breathe."
3243,3530,17,35,174,226,1.3053097345132743,0.04014076223606757,651,"Okay, so we’re feeling tightness in the chest, difficulty breathing...any history of heart disease in your family?"
4505,3533,17,42,190,249,1.3052208835341366,0.037492326124915085,651,Choking is largely psychosomatic
7118,3533,11,54,184,249,1.3052208835341366,0.03480443690681967,651,Your results show some arterial constriction.
6347,3533,15,46,188,249,1.3052208835341366,0.036618291717458964,651,"And tell me, how long have you been experiencing shortness of breath?"
2994,3533,17,42,190,249,1.3052208835341366,0.037492326124915085,651,"And on a scale of one to ten, how would you rate this pressure?"
433,3533,15,46,188,249,1.3052208835341366,0.036618291717458964,651,You are preaching to the choir. I have a wife and four kids.
5738,3533,15,46,188,249,1.3052208835341366,0.036618291717458964,651,I'm concerned about the weight gain. When did you notice your dog was missing?
610,3533,20,36,193,249,1.3052208835341366,0.03876644635745053,651,You're wrapped in a snake.
3861,3540,18,47,207,272,1.3051470588235294,0.03564820280794972,651,Your hangnail is doing much better
4701,3540,18,47,207,272,1.3051470588235294,0.03564820280794972,651,"You have only about five days to live.  But your snake has about fifty years."""
3302,3542,8,56,172,236,1.305084745762712,0.034505914006529054,651,As long as you feed it a piglet every two weeks you’ll be fine.
2088,3542,17,38,181,236,1.305084745762712,0.03892577990996553,651,It is listed as one of the side affects.
3115,3542,14,44,178,236,1.305084745762712,0.03751040204451795,651,"The tightness is normal, once you've passed out it will subside."
7454,3542,12,48,176,236,1.305084745762712,0.03653636829474951,651,"I think I might know what's causing your shortness of breath, but I'd like to run a few more tests."
56,3546,18,50,214,282,1.3049645390070923,0.03476513692305689,651,"Sir, for the fifth time, I know you can hear me; we just need you to sign these papers so we can proceed."
5850,3547,11,46,166,223,1.304932735426009,0.03740474212431475,651,I think your support animal is smothering you.
2772,3547,23,22,178,223,1.304932735426009,0.04340396820389088,651,It appears that the lump in your throat is a human.
3931,3549,11,53,182,246,1.3048780487804879,0.03507183988477071,651,"Does it feel like an elephant on your chest, or something less intense?"
3519,3550,12,47,174,233,1.3047210300429184,0.036840196359902655,651,I’m recommending ASPirin
6319,3550,10,51,172,233,1.3047210300429184,0.035821819213159516,651,The good news is you've lost several inches off your waist.
7113,3550,18,35,180,233,1.3047210300429184,0.039739049763725935,651,Have you been out of the country?
3660,3550,12,47,174,233,1.3047210300429184,0.036840196359902655,651,I'm prescribing a cream for her skin and don't let her eat anything bigger than your fist.
8668,3554,15,48,193,256,1.3046875,0.03592151178877605,651,For how long has he been your main squeeze ?
8082,3555,14,46,183,243,1.3045267489711934,0.03676014199632581,651,"On a positive note, you’ve lost 10 pounds."
5426,3555,16,42,185,243,1.3045267489711934,0.037673973902821935,651,"As your vet, my advice is let him go and find some rodents."
5595,3555,13,48,182,243,1.3045267489711934,0.03629459883467236,651,It appears you were simply too charming.
1136,3558,14,53,199,266,1.3045112781954886,0.03458908746782012,651,Do you feel constricted?
8321,3559,18,41,194,253,1.3043478260869565,0.03748082668372651,651,"I'm sorry, but we'll have to run few more tests."
2650,3559,13,44,173,230,1.3043478260869565,0.03765875885312668,651,"Unfortunately, you did not pick up the wrap around option to your health plan."
8942,3561,15,50,198,263,1.3041825095057034,0.03525934186650922,651,"I understand your need for an emotional support animal,  however I think there just might be a connection to your breathing issues."
8676,3562,16,41,183,240,1.3041666666666667,0.03799265723424989,651,"I'm sorry but HIPAA laws preclude me from discussing Eve's condition.""

John Canning
Sea Cliff, New York"
3939,3562,19,35,186,240,1.3041666666666667,0.039345196837472445,651,Get two asps and call me in the morning.
6015,3562,13,47,180,240,1.3041666666666667,0.03659015568782059,651,So do you want to start with the good news or the bad news?
5205,3562,17,39,184,240,1.3041666666666667,0.03844879071188002,651,Sometimes we have to go back to the ancient cures for constipation.
3253,3562,20,33,187,240,1.3041666666666667,0.039785826844068506,651,The diagnosis seems to be stupidity
3206,3562,16,41,183,240,1.3041666666666667,0.03799265723424989,651,I'm assuming you haven't tried diet and exercise?
9092,3562,15,43,182,240,1.3041666666666667,0.0375309805391819,651,"I never do this, but I think I’m going to have to recommend acupuncture."
881,3562,11,51,178,240,1.3041666666666667,0.035624492786360464,651,This is what happens when you consult one of those snake oil salesmen instead of trusting the medical establishment.
6794,3570,17,32,168,217,1.304147465437788,0.04129410169719601,651,There may be some swelling in your feet due to poor circulation.
1459,3571,13,57,203,273,1.304029304029304,0.03358667351918065,651,"So, that tight feeling in your chest now feels like it's spread up into your neck and down into your abdomen?"
5116,3571,16,51,206,273,1.304029304029304,0.03476875306181999,651,I'm afraid your still going to have to cough.
621,3573,16,44,190,250,1.304,0.03692954325006789,651,"Listen, I'm sorry I can't give you a better diagnosis than 'it's a snake,' but this isn't really what you'd call a typical case."
7636,3573,13,50,187,250,1.304,0.03560064075954195,651,I think you'll find a weighted blanket will serve the same purpose.
2697,3575,14,51,195,260,1.3038461538461539,0.03510689557778503,651,I understand you're feeling a lot of pressure.
4145,3576,11,50,176,237,1.3037974683544304,0.03591017340834324,651,How long have you been experiencing shortness of breath?
7745,3576,11,50,176,237,1.3037974683544304,0.03591017340834324,651,And what brings you to the Travel Clinic?
6455,3578,12,41,161,214,1.3037383177570094,0.03897940257778813,651,I see the gastric banding procedure seems to be working.
6163,3579,11,60,199,270,1.3037037037037038,0.03300046442963931,651,Blood pressure seems fine. How's your breathing?
8621,3579,13,56,201,270,1.3037037037037038,0.03382461106344766,651,That tightness in your chest could be something serious. I'd like to order a few tests.
6868,3581,19,37,191,247,1.3036437246963564,0.038534662202187805,651,It's a straight forward case of separation anxiety. She doesn't want you sitting under the apple tree with any one else but her.
1010,3581,13,49,185,247,1.3036437246963564,0.03588075163058428,651,Any difficulty with breathing?
1442,3581,14,47,186,247,1.3036437246963564,0.03633653322051859,651,I’m going to refer you to a veterinarian.
2977,3581,13,49,185,247,1.3036437246963564,0.03588075163058428,651,So where are you feeling this tightness?
4700,3581,16,43,188,247,1.3036437246963564,0.03723136130073945,651,So far we've determined that you don't have a frog in your throat.
6349,3581,18,39,190,247,1.3036437246963564,0.03810518182775864,651,so looks like you are reporting tightness in your chest....
2763,3587,12,44,168,224,1.3035714285714286,0.0377956906380136,651,"Let's take a 'wait-and-see' approach, but call me if the snake gets tighter."
6687,3587,11,46,167,224,1.3035714285714286,0.037262256962038755,651,Don't worry. Your snake is going to be fine.
3112,3589,18,42,197,257,1.3035019455252919,0.037052872674529225,651,"Good morning Mr. Pivnick, what seems to be the problem?"
7432,3589,14,50,193,257,1.3035019455252919,0.03537400235618773,651,"Try two rats a day to reduce squeezing, and maybe we'll see you in two weeks."
2798,3589,13,52,192,257,1.3035019455252919,0.03494168298766889,651,Any allergies?
9056,3589,15,48,194,257,1.3035019455252919,0.035801101594509624,651,So when did the 'tightness of the chest' start?
5772,3589,9,60,188,257,1.3035019455252919,0.03315608359368534,651,I have the test results. You're a little wound up.
1678,3594,6,59,169,234,1.3034188034188035,0.033573817488356056,651,Your blood pressure is a little too high.  I would recommend a lab test to find the cause.
5832,3594,11,49,174,234,1.3034188034188035,0.03620239524287068,651,Take one every day.  It'll help you unwind.
1406,3596,20,41,206,267,1.303370786516854,0.03684705671147266,651,"So, Monte, what brings you in today?"
4096,3597,16,42,186,244,1.3032786885245902,0.037540007004599175,651,Have you tried obedience training?
7279,3598,17,50,210,277,1.3032490974729243,0.03478884361532425,651,"He says your prostate's okay, so that's good..."
6890,3599,14,49,191,254,1.3031496062992125,0.03564682618806004,651,"My schedule is tight today but I can squeeze you in next Thursday."""
6799,3599,13,51,190,254,1.3031496062992125,0.03520757909019463,651,So how long has it been since you ate the apple from the tree?
3290,3599,16,45,193,254,1.3031496062992125,0.036509470018896026,651,"Just so I'm clear, which one of you is shedding skin?"
1027,3602,12,46,173,231,1.303030303030303,0.037013454802260745,651,"The bad news is that we can't use liposuction, but you're a perfect candidate for vip-o-suction."
1918,3602,13,44,174,231,1.303030303030303,0.03751852012411183,651,I want you take these twice a day with mice.
791,3602,14,42,175,231,1.303030303030303,0.03801687609743559,651,"Sure, laxatives work too."
6529,3605,18,37,186,241,1.3029045643153527,0.038758385253670966,651,"Two mice every four hours. As for you Mr. Deal, no more Ladies Night pole dancing."
2176,3605,17,39,185,241,1.3029045643153527,0.038309715228132896,651,Let’s get you on a less restrictive diet.
2097,3605,12,49,180,241,1.3029045643153527,0.0359825450434503,651,"I’d advise against self-medicating again, so I’m prescribing a standard back brace for you, and a muscle-relaxant for your snake."
2383,3605,15,43,183,241,1.3029045643153527,0.03739622959120283,651,A feeling of tightness around the chest... is that all?
3864,3605,15,43,183,241,1.3029045643153527,0.03739622959120283,651,I really can't help you if you won't get undressed.
4107,3605,14,45,182,241,1.3029045643153527,0.036931014622219795,651,I'm prescribing something warmer and less constricting...
4844,3605,16,41,184,241,1.3029045643153527,0.037855727892213295,651,How long has Monty been your therapy pet?
5728,3605,12,49,180,241,1.3029045643153527,0.0359825450434503,651,We're trying out a new colonoscopy regimen.
3480,3613,12,52,187,251,1.302788844621514,0.03502714890337269,651,The test results indicate you’re in a bit of a bind.
2944,3613,17,42,192,251,1.302788844621514,0.0372325624970917,651,You need to learn a new computer language. Python is killing you.
1812,3613,13,50,188,251,1.302788844621514,0.03547920053015854,651,And you say that your wife asked you to get her boa from her closet?
6704,3616,10,46,162,218,1.3027522935779816,0.03735719115205272,651,You have a severe case of anacondria.
8369,3617,18,43,200,261,1.3026819923371646,0.03663734109929208,651,"We need to run a few more tests."""
507,3617,18,43,200,261,1.3026819923371646,0.03663734109929208,651,Does anyone else in your family have a snake around the body?
5220,3617,18,43,200,261,1.3026819923371646,0.03663734109929208,651,I'll have to run a few tests.
8081,3617,17,45,199,261,1.3026819923371646,0.036232890024952884,651,Is this your wife’s boa?
6694,3621,14,41,173,228,1.3026315789473684,0.03834992627686202,651,"From now on, let's leave snake charming to the professionals."
7314,3621,15,39,174,228,1.3026315789473684,0.03885047886582633,651,I see your getting along fine with your comfort animal Jim
1761,3621,17,35,176,228,1.3026315789473684,0.03983271812757134,651,So this is the cure for a frog in your throat?
2014,3624,11,60,200,271,1.3025830258302582,0.03289755986210334,651,Oh I don't know about that; everybody feels like that in Trump's America these days.
4133,3625,13,46,179,238,1.3025210084033614,0.03675932358877812,651,"So tell me, how long have you felt this tightness in your chest?"
557,3625,11,50,177,238,1.3025210084033614,0.03578174714821011,651,"Yes, I know you’ve been waiting an hour but he hasn’t swallowed you yet, so - we’re good."
5710,3627,12,51,185,248,1.3024193548387097,0.03529723883903757,651,"Now finish the full course of antibiotic this time, okay?"
492,3627,20,35,193,248,1.3024193548387097,0.03882130822917576,651,"Sorry, it says here your condition is pre-existing."
5937,3629,13,39,163,215,1.302325581395349,0.03937924027234843,651,There are a couple of things I'm not going to be able to check today.
1763,3629,18,42,198,258,1.302325581395349,0.036927719279265844,651,"If you can make sure he gets 3 or 4 mice a day, that constriction in your chest should ease up quite a bit in a week or so."
8754,3629,16,46,196,258,1.302325581395349,0.036101663196176435,651,We'll need to take a few more tests to determine why you're having difficulty breathing.
4125,3632,10,48,167,225,1.3022222222222222,0.03658239474034296,651,"But on the bright side, you won't have to worry about the Heimlich maneuver."
1122,3632,10,48,167,225,1.3022222222222222,0.03658239474034296,651,I'll give you a little something for that chest congestion.
997,3634,11,49,175,235,1.3021276595744682,0.03607112857910867,651,And when did you first notice that tightness in your chest?
9167,3634,10,51,174,235,1.3021276595744682,0.0355634091143465,651,A sore throat can make you hard to swallow.
7000,3636,12,50,183,245,1.3020408163265307,0.035573253057392125,651,"I'm telling you, Mr. Johnson, you have to unwind!"
7656,3636,17,40,188,245,1.3020408163265307,0.03785150406324777,651,"Well Adam, it says this all started when you bit an apple?"
8415,3636,14,46,185,245,1.3020408163265307,0.03650162111182433,651,"Sorry, we’re out of paper gowns."
3915,3636,13,48,184,245,1.3020408163265307,0.036040426446397926,651,It’s probably just stress.
1797,3640,11,58,196,265,1.3018867924528301,0.0333581361276183,651,"With this new treatment, your movements will be somewhat constricted."
7181,3640,13,38,161,212,1.3018867924528301,0.03974996893672722,651,Would you describe the pain as a squeezing sensation?
8119,3640,13,38,161,212,1.3018867924528301,0.03974996893672722,651,I'm not a snake oil salesman. My approach is much more wholistic.
3853,3643,10,47,165,222,1.3018018018018018,0.03689336255409451,651,Are you experiencing any unusual pain?
213,3644,16,38,178,232,1.3017241379310345,0.03884800646205733,651,There is a lot of this going around
1200,3644,11,48,173,232,1.3017241379310345,0.036367191146620424,651,"Oh I'm sorry, there was a typo on your last prescription form."
4787,3644,15,40,177,232,1.3017241379310345,0.0383646791103458,651,I think you got it backwards when I told you to embrace your fear
4972,3644,12,46,174,232,1.3017241379310345,0.03687670802459286,651,You must cut your grass more often.
6344,3644,10,50,172,232,1.3017241379310345,0.03585043359652129,651,I'm writing you a prescription for Xanax. You seem wound up a bit tighter than usual.
7601,3644,19,32,181,232,1.3017241379310345,0.04026319180821089,651,It says here that the side effects may include tightness in chest.
2331,3650,16,41,185,242,1.3016528925619835,0.03771974784249559,651,I don't think that is what your wife had in mind when she asked you to wear a boa to bed.
8255,3650,18,37,187,242,1.3016528925619835,0.03861818394112705,651,My advice is that you ease up on the Viagra.
71,3650,14,45,183,242,1.3016528925619835,0.03679938346891396,651,"So, your symptoms are squeezing pain in your chest and numbness in your arms...We better do an ekg so we can rule out any heart issues, and we’ll take it from there."
7037,3650,13,47,182,242,1.3016528925619835,0.0363304589413283,651,I warned you herpetologists not to get wrapped up in your work!
6089,3650,15,43,184,242,1.3016528925619835,0.037262407336306314,651,Not exactly what I meant when I said get closer to nature.
5911,3650,13,47,182,242,1.3016528925619835,0.0363304589413283,651,What makes you think your pet overheard your plans for a homemade pair of boots?
7719,3656,17,42,193,252,1.3015873015873016,0.037103979878519815,651,"With the increase in your blood pressure and the weight gain, I'd say you need to find a way to unwind"
7366,3656,12,52,188,252,1.3015873015873016,0.03490855991252121,651,"Even though you are experiencing unbearable chest pressure, my gut tells me we can rule out heart disease."
6249,3656,12,52,188,252,1.3015873015873016,0.03490855991252121,651,I'm going to prescribe something to help lower your blood pressure.
732,3656,17,42,193,252,1.3015873015873016,0.037103979878519815,651,I'm referring you to a herpetologist.
8363,3656,14,48,190,252,1.3015873015873016,0.035802886227647775,651,That chest tightness could just be a winter cold.....let's wait for the lab results.
3398,3661,19,44,209,272,1.3014705882352942,0.03595261103058079,651,Are you sure you are just feeling a frog in your throat?
5897,3661,12,58,202,272,1.3014705882352942,0.0332063528567096,651,"Congestion, check.  Any trouble swallowing?"
3374,3663,14,38,167,219,1.3013698630136987,0.03939915415890738,651,"At this stage, you should just go to a vet."
2608,3664,17,35,177,229,1.3013100436681222,0.03968040730092587,651,"Yes, we're trialing some new approaches to measuring blood pressure."
9247,3664,14,41,174,229,1.3013100436681222,0.03820495533734565,651,"So, you say you've been feeling a bit constricted lately?"
6908,3664,9,51,169,229,1.3013100436681222,0.03561027604869016,651,"So,you tell me your inhaler isn't helping."
5608,3664,13,43,173,229,1.3013100436681222,0.03770030824695793,651,OK - I'm gonna put you in for an MRI and we'll see what's going on.
1723,3668,18,36,185,239,1.301255230125523,0.03895311400105803,651,"Concerning yes, but not as bad as it looks. I suggest a few mice twice a day until you feel things loosen up"
3254,3668,8,56,175,239,1.301255230125523,0.034142935040826654,651,You should start to see results in three to five weeks.”
3728,3668,14,44,181,239,1.301255230125523,0.037103949378853154,651,I am afraid we will have to do more tests.
6668,3668,17,38,184,239,1.301255230125523,0.038499150414803854,651,You might try switching to feather.
7585,3668,10,52,177,239,1.301255230125523,0.035157659601252916,651,"....and after we remove it, you can make a nice pair of shoes."
3676,3668,17,38,184,239,1.301255230125523,0.038499150414803854,651,Since I’ve been a veterinarian this is the worst case of separation anxiety I’ve seen.
4072,3674,16,43,190,249,1.3012048192771084,0.036971792448839295,651,"I just want to rule some things out.  First, could your sudden shortness of breath be connected to allergies?"
1369,3674,10,55,184,249,1.3012048192771084,0.03424306859824119,651,"Well, it’s not getting any worse."
6283,3676,15,48,196,259,1.3011583011583012,0.03556259328576546,651,"It may be a snake, Mr. Mowgli, but I'll make the diagnosis. You just tell me the symptoms."
879,3676,19,40,200,259,1.3011583011583012,0.0372077826692532,651,"We'll run a few tests, but I'm pretty sure it's just a cold."
7404,3678,18,45,206,269,1.3011152416356877,0.03584137155333544,651,You seem to have a rare case of a pain in the asp.
6378,3678,19,43,207,269,1.3011152416356877,0.03622631976988839,651,How long have you noticed the tightness in your chest?
2103,3680,21,42,216,279,1.3010752688172043,0.03603388621661753,651,I am not sure your insurance will cover this.....
8114,3681,15,38,173,226,1.3008849557522124,0.03904963007285643,651,"As your doctor, I must to warn you, some of these fad diets can kill you."
3810,3681,14,40,172,226,1.3008849557522124,0.038542732675070385,651,The good news is the TB test came back negative.
9045,3683,15,41,180,236,1.3008474576271187,0.03789441708917781,651,So you first noticed the symptoms as you were eating an apple?
1989,3683,18,35,183,236,1.3008474576271187,0.03929596578004249,651,"Python death grips are very rare, sir.  Delusional disorder though-- very common. With that code you should have coverage."
3035,3683,10,51,175,236,1.3008474576271187,0.03543552896598374,651,I'm afraid your insurance doesn't cover pythonectomy.
3410,3683,15,41,180,236,1.3008474576271187,0.03789441708917781,651,Great news! The snake is not poisonous so you can go home now.
5065,3683,16,39,181,236,1.3008474576271187,0.03836728910431999,651,Just don't let this pressure consume you.
6568,3683,16,39,181,236,1.3008474576271187,0.03836728910431999,651,I did all the tests on your snake and I think he's doing fine.
8311,3689,12,50,184,246,1.3008130081300813,0.03544962035314221,651,Yeah - I would avoid the jungle and I'll fill out a script for some mice.
2682,3689,16,42,188,246,1.3008130081300813,0.03727481193003766,651,Next time use SPANX.
5323,3689,13,48,185,246,1.3008130081300813,0.03591461524910653,651,I'm going to recommend you see a snake oil salesman.
452,3689,13,48,185,246,1.3008130081300813,0.03591461524910653,651,I'm prescribing you some snake oil.
918,3693,20,37,199,256,1.30078125,0.037914345655232676,651,I have ordered further testing to see what is causing your shortness of breath.
7256,3693,14,49,193,256,1.30078125,0.0354072602308156,651,Your chronic herpetology has become acute.
6358,3693,15,47,194,256,1.30078125,0.03583728968483327,651,"This tightness in your chest, would you describe it as constricting?"
3325,3696,19,42,205,266,1.300751879699248,0.03650574157032144,651,"It looks like you have an acute reptilian constriction, but am MRI will tell us for sure."
941,3697,19,45,212,276,1.3007246376811594,0.03557171958390974,651,Any chest tightness?
8430,3698,16,32,165,213,1.300469483568075,0.04123233268290561,651,On any medications at the moment?  Allergies?  How often do you drink alcohol each week?  Ever to excess? Smoke?  Under unusual amount of stress?
3795,3699,17,33,173,223,1.3004484304932735,0.040417056586978035,651,"You want a holistic remedy for constipation, you get Sally."
3095,3700,12,46,175,233,1.3004291845493563,0.036740925543141026,651,And when did you first notice this constrictive feeling in your chest?
6615,3700,12,46,175,233,1.3004291845493563,0.036740925543141026,651,any history of hypertension ?
4427,3700,13,44,176,233,1.3004291845493563,0.03724102949455859,651,"The directions clearly state, “Counter-clockwise only.”"
8158,3703,14,45,184,243,1.300411522633745,0.0366686513009139,651,Let me get this right. You are wondering what's causing you a stomach ache?
1753,3703,11,51,181,243,1.300411522633745,0.03524995862646234,651,"Yes, I'm aware you love him, but he just doesn't qualify as an emotional support animal."
38,3703,16,41,186,243,1.300411522633745,0.037584707771492476,651,"You’re suffering from moderate anxiety. Coincidentally, the snake’s blood sugar is low."
8884,3703,16,41,186,243,1.300411522633745,0.037584707771492476,651,I'm prescribing muscle relaxers
8718,3703,11,51,181,243,1.300411522633745,0.03524995862646234,651,"Weight, good. Blood pressure is a little elevated. Let's keep an eye on this. Overall, great shape! How's the family?"
569,3708,14,48,191,253,1.300395256916996,0.0356810097605211,651,High blood pressure is the real threat here though.
3324,3708,14,48,191,253,1.300395256916996,0.0356810097605211,651,You should have listened to your ex-wife when she said 'It's him or me!'
2373,3708,17,42,194,253,1.300395256916996,0.036976252477656055,651,Tightness in the chest could be a heart attack so I'm sending you to the E.R.
2973,3708,16,44,193,253,1.300395256916996,0.036549605342662425,651,Can you describe this feeling of being “constricted”?
3953,3712,15,49,199,263,1.3003802281368821,0.03517786798509724,651,Well that just about wraps it up. I’d caution you on exhaling.
2350,3712,9,61,193,263,1.3003802281368821,0.03260877342488047,651,"As soon as you get home, give the boa a muscle relaxer as prescribed."
3139,3712,15,49,199,263,1.3003802281368821,0.03517786798509724,651,"You need an Expectorant, not a Constrictor"""
3235,3712,16,47,200,263,1.3003802281368821,0.03558802389279132,651,You will be pleased to learn the technique works. You already lost 10 pounds.
4018,3716,16,50,207,273,1.3003663003663004,0.03469205405646815,651,"So, Mr......Mowgli? What seems to be the problem?"
8403,3717,17,47,206,270,1.3,0.03533829740755986,651,"I see you're a hypochondriac, Mr. Jones.  What's your complaint today?"
6986,3717,17,44,199,260,1.3,0.03627273515619295,651,"Well, Bill... according to this chart, you've got 20 minutes left. So I'll just give you the bill now."
6554,3717,10,46,164,220,1.3,0.0370676963640869,651,Any other symptoms in addition to the tightness in your chest?
6186,3717,12,51,187,250,1.3,0.03505589340825024,651,"It's one of the toughest cases I've yet to unwind""."
5768,3717,18,36,186,240,1.3,0.03881077364118905,651,Is there a hisstory of this in your family?
5543,3717,15,48,197,260,1.3,0.03544448132377249,651,Tell me when you first started feeling constricted?
4764,3717,16,46,198,260,1.3,0.035860999512162046,651,I think it may be something that ate you.
3909,3717,14,35,161,210,1.3,0.04053076882678875,651,One tropical medicine class and you interns obsess over every little symptom.
3839,3717,15,39,176,230,1.3,0.03855664367157769,651,I'm prescribing Xanax. You seem a little tightly wrapped.
3832,3717,19,40,201,260,1.3,0.03708249418676386,651,A triple dosage of Viagra should bust you right out of there.
4774,3717,14,47,189,250,1.3,0.035960710376229395,651,So you’re feeling a moderate tightening of the chest... any other symptoms?
3663,3717,11,50,179,240,1.3,0.03552750520681634,651,"I’m going to prescribe a muscle relaxant. And lay off the humans for a while, OK?"
3460,3717,12,51,187,250,1.3,0.03505589340825024,651,"I’m afraid that procedure is only covered  once your deductible is met, but try feeding it two whole rats and call me in the morning."
3414,3717,14,47,189,250,1.3,0.035960710376229395,651,"Yes, constriction of the chest is a common symptom of an anxiety disorder."
2954,3717,13,49,188,250,1.3,0.03551118382575871,651,"You say you're gripped by fear, but I think it's a reptile."
3674,3717,13,49,188,250,1.3,0.03551118382575871,651,"Try as you might, Adam, things will never be as they were."
2319,3717,11,53,186,250,1.3,0.03459461155432125,651,"Yes, I can give you something that will reduce the ""hissing"" in the 
middle of the night."
1356,3717,17,41,192,250,1.3,0.03727677873598693,651,Let's see: difficulty breathing and chest pain. Have you tried aspirin?
2809,3717,18,48,214,280,1.3,0.034835580447734306,651,Now -- what type of insurance do you have?
7019,3717,11,50,179,240,1.3,0.03552750520681634,651,"With a high level of confidence, I can say that the pain in your chest is not a heart attack.m"
763,3717,20,35,195,250,1.3,0.03854794125631616,651,You say you're feeling constricted.”
5935,3738,20,49,228,297,1.2996632996632997,0.03411751062149609,651,So your naturopath prescribed this for bloating?
5303,3739,15,53,209,277,1.2996389891696751,0.03395215700584754,651,Experiencing any shortness of breath?
2444,3740,18,44,205,267,1.299625468164794,0.035997154632018157,651,There's a lot of that going around now.
9066,3740,14,52,201,267,1.299625468164794,0.03439700551146879,651,It sounds like it’s crunch time.
1414,3742,16,45,196,257,1.2996108949416343,0.03613980153357962,651,So when did you start feeling constricted?
3958,3742,16,45,196,257,1.2996108949416343,0.03613980153357962,651,We still gotta do a blood test to know for sure.
4682,3742,19,39,199,257,1.2996108949416343,0.037380232114594986,651,He'll be okay; just a sniffle.
8794,3742,19,39,199,257,1.2996108949416343,0.037380232114594986,651,"Oh boy, yeah, you're definitely constricted.."
3944,3746,14,46,187,247,1.2995951417004048,0.036246570718452796,651,It's a difficult diagnosis. Have you visited a tropical country recently?
4827,3746,13,48,186,247,1.2995951417004048,0.03578964347318405,651,Has anything been causing you stress lately?
4629,3746,16,42,189,247,1.2995951417004048,0.037143566154425024,651,"So, your pet's name is Monty?"
3315,3746,14,46,187,247,1.2995951417004048,0.036246570718452796,651,"When my patients tell me they have a pressing feeling, it's not usually so easy to diagnose."
2945,3746,14,46,187,247,1.2995951417004048,0.036246570718452796,651,All your tests have come back negative. So I think we are good to go.
225,3746,13,48,186,247,1.2995951417004048,0.03578964347318405,651,I think I finally found out why you are having trouble breathing.
3152,3746,11,52,184,247,1.2995951417004048,0.03485782497685817,651,Can I assume your occupation is charming?
1647,3753,13,45,179,237,1.2995780590717299,0.03679626034245388,651,"So, I hear you're having a little tightness in your chest?"
2441,3753,14,43,180,237,1.2995780590717299,0.03727898175883082,651,I'm prescribing you two tubs of Vaseline every four hours
3797,3755,17,34,176,227,1.2995594713656389,0.039889411849700566,651,Was this your first attempt at drag?
8785,3756,12,41,164,217,1.2995391705069124,0.03851494023367433,651,Perhaps you should have eaten the  apple
4311,3756,12,41,164,217,1.2995391705069124,0.03851494023367433,651,You're a little wound up .
282,3758,13,56,205,274,1.2992700729927007,0.03340274863953572,651,It seems your breathing is constricted.
4821,3759,16,47,201,264,1.2992424242424243,0.03547121775366606,651,Any experience of tightness in your chest?
4581,3759,13,53,198,264,1.2992424242424243,0.03423144465652837,651,"I understand you’re feeling constricted, but I really don’t think it’s the medication."
8030,3759,15,49,200,264,1.2992424242424243,0.03506283113273919,651,"Yes, Monty, python can be hazardous."
3620,3762,13,50,191,254,1.2992125984251968,0.035119593761619994,651,Your condition is deteriorating. We need to order you another PET.
7223,3762,13,50,191,254,1.2992125984251968,0.035119593761619994,651,I’m sorry Mrs Miller but our insurance company considers this a preexisting condition
8375,3764,16,41,187,244,1.2991803278688525,0.037450598475976676,651,So what other symptoms are you feeling besides shortness of breath?
5894,3764,11,51,182,244,1.2991803278688525,0.035126777664629,651,We'll have to run a few tests to rule out anything more serious.
5599,3764,18,37,189,244,1.2991803278688525,0.03834071012712526,651,Next time swipe left.
7456,3764,14,45,185,244,1.2991803278688525,0.036538809495732176,651,So.....I understand you are feeling a little constricted.
4923,3764,14,45,185,244,1.2991803278688525,0.036538809495732176,651,I’d suggest more quality time to resolve his separation anxiety
629,3764,15,43,186,244,1.2991803278688525,0.03699751292704845,651,When did this feeling of tightness in you chest start?
896,3764,14,45,185,244,1.2991803278688525,0.036538809495732176,651,But it’s my support animal
2952,3771,14,42,178,234,1.2991452991452992,0.03759483052781287,651,The good news is that it's not psoriasis...
7567,3771,15,40,179,234,1.2991452991452992,0.038079570934175286,651,"Besides tightness in your chest, what other symptoms do you have?"
8772,3773,14,39,171,224,1.2991071428571428,0.038738056741787576,651,"Yes, we can remove him, but we can't promise there won't be some scarring of your scales."
8682,3773,10,47,167,224,1.2991071428571428,0.036612611113279805,651,.... And how long have you felt constricted?
3631,3773,16,35,173,224,1.2991071428571428,0.03975819304154554,651,This isnt the first holistic colon screening Ive seen go sideways.
8249,3776,13,52,196,261,1.2988505747126438,0.034482758620689655,651,"So, any tightening of the chest—I mean, other than the obvious?"
3498,3776,18,42,201,261,1.2988505747126438,0.036557117753188366,651,"Well, we've cancelled the MRI."
8282,3778,17,41,193,251,1.298804780876494,0.03714720183984369,651,New York Fashion week is always a busy time of year.
8789,3778,16,43,192,251,1.298804780876494,0.03671569275623064,651,well Mr. Smith I do not think I will be asking you to bend over”.
8640,3780,11,50,180,241,1.2987551867219918,0.035401673229208716,651,Your blood seems to be running cold.
8703,3780,11,50,180,241,1.2987551867219918,0.035401673229208716,651,"Good news is, we finally got your blood pressure down!"
2513,3780,11,50,180,241,1.2987551867219918,0.035401673229208716,651,"Yes, I see the problem. We’ll have to lower your dosage of Adder-all."
7939,3780,14,44,183,241,1.2987551867219918,0.03683765610434109,651,"If it's still bothering you in a week, then give us a call."
6904,3780,18,36,187,241,1.2987551867219918,0.038669438756039176,651,A steady diet of rats will keep it from crushing you.
4271,3780,18,36,187,241,1.2987551867219918,0.038669438756039176,651,It says here that you're feeling a little wound up lately....
2678,3780,10,52,179,241,1.2987551867219918,0.034909888582124286,651,You better increase his rations by one rat.
6830,3787,11,47,173,231,1.2987012987012987,0.036398574272935434,651,Blood tests are negative.
5927,3787,10,49,172,231,1.2987012987012987,0.035877746489962434,651,"Ok, so for the good news first, I’m pretty sure it’s not your asthma acting up"
5750,3787,12,45,174,231,1.2987012987012987,0.036912053925605155,651,"And you say the tightness in your chest started a week ago on your trip to the Brazilian rainforest?"""
8720,3787,15,39,177,231,1.2987012987012987,0.03841133000456947,651,Nice boa.  You get it at Saks?
6719,3787,16,37,178,231,1.2987012987012987,0.038898249171708546,651,"I'm afraid Mr. Asclepius, that we regard this is as a pre-existing condition..."
4578,3787,14,41,176,231,1.2987012987012987,0.037918158668579276,651,"Oh, so that's what you meant about feeling wound up."
594,3793,13,40,168,221,1.2986425339366516,0.03855941281640326,651,Your insurance doesn't cover pre-existing conditions.
1758,3793,13,40,168,221,1.2986425339366516,0.03855941281640326,651,Just exactly how long have you been short of breath?
183,3795,12,56,200,268,1.2985074626865671,0.0334615322888794,651,Your oxygen level is a bit low. We'll run some tests to figure out why.
7525,3796,10,54,184,248,1.2983870967741935,0.03426482944087249,651,Think you have a problem ? My salary is being squeezed by the limits on Medicare.
1448,3796,14,46,188,248,1.2983870967741935,0.03612032652253279,651,One reptile aquarium and one a box of generic mice.
4146,3796,15,44,189,248,1.2983870967741935,0.036569493446928704,651,I understand you're having trouble scratching your nose?
4251,3796,16,42,190,248,1.2983870967741935,0.0370132099909686,651,It's your call. I can prescribe something that will get him to relax or motivate him to finish the job.
5119,3796,17,40,191,248,1.2983870967741935,0.0374516698787399,651,You should have kept your pants on.
2584,3796,18,38,192,248,1.2983870967741935,0.03788505562324925,651,If you’ll just sign here so we can verify your insurance....
8381,3802,13,45,180,238,1.2983193277310925,0.036662942114945606,651,Sorry we kept you waiting.
994,3802,12,47,179,238,1.2983193277310925,0.036176153798611915,651,Call me back if you have difficulty breathing.
2393,3802,17,37,184,238,1.2983193277310925,0.03854867323236907,651,Tightness in the chest can have many causes.  Have you been stressed at work?
4002,3805,19,30,179,228,1.2982456140350878,0.04069667719665089,651,"Yes, Eve said the same thing"
3345,3805,15,38,175,228,1.2982456140350878,0.03875110429646283,651,Are you experiencing any symptoms besides tightness in your chest?
815,3807,9,47,162,218,1.298165137614679,0.03667213659093865,651,That rattling in your lungs is textbook pneumonia.
4730,3807,14,37,167,218,1.298165137614679,0.039449147999325654,651,Tightness in the chest may indicate something more serious. When did you first notice these symptoms.
3553,3809,21,37,207,265,1.2981132075471697,0.03732191497484501,651,"I'm sorry, your insurance only has venomous coverage."""
5443,3810,19,38,198,255,1.2980392156862746,0.037554760512820265,651,Did this happen before or after he suggested to your wife she should eat the apple?
6074,3811,9,41,148,198,1.297979797979798,0.03902992011764675,651,You  say she's an old squeeze who just can't let go?
2907,3812,12,49,184,245,1.2979591836734694,0.03547908020248927,651,"Trust me, your blood pressure is not where it should be for a man your age."
4355,3812,16,41,188,245,1.2979591836734694,0.03731741086177483,651,"When you said you were tied up, I thought you were kidding"
5272,3812,14,45,186,245,1.2979591836734694,0.03640984952894736,651,"Well, Adam, we can take care of it this time, but next time choose a fig-leaf."
9194,3815,15,40,180,235,1.297872340425532,0.037938545882626754,651,"Um … since your holistic approach isn't working, let's try milk of magnesia."
9192,3815,14,42,179,235,1.297872340425532,0.037456147887255695,651,I’m going to have to run some tests.
8876,3815,18,34,183,235,1.297872340425532,0.03935027332937848,651,Wow! You've got the biggest asp I've ever treated!
3961,3815,12,46,177,235,1.297872340425532,0.03647221567549133,651,We may be overlooking an underlying cause.
3513,3815,13,44,178,235,1.297872340425532,0.03696745549014379,651,"And here I was, thinking it was worms."
2355,3815,10,50,175,235,1.297872340425532,0.03546099290780142,651,Now please shed your skin and step on the scale.
1372,3815,16,38,181,235,1.297872340425532,0.03841488660434106,651,"As a matter of fact,yes, I do research with lab rats. I just  came from the lab.
Why do you ask?"
2560,3815,19,32,184,235,1.297872340425532,0.03980972569904247,651,"As a fashion statement, I suggest a turtle neck."
868,3815,12,46,177,235,1.297872340425532,0.03647221567549133,651,"He seems to have a crush on you, but I think you're a little too big to swallow."
78,3815,8,54,173,235,1.297872340425532,0.03442007437142938,651,You may feel a little pressure.
4702,3825,12,43,170,225,1.2977777777777777,0.037545974169900596,651,"Yes, it is serious but I think we caught it in time."
2084,3826,17,44,201,262,1.297709923664122,0.036031580304547464,651,Occupation ... ?
4219,3827,12,40,163,215,1.2976744186046512,0.038711264395182576,651,"The tests came back, and we can rule out COPD."
1802,3828,19,37,196,252,1.2976190476190477,0.03786301588279985,651,I'm prescribing antidepressants.
4130,3828,15,45,192,252,1.2976190476190477,0.03615424950975386,651,"Any tingling, fever or shortness of breath?"
5814,3828,14,47,191,252,1.2976190476190477,0.03571428571428572,651,So the pain is...where?
6507,3828,14,47,191,252,1.2976190476190477,0.03571428571428572,651,That means it likes you.
6840,3828,18,39,195,252,1.2976190476190477,0.03744313579562013,651,"So, how long have you been experiencing this tightness in your chest?"
5516,3833,16,40,186,242,1.2975206611570247,0.03762853613332421,651,When did you first notice breathing difficulties?
5524,3833,13,46,183,242,1.2975206611570247,0.03623575031820062,651,"the good news is, it appears to be growing slowly."
915,3833,13,46,183,242,1.2975206611570247,0.03623575031820062,651,"Call me old-fashioned, but I don't consider this new 'cuddle therapy' trend to be medically viable."
959,3836,15,39,178,232,1.2974137931034482,0.03826707092129565,651,You were supposed to use the fig leaf.
1424,3836,16,37,179,232,1.2974137931034482,0.038751615704789855,651,Do you feel safe at home?
3326,3836,12,45,175,232,1.2974137931034482,0.03677515069155718,651,A prescription for snake oil should take care of it
7167,3839,17,46,206,269,1.2973977695167287,0.035373612954602035,651,"Rest assured, your pet python's health is not in danger if he swallows you."
8773,3840,21,35,203,259,1.2972972972972974,0.03792453627230922,651,What brought you here today and why does it concern you?
7124,3840,12,53,194,259,1.2972972972972974,0.03418915162846366,651,Looks like you may be living with some constrictions
4623,3840,14,49,196,259,1.2972972972972974,0.035053653362394105,651,I don’t see a medical code that I can submit to ensure that your insurance will cover this.
2499,3840,11,55,193,259,1.2972972972972974,0.03374859740175401,651,"Everything came back normal, but your pressure’s a little high.”"
2212,3840,14,49,196,259,1.2972972972972974,0.035053653362394105,651,Uh-uh... and when did the chest tightness start?
578,3840,14,49,196,259,1.2972972972972974,0.035053653362394105,651,I notice you're scheduled for your flu shot .
146,3840,16,45,198,259,1.2972972972972974,0.035897341670765644,651,"I see , you are suffering from the Full Monty."
2239,3840,14,38,170,222,1.2972972972972974,0.03893594579958669,651,We’ll need to wait for the tests to confirm...but I’ve got a pretty good idea about what’s restricting your breathing
3318,3848,16,42,191,249,1.2971887550200802,0.03688373489407314,651,I am prescribing a generic snake charmer.
2501,3848,15,44,190,249,1.2971887550200802,0.03644204007407153,651,Are you having difficulty focusing or concentrating?
2869,3848,16,42,191,249,1.2971887550200802,0.03688373489407314,651,"well,at least that nasty worm is no longer in your colon"
6660,3851,17,48,211,276,1.2971014492753623,0.03474690745746987,651,"We can book you a week from Tuesday--unless, of course, you've been swallowed by then."
245,3852,14,43,182,239,1.297071129707113,0.03700866837574598,651,"Let's have you stand on the scales."""
7347,3852,11,49,179,239,1.297071129707113,0.03555502793969857,651,"So, when did this feeling  of pressure in yor chest start?"
1675,3852,16,39,184,239,1.297071129707113,0.03794683847676119,651,Just take two asps and call me in the morning.
1631,3855,12,44,173,229,1.296943231441048,0.03708521731024571,651,"We'll run a blood test and x-rays, but back pain is often entirely psychological."
2315,3855,18,32,179,229,1.296943231441048,0.0400642679382232,651,And are you having any trouble breathing?
1819,3855,12,44,173,229,1.296943231441048,0.03708521731024571,651,Some snake oil should do the trick.
7878,3858,16,44,196,256,1.296875,0.036177136880122744,651,Please describe your symptoms in detail.
4936,3858,14,48,194,256,1.296875,0.03532011782312193,651,"Before we try and unravel what’s ailing you, Adam, tell me a little about your family’s history ...."
8672,3860,9,47,163,219,1.2968036529680365,0.0365296803652968,651,"You know, the lap band does this from the inside."
3316,3861,13,47,186,246,1.2967479674796747,0.03582153429335919,651,The parts of you that I can see look pretty healthy
5575,3861,11,51,184,246,1.2967479674796747,0.034882865543292556,651,"Alright now, take a deep breath"
8246,3861,10,53,183,246,1.2967479674796747,0.034403928601280206,651,"First we will  find you a snake charmer, THEN we can worry about your shoes."
7443,3864,19,43,211,273,1.2967032967032968,0.0357619061633588,651,"I'm fairly certin that you have Calabar Python, but I am refering you to a herpetologist for a second opinion"
2820,3865,12,46,178,236,1.2966101694915255,0.036339269662093464,651,"As I’ve said before, the tightness in your chest is just anxiety."
49,3865,11,48,177,236,1.2966101694915255,0.03583964973166516,651,"Not to worry, it's just something that's going around this season....around and around and around."
8432,3865,12,46,178,236,1.2966101694915255,0.036339269662093464,651,I’ll describe her as an emotional support boa.
6498,3868,12,43,171,226,1.2964601769911503,0.037402687408795335,651,And how long have you been feeling this pressure?
3543,3868,14,39,173,226,1.2964601769911503,0.038439871994194345,651,So your chief complaint is entanglement?
5097,3868,14,39,173,226,1.2964601769911503,0.038439871994194345,651,And where’s the apple?
6101,3871,11,53,189,253,1.2964426877470356,0.034244739044879624,651,I want to run some tests to make sure your chest pains aren't something serious.
4481,3871,14,47,192,253,1.2964426877470356,0.03559228767602423,651,It’s my homeopathic cure for that frog in your throat.
1050,3871,17,41,195,253,1.2964426877470356,0.03689064558629775,651,I'm referring you to a Pet Psychiatrist for Snuggles. I think we may have a case of separation anxiety.
1917,3871,9,57,187,253,1.2964426877470356,0.033316106601431195,651,My prescription may seem somewhat cold-blooded.
6238,3875,15,53,212,280,1.2964285714285715,0.033638470605890904,651,It started when she offered you an apple
7863,3876,11,42,163,216,1.2962962962962963,0.037993674684649835,651,"With this condition,having constricting chest pain is to be expected."
5053,3876,14,44,185,243,1.2962962962962963,0.03657501848888962,651,You're the third one today.
6251,3876,15,42,186,243,1.2962962962962963,0.03703703703703704,651,"So, it says here you've been feeling some tightness in your chest---"
2889,3876,15,42,186,243,1.2962962962962963,0.03703703703703704,651,"Well Mr. Houdini, you can't expect every trick to work every time."
70,3876,15,42,186,243,1.2962962962962963,0.03703703703703704,651,"So, how long have you felt this pressure?"
26,3876,12,48,183,243,1.2962962962962963,0.0356330142904322,651,Gained some weight...any other issues?
7877,3876,16,40,187,243,1.2962962962962963,0.037493362712660086,651,We’ll need to run some tests.
1198,3876,11,42,163,216,1.2962962962962963,0.037993674684649835,651,"Yes, feeling hugged all the time can lower your blood pressure, technically."
8901,3876,15,42,186,243,1.2962962962962963,0.03703703703703704,651,This prescription will relieve shedding skin.
6282,3885,12,53,195,260,1.2961538461538462,0.034076590877454724,651,Well.  It is not Elephantiasis.
9226,3885,17,43,200,260,1.2961538461538462,0.036189973671302646,651,"To complete our diagnosis, we need to know how you took your shirt off in that condition."
3463,3887,17,35,181,233,1.296137339055794,0.0390822939368981,651,It's our homeopathic remedy for constipation.
4981,3887,12,45,176,233,1.296137339055794,0.036639218866268836,651,You seem a bit wound-up today. What seems to be the problem?
6863,3887,15,39,179,233,1.296137339055794,0.038123855566747196,651,"It's very simple...
You're not feeding him enough."
7581,3887,12,45,176,233,1.296137339055794,0.036639218866268836,651,"Once you are down to your desired weight, I’d advise stop feeding the snake"
1045,3891,17,40,193,250,1.296,0.03718962587997316,651,Do you remember what you were doing when you first noticed the tightness?
3875,3891,16,42,192,250,1.296,0.03675513241761135,651,Take two asps around and call me in the morning.
7625,3891,21,32,197,250,1.296,0.03887907315404097,651,"Your breathing is labored? Let's order a battery of tests."""
3719,3894,12,42,169,223,1.295964125560538,0.03772784716790915,651,"So, other than feeling chest compression, what other complaints do you have?"
440,3895,17,45,205,267,1.2958801498127341,0.03552378800213912,651,I'm going to prescribe you an antidepressant.
4364,3895,12,55,200,267,1.2958801498127341,0.033483399950037324,651,"Well, it’s one way to stop smoking."
6984,3895,16,47,204,267,1.2958801498127341,0.0351251936031614,651,I'm a hamster man myself.
8170,3898,9,53,178,240,1.2958333333333334,0.03442996482596588,651,Cramping is common with your condition.
4067,3898,13,45,182,240,1.2958333333333334,0.03639907267863083,651,Have you tried putting mice in it?
4038,3898,13,45,182,240,1.2958333333333334,0.03639907267863083,651,The good news isn’t that the tightening in your chest is not due to a heart attack . . .
3750,3901,11,54,192,257,1.2957198443579767,0.033881268495852365,651,"Fortunately, the duration of symptoms should be short."
5370,3901,7,62,188,257,1.2957198443579767,0.03203662004876199,651,"I swear, I thought it would be like sleeping with my dog"
8952,3903,10,53,184,247,1.2955465587044535,0.03428541432167757,651,Did you contract anything else on your trip to the Amazon?
3601,3903,20,33,194,247,1.2955465587044535,0.03878972446809637,651,Any family hissstory?
4834,3903,13,47,187,247,1.2955465587044535,0.03569643626385714,651,Are you sure high blood pressure doesn’t run in your family?
3538,3903,18,37,192,247,1.2955465587044535,0.03793167682149691,651,When did you first notice the breathing problem?
62,3907,13,52,199,264,1.2954545454545454,0.03414607435083545,651,Your plan limits you to two of these per year.
8975,3907,11,43,166,220,1.2954545454545454,0.037511712449439946,651,And how long have you had this “constricted” feeling?
4556,3909,17,49,215,281,1.295373665480427,0.03428475840568968,651,"On the bright side, your heart looks healthy"
8011,3910,6,58,173,237,1.2953586497890295,0.033112214780891894,651,I can prescribe a muscle relaxant.
7430,3910,13,44,180,237,1.2953586497890295,0.03669772074932029,651,"So... hoarseness, vocal fatigue, throat clearing, anything else ?"
5872,3910,12,46,179,237,1.2953586497890295,0.036207250688356556,651,Is there anything I haven't asked you?
6001,3910,14,42,181,237,1.2953586497890295,0.037181721503726665,651,"Well, Mr. Snake. What seems to be the trouble today?"
3292,3914,17,41,196,254,1.295275590551181,0.03676364976765239,651,"No, it's shingles."
8723,3915,19,42,210,271,1.2952029520295203,0.03591551667953246,651,Unfortunately I can’t make referrals to herpetologists.
1874,3916,14,39,174,227,1.2951541850220265,0.03829243609932698,651,So how long have you felt this tightness in your chest?
2502,3916,14,39,174,227,1.2951541850220265,0.03829243609932698,651,I have an oil that will take care of that.
1666,3916,14,39,174,227,1.2951541850220265,0.03829243609932698,651,Start with a dozen Tums. Or two dozen if you swallow someone bigger.
5963,3916,14,39,174,227,1.2951541850220265,0.03829243609932698,651,Well lets stop the cream for the ringworm.
4317,3916,11,45,171,227,1.2951541850220265,0.03673358351322897,651,Now for the bad news...
1605,3916,13,41,173,227,1.2951541850220265,0.03777996595448196,651,No problem. It’s fashion week.
4155,3922,14,44,186,244,1.2950819672131149,0.03644504844798766,651,"Crushing chest pain, I see"
6592,3922,13,46,185,244,1.2950819672131149,0.035979302285542705,651,YOU'RE fine but Pickles there needs to work on his cholesterol.
1599,3924,11,55,195,261,1.2950191570881227,0.03352806182763465,651,Let's discuss separation anxiety.
3407,3924,12,53,196,261,1.2950191570881227,0.03396473720173967,651,"Your blood is a bit cold, but everything else looks normal!"
6553,3926,15,34,168,217,1.294930875576037,0.040034447096535024,651,"Take an aspirin, and coil me tomorrow"
6647,3926,8,48,161,217,1.294930875576037,0.03611192561701067,651,This isn't even the worst thing that happened today
7708,3926,8,48,161,217,1.294930875576037,0.03611192561701067,651,So you say something has gotten a hold of you?
6712,3929,8,53,173,234,1.294871794871795,0.03443588854525275,651,I can see you're covered by insurance that constricts your options.
4313,3929,13,43,178,234,1.294871794871795,0.03700327850989223,651,You really need to be more careful about what you order on line
7189,3929,11,47,176,234,1.294871794871795,0.03599830190785142,651,What I am seeing is some constriction in the chest area.
101,3929,12,45,177,234,1.294871794871795,0.03650424879880061,651,"Oh, and the results of the first test came back; it doesn't seem to be an internal issue."
2573,3933,17,40,194,251,1.294820717131474,0.03705993141991683,651,How long have you had tightness in your chest?
1199,3933,11,52,188,251,1.294820717131474,0.03438318567393054,651,It's a new non-invasive procedure...
6168,3933,16,42,193,251,1.294820717131474,0.03662739421374089,651,The results are conclusive - you're a Slytherin!
7704,3933,17,40,194,251,1.294820717131474,0.03705993141991683,651,"If Monty the Python can't tell me this is consensual, I'm calling the ASPCA."
6733,3937,15,49,204,268,1.294776119402985,0.03460983479006182,651,I'll come back once you put on one of the hospital gowns.
8278,3937,17,45,206,268,1.294776119402985,0.03540820438975571,651,I'm afraid that penis enhancement drug was too successful!
1840,3939,13,40,171,224,1.2946428571428572,0.03811122926035494,651,I think a couple's therapist would be more helpful than a physician.
549,3939,9,48,167,224,1.2946428571428572,0.035948741954867365,651,Beans every day snake goes away.
9030,3939,11,44,169,224,1.2946428571428572,0.03704576793557515,651,The good news is you won't be needing that planned Gastric Bypass Surgery!
8777,3939,11,44,169,224,1.2946428571428572,0.03704576793557515,651,"It's not ""work stress"" Mr. Whorton."
3970,3943,15,41,185,241,1.2946058091286308,0.03720968479201828,651,And how long have you felt this shortness of breath?
6851,3943,13,45,183,241,1.2946058091286308,0.03626850354093304,651,"Charmed, I am sure”"
4207,3943,13,45,183,241,1.2946058091286308,0.03626850354093304,651,Nothing to worry about; it's just affectionate.
4597,3943,12,47,182,241,1.2946058091286308,0.03578863230814124,651,"Yes, I believe in alternative therapies ... why do you ask?"
2725,3943,16,39,186,241,1.2946058091286308,0.0376714585453324,651,Any other phobias you’re being treated for?
5316,3948,14,48,196,258,1.2945736434108528,0.035083399457797496,651,I can refer you to a great dermatologist to shed that extra skin.
464,3949,14,35,165,214,1.294392523364486,0.03986872160806663,651,"I'm sorry, the nurse should have told you up front... no pets."
622,3950,11,46,174,231,1.2943722943722944,0.03629321064285816,651,"So you said it feels like a ""squeezing sensation""?"
7934,3950,11,46,174,231,1.2943722943722944,0.03629321064285816,651,You seem to have an advanced case of anaconda.
3524,3952,13,47,188,248,1.2943548387096775,0.03557217543592345,651,I want to rule out Eboa virus.
1735,3952,8,57,183,248,1.2943548387096775,0.033198348616930266,651,Mine prefers mice.
3722,3952,16,41,191,248,1.2943548387096775,0.036923288773561914,651,"I've heard of a frog in your throat, but this is a new one."
4541,3952,15,43,190,248,1.2943548387096775,0.036478478463133124,651,So feeling some tightness in the chest? Any other symtoms?
7682,3952,10,53,185,248,1.2943548387096775,0.034167675903291804,651,"After some tests, we have concluded that that growth may be life threatening."
4833,3957,18,42,205,265,1.2943396226415094,0.03607404347776067,651,You're my third patient today to walk in with a student loan
3317,3957,12,54,199,265,1.2943396226415094,0.03361264681952971,651,Do your symptoms include shortness of breath?
3411,3959,12,46,180,238,1.2941176470588236,0.03607614970531896,651,There _are_ alternatives to lap-band surgery.
4280,3959,16,38,184,238,1.2941176470588236,0.03799101816235912,651,Your tapeworm condition has gotten much worse
4289,3959,11,48,179,238,1.2941176470588236,0.03558133438612943,651,"Yes, our process for taking your blood pressure has been altered slightly."
6510,3959,15,45,195,255,1.2941176470588236,0.03578476315279054,651,"I'm sorry Adam, but I'm not in-network for Eden."""
7677,3959,14,42,182,238,1.2941176470588236,0.03704595820446062,651,"Worst case scenario, Adam, is you and and Eve'll have to move out and get jobs."
7706,3959,12,46,180,238,1.2941176470588236,0.03607614970531896,651,"Unfortunately, your insurance company has classified this as a pre-existing condition and will not cover it."
8062,3959,12,46,180,238,1.2941176470588236,0.03607614970531896,651,"Common side effects include mood changes, shortness of breath, and insomnia."
8941,3959,19,37,199,255,1.2941176470588236,0.03747083194191793,651,"I see... body aches and tightness in your chest. Well, ​sir, I think you have the flu."
3190,3959,11,43,167,221,1.2941176470588236,0.03736551448860676,651,Have you noticed any changes since your last appointment?
2452,3959,11,48,179,238,1.2941176470588236,0.03558133438612943,651,So tell me more about this tightness in your chest.
319,3959,14,47,194,255,1.2941176470588236,0.035350682889751656,651,I'll give you something for the tightness in your chest.
1833,3959,15,45,195,255,1.2941176470588236,0.03578476315279054,651,"On a scale of 1 to 10, how squeezed do you feel?"
1088,3959,15,45,195,255,1.2941176470588236,0.03578476315279054,651,I figured out why you're feeling constipated.
94,3959,22,36,214,272,1.2941176470588236,0.03691903791077727,651,Doctor I feel constricted.
2367,3959,13,49,193,255,1.2941176470588236,0.03491120576036075,651,Yeah... but it's still better than the old prostate exam.
1606,3974,13,51,198,262,1.2938931297709924,0.034282833034407274,651,You say it feels like a snake crushing your chest?
2947,3974,17,43,202,262,1.2938931297709924,0.03594860904117795,651,"But on the positive side, boas have long been a popular fashion statement"
5274,3974,17,43,202,262,1.2938931297709924,0.03594860904117795,651,The nurse says you’re reporting some tightness in your chest. I think we need to do some tests.
2739,3977,20,32,193,245,1.2938775510204081,0.03898186012293245,651,"The good news is, you’re only the second-worst snake charmer I’ve ever seen."
4995,3977,11,50,184,245,1.2938775510204081,0.034906752505313686,651,Do you really hate putting on the gown that much?
5597,3977,9,54,182,245,1.2938775510204081,0.033934780974117125,651,"Do you have any difficulty swallowing?
And you, sir?"
7309,3977,15,42,188,245,1.2938775510204081,0.03677370516930632,651,"hmmm...you say your are experiencing a tightness of the chest, heavy pressure, squeezing and crushing pain?  Sounds like a heart attack to me."
4499,3977,11,50,184,245,1.2938775510204081,0.034906752505313686,651,"I know it's unusual, but I'd reccomend a hiss-terectomy."
1547,3982,13,41,174,228,1.293859649122807,0.03763616942145387,651,Our new treatment for bloating is organic and effective.
7925,3982,15,37,176,228,1.293859649122807,0.038649281675691094,651,Should have just taken the apple...would have kept me away...
7230,3984,12,38,161,211,1.2938388625592416,0.039111663175757296,651,"Well, we've ruled out a tapeworm..."
7923,3985,14,46,192,252,1.2936507936507937,0.03562370378714988,651,"On the plus side, your diet's going great."
2616,3985,16,42,194,252,1.2936507936507937,0.03650051203172915,651,I'm afraid you'll need to shed more than just a few pounds.
3236,3985,12,50,190,252,1.2936507936507937,0.034724762986243524,651,It's okay -- he just likes you.
8694,3988,15,39,181,235,1.2936170212765958,0.03784051330047378,651,That outfit is to die for!
7699,3988,15,39,181,235,1.2936170212765958,0.03784051330047378,651,Now let’s discuss some possible side affects  with constrictor therapy...
6897,3988,12,45,178,235,1.2936170212765958,0.03637023095107746,651,"So, exactly how long have you been experiencing this pressure in your chest?"
2883,3988,17,35,183,235,1.2936170212765958,0.03878975309428698,651,"OK, it says here that you're experiencing 'upper body constriction'."
2177,3992,8,48,162,218,1.2935779816513762,0.035971343289285106,651,How long have you had this tightness in your chest?
2105,3992,9,46,163,218,1.2935779816513762,0.03655428118813505,651,"I can treat him for the rash, but I'm afraid the constricting is just part of his nature."
3893,3992,6,52,160,218,1.2935779816513762,0.03477616522482462,651,I see you're having trouble swallowing.
4299,3995,13,50,196,259,1.2934362934362935,0.034535541490383015,651,"Sir, that is a boa constrictor not a python."
3685,3995,15,46,198,259,1.2934362934362935,0.03539158305318894,651,Have you experienced any tightness in your chest?
1832,3997,16,39,187,242,1.2933884297520661,0.03753521522165468,651,I'm prescribing a muscle relaxant for one of you. Magnetic Reptile Imaging will help us decide who gets it.
3954,3997,18,35,189,242,1.2933884297520661,0.03843796476590832,651,I think I have an idea where the tightness in your chest is coming from.
2600,3999,14,38,173,225,1.2933333333333332,0.03848314411469495,651,"Mr. Adams, you have what we call an abnormal constriction of your airway."
455,3999,8,50,167,225,1.2933333333333332,0.03525417908358018,651,"And  tell me, how long have you had this tightness in your chest?"
6267,4001,15,48,203,266,1.2932330827067668,0.03475137552864778,651,"Well, Mr. Mowgli, we do things a little different here in the big city."
1738,4001,13,52,201,266,1.2932330827067668,0.03392510078767632,651,"When you called about a squeezing sensation in your abdomen, I  admit I was envisioning something entirely different."
6525,4001,10,58,198,266,1.2932330827067668,0.032646500684381796,651,It's a common symptom in the West Wing.
430,4004,11,51,187,249,1.2931726907630523,0.03452300996392761,651,We need proof of the snake's insurance.
4652,4004,13,47,189,249,1.2931726907630523,0.035448743939969315,651,Have you thought about taking up the flute?
5522,4006,12,44,176,232,1.293103448275862,0.03667111893945369,651,Just because it's one of the symbols of medicine doesn't mean it can't hurt you.
5125,4006,20,28,184,232,1.293103448275862,0.04053792035812287,651,"No, I'm quite certain it's Er-reptile Dysfunction, although you should still be embarrassed telling your wife."
7318,4008,11,41,163,215,1.2930232558139534,0.038028900026206874,651,"Ok, so you can go ahead and hop down and we’ll get you into X Ray"
1495,4009,15,45,196,256,1.29296875,0.03566321560306551,651,"Next time, I'm going to recommend you leave your service snake in the car."
8047,4009,16,43,197,256,1.29296875,0.036090195372880655,651,"Well, look at it this way--it's short-term COBRA."
8868,4009,14,47,195,256,1.29296875,0.035231061469231585,651,Lets see here...are you having any difficulty breathing...tightening of the chest?
2457,4009,13,49,194,256,1.29296875,0.03479354016691624,651,As long as you don't breathe you should be fine.
3858,4013,9,52,178,239,1.292887029288703,0.03444750145801104,651,"Well, since the leeches didn't work. This is the next logical step."
3799,4013,10,50,179,239,1.292887029288703,0.03495412514163963,651,This muscle relaxant should help you unwind.
3307,4013,10,50,179,239,1.292887029288703,0.03495412514163963,651,The tightness in the chest is normal.
8346,4013,15,40,184,239,1.292887029288703,0.037384400530248725,651,Good news: I'm circling in on the cause of your shortness of breath.
2396,4013,9,52,178,239,1.292887029288703,0.03444750145801104,651,Let's wait and see how you feel after he passes you through his digestive system..
5177,4018,10,45,167,222,1.2927927927927927,0.03666870534811868,651,We  normally prescribe digitalis for chest  tightness but in your case we might want to look at other remedies.
795,4018,13,39,170,222,1.2927927927927927,0.03829997639488106,651,I'm sorry sir but this isn't on your health plan
3770,4018,14,37,171,222,1.2927927927927927,0.03882850677653656,651,"Would you prefer I write the prescription for you, or for the snake?"
5475,4018,10,45,167,222,1.2927927927927927,0.03666870534811868,651,"So you're sure you want to go with the stomach stapling option instead? It's more invasive, you know..."
7143,4018,12,41,169,222,1.2927927927927927,0.037764049639853865,651,"In the past two weeks, have you been feeling compressed or hopeless?"
3375,4023,15,47,201,263,1.2927756653992395,0.03500962333426759,651,"'""Yeah, I don't shake hands either. Germs."
1967,4024,12,48,186,246,1.2926829268292683,0.03525884499142444,651,I'm prescribing a laxative for Slinky and a muscle relaxer for you.
20,4024,17,38,191,246,1.2926829268292683,0.03753806303842142,651,So when did you first notice the pain in the asp?
8201,4024,18,48,221,287,1.2926829268292683,0.0340944375034543,651,I think I've found the cause of your chest pain.
5058,4027,15,49,206,270,1.2925925925925925,0.03438753980611161,651,Your problem is that you're too tightly wound.
4673,4028,14,39,176,229,1.2925764192139737,0.03800081950247347,651,"It’s called “Me Too” and, Adam, you’re in for some big trouble."
5470,4028,14,39,176,229,1.2925764192139737,0.03800081950247347,651,When was the last time you had an uncoilonoscopy?
8147,4028,12,43,174,229,1.2925764192139737,0.03697906897196987,651,"I know you work at the zoo, but you're a little too wrapped up in your work."
2220,4031,19,36,198,253,1.2924901185770752,0.0376458685506116,651,"Congressman, I'd avoid the swamp if I were you."
5057,4031,12,50,191,253,1.2924901185770752,0.03460670806102499,651,So your intention was to buy a feathered boa?
8761,4033,14,41,181,236,1.2923728813559323,0.037219020955041225,651,"This is our new, highly experimental full-body blood-pressure test."
6416,4033,11,47,178,236,1.2923728813559323,0.035736108361069455,651,"-OK, Let's see what we got here mister...?
-Adam.
-Adam...?
-Just Adam."
4954,4033,8,53,175,236,1.2923728813559323,0.03418893623288679,651,I don’t think he wants to be your emotional support animal any longer.
4735,4033,15,39,182,236,1.2923728813559323,0.03770036535018855,651,I’m referring you to a herpetologist but he’s out-of-network
3342,4033,17,35,184,236,1.2923728813559323,0.03864507214263543,651,Would it make a difference if I told you that you don't look good in a boa?
1202,4033,13,43,180,236,1.2923728813559323,0.03673136934781901,651,I see you’ve met my nurse.
472,4033,16,37,183,236,1.2923728813559323,0.038175641110839216,651,I might suggest a veterinarian at this point.
424,4033,7,55,174,236,1.2923728813559323,0.03365741127969439,651,"It says here, you're experiencing shortness of breath."
330,4033,11,47,178,236,1.2923728813559323,0.035736108361069455,651,"So then what happened after you said ""here, hold my beer""?"
1871,4042,15,46,199,260,1.2923076923076924,0.03527325874744664,651,I'm doing the 'try not to laugh' challenge myself.
2987,4042,11,54,195,260,1.2923076923076924,0.033547021683961786,651,I'm not sure snake oil will do it.
5428,4042,17,42,201,260,1.2923076923076924,0.03610544061584598,651,And when exactly did the tightness in your chest start?
6115,4042,17,42,201,260,1.2923076923076924,0.03610544061584598,651,"So, the first thing I see on your chart is that your cholesterol level is quite high."
6225,4042,15,46,199,260,1.2923076923076924,0.03527325874744664,651,So what other diet restrictions do you have?
7917,4047,14,36,169,219,1.2922374429223744,0.0391825064619161,651,"Sorry, your policy does not cover this."
63,4048,12,47,184,243,1.2921810699588476,0.03553468358172579,651,Do you have any symptoms other than tightness in the chest?
1087,4048,15,41,187,243,1.2921810699588476,0.03694244364297089,651,Did the muscle spasms begin before of after your vacation in Burma?
8358,4050,7,52,167,226,1.2920353982300885,0.03455736789523887,651,A birthday gift from my wife. She said it' expresses how I make her feel.
998,4050,12,42,172,226,1.2920353982300885,0.037294349567620316,651,You're right. You are allergic to snakeskin.
7058,4050,13,40,173,226,1.2920353982300885,0.03781798350569285,651,I see your health insurance carrier requires pre-authorization before we can begin treatment...
5495,4050,16,34,176,226,1.2920353982300885,0.03934709616644971,651,Sir I can't help if the snake is uninsured.
565,4050,17,32,177,226,1.2920353982300885,0.03984376166348801,651,"No, Jim, the tiny red patch on your left forearm is not cancerous."
7298,4055,15,43,192,250,1.292,0.0362242014554405,651,You wanted an emotional support animal.  Medicine isn't perfect.
8134,4055,16,41,193,250,1.292,0.03666498718315012,651,Your plan only covers snakebites. I'll see you in a few days?
3179,4055,11,51,188,250,1.292,0.03440463217154687,651,"I see, I see... Any shortness of breath?"
3756,4058,12,37,160,209,1.291866028708134,0.03931583074916931,651,"Yes, yes, soon your leg will go numb and then we can make the incision."
2948,4059,9,50,174,233,1.2918454935622317,0.03498305749621505,651,"You know, these fad diets never work."
4564,4059,12,44,177,233,1.2918454935622317,0.036535055986372036,651,How long have you felt this tightness?
2908,4061,13,49,195,257,1.2918287937743191,0.03467663478897087,651,"So, the inhaler didn't work."
4396,4061,18,39,200,257,1.2918287937743191,0.03680303199074486,651,I'm sorry. It's cancer.
6054,4061,17,41,199,257,1.2918287937743191,0.03638769477484064,651,"Tell me more about the tightness in your chest, Mr. Bartholomew."
7811,4064,13,44,183,240,1.2916666666666667,0.036300152468965015,651,"Nasty case of ringworm you have there, Mr. Stevens."
4502,4064,15,47,202,264,1.2916666666666667,0.034894386327616295,651,You need a specialist...I’m sending you to a herpetologist
4293,4064,12,46,182,240,1.2916666666666667,0.035816666033892046,651,"Opiods will only mask the symptoms. 
You need to have this thing removed."
8530,4064,12,39,165,216,1.2916666666666667,0.03844103508354807,651,Have you felt any shortness of breath lately?
7839,4064,14,42,184,240,1.2916666666666667,0.036777283379239106,651,Hmm- I don't like the looks of that eye
2741,4064,9,45,162,216,1.2916666666666667,0.03672212156025718,651,The good news is you are losing weight.
739,4070,19,41,211,271,1.2915129151291513,0.03583679764422151,651,I’m sorry but it appears you declined the optional one dollar per year boa constrictor coverage.
6055,4071,11,50,186,247,1.291497975708502,0.0346642274652313,651,"I'm sure he's fine, Mr. Jones.  Boas can get very clingy at certain times of year. Not to worry."
1006,4071,13,46,188,247,1.291497975708502,0.035601113516035475,651,"What part of ""unwind"" don't you understand?"
2038,4071,10,52,185,247,1.291497975708502,0.03418615738644988,651,"Honestly, I'm just glad it's not another vacuum cleaner."
3729,4074,12,41,170,223,1.2914798206278026,0.03761724333742936,651,Tightness of the chest is a normal side effect.
1764,4074,13,39,171,223,1.2914798206278026,0.038150440886646785,651,"Yes, well, some progress to report: there's no sign of the elephant in the room."
9,4076,16,49,213,278,1.29136690647482,0.034072557213582405,651,Wait a bit and try to remember the safe word.
8898,4076,15,51,212,278,1.29136690647482,0.033689273558377565,651,I'm going to recommend you try a hula hoop instead.
3296,4078,14,46,194,254,1.2913385826771653,0.035380296061233024,651,I see on the form that you have shortness of breath.  About how long has this been going on?
4911,4078,15,44,195,254,1.2913385826771653,0.03581742510664263,651,"Aside from the snake, your weight seems good. Any other problems? Any alcohol or tobacco use?"
6395,4078,12,50,192,254,1.2913385826771653,0.03448942106793902,651,Your vitals show that you’re running like a well coiled machine.
7368,4081,8,51,171,230,1.291304347826087,0.03471728249350265,651,"As for the sense of constriction, there is such a thing as being too health conscious.  You need a way to unwind."
2838,4081,14,39,177,230,1.291304347826087,0.037856616134385734,651,"Yes, I can now see I missed that last week. Also, please stop taking the asthma medication I prescribed."
5281,4081,13,41,176,230,1.291304347826087,0.037351721578942065,651,"Yeah, let’s go ahead and skip the deep breath in."
6845,4081,17,33,180,230,1.291304347826087,0.03933243223921601,651,Doctor’s orders — no planes.
8027,4085,10,56,195,261,1.2911877394636015,0.032993343870690306,651,take a deep breath but don't exhale
6683,4085,13,50,198,261,1.2911877394636015,0.034307113978973194,651,I'm afraid your insurance only covers mammal and amphibian attacks.
714,4085,13,50,198,261,1.2911877394636015,0.034307113978973194,651,I told you to REstrict your diet
2857,4085,16,44,201,261,1.2911877394636015,0.035572396592904704,651,What’s your family hissssstory
243,4089,15,39,183,237,1.2911392405063291,0.0375612190480556,651,Are you experiencing any shortness of breath?
6226,4090,18,42,208,268,1.291044776119403,0.03571978294608219,651,"Well, at least we’ve moved on from using leeches."
1231,4090,16,46,206,268,1.291044776119403,0.0349285358955093,651,"Adam, you say you were in the garden with your wife when the serpent appeared?"
356,4092,15,41,188,244,1.290983606557377,0.03681021099526496,651,So you say this began when you said he didn’t spark any joy?
2442,4092,11,49,184,244,1.290983606557377,0.03492944574179624,651,I'm writing you a scrip for snake oil. Two days of treatment and you should feel less constricted.
4239,4092,11,49,184,244,1.290983606557377,0.03492944574179624,651,'You'll want to be acutely aware of any tightness in the chest.'
6766,4092,12,47,185,244,1.290983606557377,0.035409003703165624,651,Do you currently use an inhaler?
7616,4092,12,47,185,244,1.290983606557377,0.035409003703165624,651,"Ok, Mr. Jones; now take a deep breath."
9124,4097,13,38,169,220,1.290909090909091,0.0384911073117984,651,"My brother is a veterinarian, maybe you should go see him?"
6279,4098,13,47,191,251,1.2908366533864541,0.03520433790338569,651,"Sorry, Larry- your insurance doesn't cover this. Maybe try the vet?"
8474,4098,16,41,194,251,1.2908366533864541,0.036537144621552414,651,"We are going to have to run some test. I have you scheduled for an MRI, colonoscopy, EKG, angiography, and ultrasound. I am also going to put you on lexapro, oxycodone, and viagra just to be safe. No matter the cost, we will identify the issue."
4762,4098,12,49,190,251,1.2908366533864541,0.03474871072796225,651,My diagnosis is - you're very tightly wound.
6425,4101,14,54,214,282,1.2907801418439717,0.03297350554541921,651,Self-treating anxiety with compression? A weighted blanket might have been a better place to start.
263,4102,16,34,177,227,1.2907488986784141,0.03919449683644863,651,Sorry. Our sphygmomanometer is in the shop.
209,4103,14,47,197,258,1.2906976744186047,0.034994144495687836,651,What was the first symptom?
8156,4104,12,44,178,234,1.2905982905982907,0.03639996148324523,651,When did these symptoms begin?
3363,4104,11,46,177,234,1.2905982905982907,0.03589254457217849,651,Ok if you are still constipated tomorrow come back in.
2664,4104,15,38,181,234,1.2905982905982907,0.037881453461152806,651,"We finally found a hospital gown that's less revealing, although some patients have complained it's a little constricting."
7848,4107,12,53,200,265,1.290566037735849,0.033524270560511014,651,Take a couple of mongooses and call me in the morning.
2729,4107,12,53,200,265,1.290566037735849,0.033524270560511014,651,And when did you first notice you were supporting her more than she was supporting you?
938,4109,13,35,162,210,1.2904761904761906,0.039730509473509916,651,Quite serious. I'm recommending you to my zoologist. How's Thursday?
6751,4109,11,39,160,210,1.2904761904761906,0.03856651980387218,651,I'm going to give you something for the pain but you need to see a specialist.
7869,4109,10,41,159,210,1.2904761904761906,0.03797114671907298,651,It's my professional veterinary opinion that Debby would benefit from having a different heat source.
1699,4112,18,34,189,241,1.2904564315352698,0.03848533737434204,651,"So, it’s been longer than four hours?"
4302,4112,17,36,188,241,1.2904564315352698,0.03803344641503826,651,"Good news.Your tests came back.
The tightness in your chest is definitely not heart-related."
5340,4112,7,56,178,241,1.2904564315352698,0.03317772716887295,651,Your labs are good.  Still feeling that tightness in your chest?
9060,4112,16,38,187,241,1.2904564315352698,0.037576121401686,651,"So, you were at Disney World when you felt a tightening in your chest and started having trouble breathing.  Do you happen to remember if this began sometime during the Jungle Cruise?"
6461,4116,13,53,206,272,1.2904411764705883,0.033364438211626476,651,Constricted breathing you say?
6738,4117,15,42,191,248,1.2903225806451613,0.036385426730116945,651,"Well, patients were complaining about those open-back gowns, so we're giving these a try."
602,4117,14,44,190,248,1.2903225806451613,0.035933959084160666,651,The lack of feathers didn't strike you as being somewhat odd?
2748,4117,15,42,191,248,1.2903225806451613,0.036385426730116945,651,"You can tell Eve her ""apple-a-day"" theory has about as much credibility as snake oil."
4624,4117,14,53,212,279,1.2903225806451613,0.03319843341366352,651,"Don’t tell my colleagues, but I’m writing you a prescription for snake oil."
4640,4117,10,52,186,248,1.2903225806451613,0.03406831319539946,651,How long have you been feeling tightness in the chest?
5170,4122,17,40,198,255,1.2901960784313726,0.03654980680215204,651,Is there any  family history of being squeezed to death by a boa constrictor?
1810,4122,10,54,191,255,1.2901960784313726,0.03346250028566145,651,"So, it says here you’re having some chest tightness?"
1273,4122,11,52,192,255,1.2901960784313726,0.0339207520331939,651,I think you've gone overboard trying to constrict your food intake.
4901,4122,16,42,197,255,1.2901960784313726,0.036124920541713366,651,I’m referring you to a specialist.
8810,4122,6,62,187,255,1.2901960784313726,0.0315630314268093,651,"Before I can do anything, I'll need you both to sign this waiver."
1003,4127,12,41,171,224,1.2901785714285714,0.03747153330621584,651,Any pressure in your chest?
1878,4128,12,52,198,262,1.2900763358778626,0.03376360850527549,651,Any respiratory issues?
3224,4128,15,46,201,262,1.2900763358778626,0.035038887648515926,651,The good news is that the treatment is covered by your wrap-around insurance policy.
8121,4128,12,52,198,262,1.2900763358778626,0.03376360850527549,651,So...Adam...when did this snake fetish start?
8127,4128,8,60,194,262,1.2900763358778626,0.0319842368701693,651,I'm afraid it's a little more than congestion.
5140,4132,11,45,175,231,1.29004329004329,0.03618528857820592,651,Is this tightness in your chest something new?
827,4132,11,45,175,231,1.29004329004329,0.03618528857820592,651,"Sorry, I'm a hematologist.  I'll refer you to an excellent herpetologist."
4405,4134,14,50,205,269,1.2899628252788105,0.03400908595486003,651,I'm referring you to one of our top Herpetologists.
6715,4134,15,48,206,269,1.2899628252788105,0.03441453554431646,651,Find two herpatoligists and call me in a week.
389,4136,15,39,184,238,1.2899159663865547,0.03742306420016724,651,"On the good side, Jungle Jerry’s Hands-On Amazon Adventure is willing to give you a life-time pass."
5477,4136,15,39,184,238,1.2899159663865547,0.03742306420016724,651,I’m referring you to a couples counselor.
2167,4138,12,47,186,245,1.2897959183673469,0.03528417583707762,651,"The last time you were in here, we asked you to do something about the snake."
3811,4138,7,57,181,245,1.2897959183673469,0.03282823537348616,651,"I initially thought you just had a ""frog in your throat."" But the tests say this is much worse!"
1317,4138,15,41,189,245,1.2897959183673469,0.03667889148489489,651,Pressure you say?  Take two aspirin and cut the head off that snake.
5437,4138,14,43,188,245,1.2897959183673469,0.03621995410278338,651,Have you considered that the problem might not be physical?
1083,4138,18,35,192,245,1.2897959183673469,0.0380224814632025,651,I'd stick to the ostrich if I were you Mr Manafort
6464,4138,8,55,182,245,1.2897959183673469,0.03333390230816022,651,"aaaaand, what is your chief complaint?"
6798,4144,16,30,168,214,1.2897196261682242,0.040842930250688934,651,"So, it looks like you’ve got the full Monty...."
4158,4145,14,45,193,252,1.2896825396825398,0.03553112529218267,651,Your HMO doesn’t cover anaconda removal sir but I can make a referral.
7114,4145,16,41,195,252,1.2896825396825398,0.036410163026174315,651,"It may be a new design, but it still opens in the back."
2832,4145,16,41,195,252,1.2896825396825398,0.036410163026174315,651,I am sorry to confirm that this is indeed your penis now.
914,4148,12,40,169,221,1.2895927601809956,0.03779887435190373,651,And what is your complaint today?
1194,4148,12,40,169,221,1.2895927601809956,0.03779887435190373,651,"Now, take a deep breath and hold it."
1296,4148,15,34,172,221,1.2895927601809956,0.03939747337114339,651,"Well, Mr. Stone, there’s really no cure for karma."
2539,4148,12,40,169,221,1.2895927601809956,0.03779887435190373,651,And when did you first notice these symptoms?
1169,4152,15,45,199,259,1.2895752895752897,0.03530331237466574,651,It's quite common. I call it Medicare Constriction.
3073,4152,15,45,199,259,1.2895752895752897,0.03530331237466574,651,I'd like to change your prescription to feather boa for a few weeks and see if that helps you feel less wound up.
7313,4152,14,47,198,259,1.2895752895752897,0.03487683474936946,651,"I'm afraid it's acute separation anxiety, Mr Johnson"
7696,4152,12,51,196,259,1.2895752895752897,0.034007838466418604,651,"So, this is looking really good.  We'll see you back in a few months."
1659,4156,14,38,176,228,1.2894736842105263,0.03804041949026673,651,And would you say your chest tightness has been getting progressively worse?
5358,4156,14,49,203,266,1.2894736842105263,0.03425442146119147,651,"So, you say it all started with an argument over the remote?"
7593,4156,20,37,209,266,1.2894736842105263,0.03665518111642943,651,"You said it was recommended by ""Goop""?"
8492,4156,21,35,210,266,1.2894736842105263,0.03704018252543846,651,When did the coiling start?
9016,4160,16,36,183,235,1.2893617021276595,0.0382189888944893,651,"It will take some time,but I do think a course of  mindfulness meditation will release some of the tension you feel"
6556,4160,15,38,182,235,1.2893617021276595,0.037740175714759065,651,"So, your pet snake hates it when you bring her to the vet, and she's retaliated by dragging you here for your annual rectal exam?"
4662,4160,13,42,180,235,1.2893617021276595,0.0367638458911534,651,I'm recording here that your major complaints are stiff neck and limited mobility of your arms.
3258,4160,12,44,179,235,1.2893617021276595,0.03626582572577481,651,"So, chest pains, tightness and a choking sensation you say? 
I think I see the problem."
1488,4160,11,46,178,235,1.2893617021276595,0.03576087060511899,651,All your tests seem normal. How have you been eating?
3552,4160,13,42,180,235,1.2893617021276595,0.0367638458911534,651,Well I think we can rule out allergies
7597,4166,18,45,217,280,1.2892857142857144,0.03460845600605591,651,"If you think this is bad, try not paying your bill."
5749,4167,14,42,186,242,1.2892561983471074,0.03651234824397539,651,"Frankly, I don’t think the additional weight on your knees is the problem."
4655,4167,14,42,186,242,1.2892561983471074,0.03651234824397539,651,Is this a precondition or a new health event?
6469,4167,15,40,187,242,1.2892561983471074,0.03697896633349787,651,Okay... Hmm... So what are you in for?
1826,4167,13,44,185,242,1.2892561983471074,0.036039689197948095,651,I have bad news and worse news.
6082,4171,13,33,158,204,1.2892156862745099,0.04050305306739787,651,"So what brings you in today, Mr Mouseman?"
91,4172,12,48,189,249,1.2891566265060241,0.034892150310864276,651,Have you been travelling recently?
1889,4172,10,52,187,249,1.2891566265060241,0.03395124332574404,651,Let's start with a lengthy review of your family history.
6526,4172,19,34,196,249,1.2891566265060241,0.03800230858971831,651,Oxycontin...sixty tablets...three refills...Okay you're free to go!
7892,4172,14,44,191,249,1.2891566265060241,0.03580834236973295,651,"Wow Mr. Jones, you really ARE wound up tight!"
1295,4176,8,45,158,211,1.2890995260663507,0.036602782484709315,651,So you say this has helped you reduce your calorie intake?
5325,4177,19,36,201,256,1.2890625,0.03725602312635068,651,"I wasn’t going to come in, but Web MD said shortness of breath was cause for concern."
8447,4177,10,54,192,256,1.2890625,0.033350801565682486,651,HIPPA constricts what I can say in front of your pet
2144,4179,13,37,168,218,1.2889908256880733,0.03868466297278932,651,Seems to me you'll need to remove that man to ever get back to your original length.
6991,4180,9,58,196,263,1.2889733840304183,0.03233347425221048,651,Your insurance suggests that we start with physical therapy first.
18,4181,8,49,168,225,1.288888888888889,0.03513641844631533,651,The test results show a dangerous rise in your blood pressure since your last appointment.
1172,4181,11,43,171,225,1.288888888888889,0.03679151424285479,651,I prescribe  a series of deep breathing exercises!
3413,4181,10,45,170,225,1.288888888888889,0.03624821348148964,651,I think we are looking at more than arterial constriction here.
4058,4181,12,41,172,225,1.288888888888889,0.03732690798826936,651,Would you say it's being passive or aggressive right now?
794,4185,15,50,212,277,1.288808664259928,0.033713491730443544,651,Snake oil might do you some good.
2626,4186,10,47,175,232,1.2887931034482758,0.03552930278957139,651,I'm prescribing one mouse twice weekly for your natural compression therapy.
2766,4186,14,39,179,232,1.2887931034482758,0.03757136367046081,651,The first thing you'll need to do is give up gardening.
7406,4186,12,43,177,232,1.2887931034482758,0.03656459164800742,651,OK - so you will let him go if he eats the apple?
4567,4189,9,51,179,239,1.288702928870293,0.034340567874556326,651,"No, you definitely don’t have a tape worm but this one will eventually cause significant weight loss."
5646,4189,15,39,185,239,1.288702928870293,0.03728589073970741,651,"Well, that wraps it up. Any other questions?"
8229,4189,10,49,180,239,1.288702928870293,0.034848746170626305,651,Sit tight. Your results will be ready in a couple hours.
6793,4192,17,37,192,246,1.2886178861788617,0.0374454151887037,651,Says here you’re covered by Mutual of Omaha.
4210,4192,12,47,187,246,1.2886178861788617,0.035160191866757465,651,"Why yes, your blood pressure is a bit elevated, but it's unclear why."
2549,4192,13,45,188,246,1.2886178861788617,0.03562896430457443,651,You said it's a tightness in your chest?
7653,4195,16,41,196,253,1.2885375494071147,0.03628403412867347,651,The snake is in amazingly good health - and will be for the rest of his term and beyond.
4993,4195,17,39,197,253,1.2885375494071147,0.03671376757073194,651,"When I suggested you wrap a boa on your neck to help you when you're feeling cold, I think you misunderstood."
1348,4197,15,45,200,260,1.2884615384615385,0.03518490016350283,651,Your snake is suffering from severe insecurity.
8696,4197,13,49,198,260,1.2884615384615385,0.034330411301287986,651,"I'd say the definition of service animal has gotten less restrictive."""
2913,4199,17,43,207,267,1.2883895131086143,0.03535862593269464,651,"Now, about that tightness in your chest."
8592,4199,21,35,211,267,1.2883895131086143,0.03691711772733128,651,The snake needs to unwind. I'm prescribing Klonopin.
4439,4201,17,45,212,274,1.2883211678832116,0.03472970792746872,651,Is anyone else in your family experiencing chest tightness?
1858,4202,14,36,172,222,1.2882882882882882,0.03871839842630171,651,"Sorry, I can't prescribe snake oil."
8786,4202,12,40,170,222,1.2882882882882882,0.0376508284557411,651,I'm going to prescribe you some asp-pirin.
3565,4204,10,46,173,229,1.2882096069868996,0.03581636117661192,651,"On the bright side, you will lose 50 pounds."
5199,4204,12,42,175,229,1.2882096069868996,0.036870346740427835,651,"So, what brings you here today, Glycon?"
1371,4206,17,34,185,236,1.2881355932203389,0.0385470847615916,651,So you were under a tree completely naked and this here fella just dropped in.
4835,4206,13,42,181,236,1.2881355932203389,0.03662826281539609,651,Are you under any stress at all?
5229,4206,15,38,183,236,1.2881355932203389,0.03759991609359691,651,When did you first notice a problem breathing?
3285,4209,17,36,190,243,1.2880658436213992,0.03775746923169513,651,Well that’s a wrap.
186,4209,14,42,187,243,1.2880658436213992,0.036381259979853586,651,And when do you think this onset of anxiety began?
3246,4209,10,50,183,243,1.2880658436213992,0.03446092769559102,651,"We treat depression, not compression."
6390,4212,12,48,190,250,1.288,0.03477154355164371,651,Any allergies to venom ?
1270,4212,20,32,198,250,1.288,0.038289533209659984,651,I’ve been feeling a little constricted.
7139,4214,13,48,196,257,1.2879377431906616,0.034584414075157936,651,Let’s test how long you can hold your breath!
7800,4214,14,46,197,257,1.2879377431906616,0.03502114403623627,651,"I can’t explain the tightness you’re feeling across your chest. Your cardiogram is normal. Why don’t you just take is easy, relax and unwind."
5581,4214,7,60,190,257,1.2879377431906616,0.03183847830555086,651,"Yes, laxatives also work, but the side effects are fewer with this method."
9051,4214,10,54,193,257,1.2879377431906616,0.03323981346017916,651,The tests for asthma came back negative.
659,4214,17,40,200,257,1.2879377431906616,0.036299821317208734,651,Due to the cold weather I'm going to prescribe you another snake for your legs.
5001,4214,13,48,196,257,1.2879377431906616,0.034584414075157936,651,"Next time, specify FEATHER boa."
1445,4220,13,52,206,271,1.2878228782287824,0.033384506741815964,651,"There are tapeworms, and then there are tapeworms."
3025,4220,20,38,213,271,1.2878228782287824,0.036136692392638205,651,"Something is constricting your blood flow, so I'm going to send you over to the lab to run some tests."
7641,4220,16,46,209,271,1.2878228782287824,0.03459083853280454,651,So when did this tightness in your lungs begin?
4232,4223,8,43,154,205,1.2878048780487805,0.037247319334252814,651,"So you live all the way down in Eden, huh"
4800,4224,10,60,208,278,1.2877697841726619,0.031617112622575404,651,Your blood pressure is elevated. I’d like to run some tests.
7796,4224,11,58,209,278,1.2877697841726619,0.03202520589739065,651,Not to worry. My last patient was an elephant and he was inside.
1023,4226,13,35,164,212,1.2877358490566038,0.039402254106992975,651,You say until this happened you had a good relationship?
4464,4227,12,39,168,219,1.2876712328767124,0.03798270585144277,651,You'll be OK. Take one mongoose each morning with breakfast.
447,4227,7,49,163,219,1.2876712328767124,0.035117328591319504,651,We'll run an EKG to check out that tightening in your chest.
1173,4227,12,39,168,219,1.2876712328767124,0.03798270585144277,651,It will gradually go away.
3509,4227,11,41,167,219,1.2876712328767124,0.03742718408477882,651,I'd say you got yourself a closet full of new shoes.
5769,4227,10,43,166,219,1.2876712328767124,0.03686329167660719,651,Have you done any recent travelling?
8140,4227,13,37,169,219,1.2876712328767124,0.038530219037510395,651,Have you gotten your flu shot yet?
8186,4233,11,43,172,226,1.2876106194690264,0.036650656127583385,651,We need to talk about your blood pressure.
8774,4233,10,45,171,226,1.2876106194690264,0.03611009869575782,651,"I am not sure this is covered by the A.C.A, but try calling the A.S.P.C.A"
727,4233,11,43,172,226,1.2876106194690264,0.036650656127583385,651,"I'm sorry, but your ""pain in the asp"" complaint is wrong.  The snake seems just fine."
5074,4233,11,43,172,226,1.2876106194690264,0.036650656127583385,651,"Everything looks just fine. I’ll
Just give him his rabies shot and you’re good to go."
3489,4237,17,33,183,233,1.2875536480686696,0.03888473762798651,651,Tightness in your chest you say!
6527,4237,13,41,179,233,1.2875536480686696,0.036932751700970635,651,"I've heard a lot of excuses for not exercising, but this is a first."
8041,4239,10,49,181,240,1.2875,0.03472408177261403,651,"You feel constricted, you say?"
7566,4239,14,41,185,240,1.2875,0.03667740270109359,651,He says your blood pressure is a little high.
7513,4239,16,37,187,240,1.2875,0.03761604545764597,651,"...and as for that feeling of pressure, I'm afraid we'll need a few more tests."
7363,4239,13,43,184,240,1.2875,0.03619895530828807,651,Next time just be prepared with some pants.
6154,4239,12,45,183,240,1.2875,0.0357140989236,651,I am just going to take down your Hiss-story.
2992,4239,9,51,180,240,1.2875,0.03421833355767688,651,"Okay, first let's get your vitals. How tall were you before today?"
1421,4239,12,45,183,240,1.2875,0.0357140989236,651,Your cholesterol's a little high.
493,4239,11,47,182,240,1.2875,0.035222568879028915,651,A mild laxative would have been easier on your system.
4160,4239,12,45,183,240,1.2875,0.0357140989236,651,Your blood pressure is up.
2946,4248,10,51,186,247,1.2874493927125505,0.03408465663804155,651,"And what, exactly, are your symptoms?"
3128,4249,11,51,192,254,1.2874015748031495,0.033938801166703954,651,I would suggest a pet rat might release his tension.
9216,4249,13,47,194,254,1.2874015748031495,0.03484375709380334,651,I'll have to postpone your rectal exam again until we get this blood pressure under control.
3873,4251,17,41,203,261,1.2873563218390804,0.035897871448142334,651,"So this should  take care of your white rat phobia. If not, we  probably ought to both see a psychiatrist."
7434,4251,8,59,194,261,1.2873563218390804,0.031990704667409754,651,"""My expert opinion is you'll shed that snake by tomorrow evening at the latest."""
5008,4253,14,34,168,216,1.287037037037037,0.03943062238364028,651,"As a 3rd year medical student,  I just Googled ""Compressive Chest Pain"" and am convienced that you are having a heart attack."
1632,4254,13,40,177,230,1.2869565217391303,0.03724438087399559,651,"So, you feel a tightness in your chest. Any other symptoms?"
1115,4254,14,38,178,230,1.2869565217391303,0.03775071107837145,651,I'm referring you to a snake-oil salesman I know.
2434,4256,11,46,180,237,1.2869198312236287,0.035500289202309854,651,"Bad news, a pythonectomy isn't covered by your insurance."
8277,4256,15,38,184,237,1.2869198312236287,0.03746066412371815,651,I'm noting your concern about the prostate exam.
8635,4258,17,36,191,244,1.2868852459016393,0.03762093607002197,651,The Anaconda Diet  is worth a try
8219,4258,10,50,184,244,1.2868852459016393,0.03433970423333191,651,When did the chest pains start?
5781,4258,14,42,188,244,1.2868852459016393,0.03625107916351666,651,"... any dryness of the skin, heart palpitations or general anxiety?"
2528,4258,8,54,182,244,1.2868852459016393,0.03334295367824054,651,OK.... So you filled in OCCUPATION as 'Charmer'.....How long have you been doing it' ?
6911,4258,14,42,188,244,1.2868852459016393,0.03625107916351666,651,Take an apple and call me in the morning
537,4258,19,32,193,244,1.2868852459016393,0.03850711048141757,651,I’m afraid you’re going to need a hissssssterectomy.
2440,4258,12,46,186,244,1.2868852459016393,0.035308327823278925,651,I understand you're suffering from chest pain.
8195,4265,16,40,195,251,1.2868525896414342,0.03644492948535226,651,I can see how this would effect your guitar playing....
1568,4265,11,50,190,251,1.2868525896414342,0.034188745741713045,651,Do you have any quality of life issues?
2920,4265,14,44,193,251,1.2868525896414342,0.03555963814877733,651,I have bad news and good:  the good news is that he's not eaten you yet.....
3551,4265,8,56,187,251,1.2868525896414342,0.03276053732024284,651,I'm afraid the tightness around the chest might be a pre-existing condition.
7741,4265,12,48,191,251,1.2868525896414342,0.03465173654164624,651,"Your EKG is normal, so that chest tightness should resolve on its own."
9143,4270,8,58,192,258,1.2868217054263567,0.03220620083119323,651,"Your tests are normal, just slightly high blood pressure."
6537,4270,12,50,196,258,1.2868217054263567,0.034027813671397636,651,"Right, ummm, okay, let's see, so it says here you've been experiencing slight constriction in the neck, chest, and waist regions?"
3516,4270,15,44,199,258,1.2868217054263567,0.03533244474576461,651,"Sorry, I don't know how to code ""mortal coil"" on the examination form."
5804,4273,18,40,207,265,1.2867924528301886,0.03590768880447211,651,"Well,I guess that about wraps it up."
5602,4274,10,58,204,272,1.286764705882353,0.03203204813006635,651,Good news!  You are not having a heart attack. It probably is just the snake trying to crush your chest.
2275,4275,13,35,165,213,1.2863849765258215,0.039240090050820395,651,We can fix this...but in the future stick with FEATHER boas.
4379,4276,10,45,172,227,1.2863436123348018,0.03597299102867508,651,Have you tried an inhaler?
6701,4276,14,37,176,227,1.2863436123348018,0.038078805432235324,651,Have you noticed anything in particular that prompts the wheezing?
8717,4276,13,39,175,227,1.2863436123348018,0.037563420880516334,651,Looks like you're in a bit of a bind.
3097,4276,11,43,173,227,1.2863436123348018,0.03651083289173724,651,"So, exactly what part of the boa massage are you objecting to?"
1285,4280,12,43,179,234,1.2863247863247864,0.03629321491731118,651,Does your breathing ever feel constricted?
6770,4280,14,39,181,234,1.2863247863247864,0.03729024442486227,651,Your chart says you've been having chest pains?
185,4282,10,49,182,241,1.2863070539419088,0.034600269548097064,651,It's your foot that concerns me.
441,4282,13,43,185,241,1.2863070539419088,0.03606817284857937,651,I told you to get snake oil not a snake coil
1778,4282,17,35,189,241,1.2863070539419088,0.03793712797617085,651,"In all my years of being a snake doctor, I’ve never seen anything like this."
1841,4282,7,55,179,241,1.2863070539419088,0.033067267999744826,651,"Take two, and call me if you have trouble swallowing them."
4142,4282,13,43,185,241,1.2863070539419088,0.03606817284857937,651,"Difficulty breathing, huh?"
7398,4282,10,49,182,241,1.2863070539419088,0.034600269548097064,651,I've ruled out angina. I'm referring you to the veterinarian.
7951,4282,14,41,186,241,1.2863070539419088,0.03654437356483676,651,The test shows your face and legs are unaffected.
8024,4282,13,43,185,241,1.2863070539419088,0.03606817284857937,651,Your chart says you’ve been having chest pains. Could you eleaborate on that for me?
4819,4282,16,37,188,241,1.2863070539419088,0.037478627675903806,651,"Your breathing is constricted? Could be a number of things, it’s never obvious."
4751,4291,13,45,190,248,1.2862903225806452,0.03537919992405329,651,You’re lucky I was able to squeeze you in.
7765,4291,12,47,189,248,1.2862903225806452,0.034914723604742404,651,In the future I want you two to see our herpetologist.
1175,4291,13,45,190,248,1.2862903225806452,0.03537919992405329,651,Not to state the obvious...
4719,4291,11,49,188,248,1.2862903225806452,0.034443984402577184,651,"‘Sorry, but I only see the one insurance card”"
1701,4291,10,51,187,248,1.2862903225806452,0.03396672192977127,651,This thing is going around; it's not as constricting as you think.
1310,4291,13,45,190,248,1.2862903225806452,0.03537919992405329,651,"All right, it's not gluten intolerance..."
3916,4291,10,51,187,248,1.2862903225806452,0.03396672192977127,651,"Yes Mr. Adam, it's an apple a day, but not just any apple."
1380,4298,14,45,196,255,1.2862745098039217,0.035166943610020596,651,So how long have you been short of breath?
1693,4298,18,37,200,255,1.2862745098039217,0.03688126754042639,651,How long have you felt the tightness in your chest?
1710,4298,14,45,196,255,1.2862745098039217,0.035166943610020596,651,We're all done; that's a wrap.
2338,4298,14,45,196,255,1.2862745098039217,0.035166943610020596,651,They call it 'the grip'.
3000,4298,13,47,195,255,1.2862745098039217,0.034725141176686854,651,And you say you've seen an increase in your blood pressure?
4371,4303,14,47,201,262,1.286259541984733,0.03452941694469296,651,I'm recommending a constricted diet.
4869,4303,13,49,200,262,1.286259541984733,0.03410327215617068,651,"Trust me, it’s non-venomous."
145,4305,14,49,206,269,1.2862453531598512,0.033922550631730324,651,What result are you hoping for?
4741,4305,16,45,208,269,1.2862453531598512,0.0347307371049656,651,"Can't help you, but I know a great snake charmer."
8138,4305,13,51,205,269,1.2862453531598512,0.033511149071858815,651,"So then, anything else apart from those chest pains?"
4920,4308,10,59,207,276,1.286231884057971,0.03172420703056764,651,"I’ll write you a prescription for something that’ll help you unwind a bit, Mr Barnes."
8737,4309,13,36,168,217,1.2857142857142858,0.03872369482628427,651,"Good news, you’re wife is not the one suffocating you."
8499,4309,18,38,203,259,1.2857142857142858,0.03646585807082923,651,"Well, your insurance doesn't cover mortal coil, so you'll have to shuffle off."
8387,4309,13,42,183,238,1.2857142857142858,0.036359975336410194,651,The X-ray shows extra vertebrae.
7978,4309,16,44,206,266,1.2857142857142858,0.03498691855443896,651,A feeling of chest pressure you say.  We're going to have to run some tests.
7938,4309,12,46,187,245,1.2857142857142858,0.03518340799381935,651,"Well, I don’t think you’ll get them confused a second time."
7342,4309,14,42,189,245,1.2857142857142858,0.03612179686512665,651,You’re up 5lbs. since your last visit.
7022,4309,19,34,199,252,1.2857142857142858,0.037601140285684335,651,Seems to be a lot of this going around.
5959,4309,12,50,197,259,1.2857142857142858,0.033914262927438786,651,No more apples for you and the missus.
6504,4309,17,38,197,252,1.2857142857142858,0.036750600589921044,651,"I noticed you got a little choked up when I mentioned your wife"""
4375,4309,16,34,181,231,1.2857142857142858,0.038595436268914304,651,So Adam how and where did you two first meet
4279,4309,12,44,182,238,1.2857142857142858,0.03586907561676672,651,We broke up. She left the snake.
7832,4309,15,42,195,252,1.2857142857142858,0.03587990435684155,651,"So, do you have any family history of respiratory problems?"
1527,4309,15,42,195,252,1.2857142857142858,0.03587990435684155,651,He said you taste like chicken?
1012,4309,14,40,184,238,1.2857142857142858,0.036844335077829624,651,"In this case, DO NOT take a deep breath."
411,4309,11,42,171,224,1.2857142857142858,0.03681829813938281,651,"It looks like your disease has evolved to fight the antibiotics, so I’m prescribing you a mongoose."
1625,4309,7,56,182,245,1.2857142857142858,0.032719904817935325,651,"Sorry, these residency hours are killing me. What did you say about chest tightness?"
1749,4309,8,52,178,238,1.2857142857142858,0.03383432727496165,651,I’m afraid we need prepayment even though you claim “you can’t reach your wallet”
3637,4309,16,44,206,266,1.2857142857142858,0.03498691855443896,651,Your symptoms are strangely similar to those inflicted by marriage.
2017,4309,18,30,183,231,1.2857142857142858,0.03955875039225325,651,So how long have you had this man-shaped growth?
2316,4309,12,44,182,238,1.2857142857142858,0.03586907561676672,651,"Okay, take off your snake, stand up, turn your head and cough."
2665,4309,16,34,181,231,1.2857142857142858,0.038595436268914304,651,Something seems to be constricting your breathing.
2864,4309,11,44,176,231,1.2857142857142858,0.036074785117390484,651,"Your blood pressure is elevated, but other than that, I can't find anything clinically wrong with you."
6156,4331,19,43,222,284,1.2852112676056338,0.034542370015418516,651,Auto erotic asp fixation... a lot more common than you’d imagine.
8584,4332,17,45,215,277,1.2851985559566788,0.03439982420894654,651,"I've finally figured out your diagnosis, Mr. Callahan.  If it had been a snake it would've bitten me."
4528,4333,12,53,205,270,1.2851851851851852,0.03298887298185943,651,"Whatever you do, don’t say “ahh.”"
8275,4334,17,41,205,263,1.285171102661597,0.03565772998474845,651,"Yeah, there's a lot going around now."
8429,4334,19,37,207,263,1.285171102661597,0.03646263573713702,651,I'm referring you for an attachment disorder.
6072,4336,17,39,200,256,1.28515625,0.036334754231216314,651,Have a friend..a very good friend...give you these.  They may help you unwind
5780,4336,10,53,193,256,1.28515625,0.03325287327027796,651,Looks like you already tried to get the gerbil out...
4451,4336,16,41,199,256,1.28515625,0.03591068239592408,651,"Cortisone cream should help 
with the shedding."
7541,4336,19,35,202,256,1.28515625,0.03716838542157587,651,Your blood pressusre is up a bit.
3293,4336,14,45,197,256,1.28515625,0.03504714824828134,651,"And on a scale from one to ten, how would you rate your pain?"
2387,4336,8,57,191,256,1.28515625,0.03231840142898849,651,"So tell me, when did you first feel the tightness in your chest?"
9150,4336,17,39,200,256,1.28515625,0.036334754231216314,651,"A squeezing sensation in your chest and arms, sweating, 
 abdominal pain,  shortness of breath, Mr. Jones you're having a heart attack!"
3908,4336,12,49,195,256,1.28515625,0.03416179284717195,651,Are you experiencing any tightness in chest?
6625,4344,14,43,192,249,1.285140562248996,0.035711953655542326,651,So...did this felling of impending doom come on just today?
6754,4344,14,43,192,249,1.285140562248996,0.035711953655542326,651,When did you first notice the choking sensation?
4407,4344,9,53,187,249,1.285140562248996,0.033367732302561966,651,It looks like you've got pernicious pythonitis.
1471,4344,12,47,190,249,1.285140562248996,0.03479322353481403,651,You said you feel a constricting in your chest?
817,4344,16,39,194,249,1.285140562248996,0.036607633955879605,651,You say both your father and grandfather were smokers?
5665,4349,17,35,190,242,1.2851239669421488,0.03779855747022005,651,"So how was your trip to India, Mr. Jones?"
981,4349,10,49,183,242,1.2851239669421488,0.03447730136186812,651,Well I can see that you are pretty tightly wound up.
1336,4349,16,37,189,242,1.2851239669421488,0.03734218218081117,651,"Your cholesterol's fine , but I'm worried about your venom ."
1615,4349,14,41,187,242,1.2851239669421488,0.03641227562808481,651,"I don't see this specifically covered anywhere, but maybe we can enter it as a general systemic constriction."""
3019,4349,9,51,182,242,1.2851239669421488,0.033976343717245935,651,....And call me if you feel any tightening around your chest.
6561,4349,11,47,184,242,1.2851239669421488,0.034971083569167685,651,When was the last time you molted?
4357,4355,8,51,176,235,1.2851063829787235,0.03408798568627076,651,I distinctly heard a rattle in your chest upon breathing.
6755,4355,15,37,183,235,1.2851063829787235,0.03763751469080877,651,"And besides that, are you experiencing any unusual pressure or tightness?"
8579,4355,8,51,176,235,1.2851063829787235,0.03408798568627076,651,I think you should start by switching to Fish Oil.
3166,4355,14,39,182,235,1.2851063829787235,0.03715120809562778,651,So the inhaler isn't working?
7875,4355,11,45,179,235,1.2851063829787235,0.03565251064870495,651,There's something going on with with your urine sample.
1398,4355,13,41,181,235,1.2851063829787235,0.03665845078325641,651,"No, the Anaconda diet is not a safe weight loss plan."
1042,4355,11,45,179,235,1.2851063829787235,0.03565251064870495,651,"I'm referring you to our herpetologist, for an appointment in three weeks."
1546,4355,15,37,183,235,1.2851063829787235,0.03763751469080877,651,"The Hippocratic oath says ""Do no harm"", so you're on your own."
1987,4363,10,45,173,228,1.2850877192982457,0.03583688018947057,651,The upside is that you’re not allergic to snake skin
7964,4363,12,41,175,228,1.2850877192982457,0.036899426920224666,651,I'll send the herpetologist right in...
5567,4365,12,39,170,221,1.2850678733031675,0.03768297577888516,651,"Yeah, I'm having a rough day. Anyways, where'd you get the snake?"
2034,4366,17,27,170,214,1.2850467289719627,0.041263700012474126,651,Do you have any shortness of breath?
2535,4366,13,35,166,214,1.2850467289719627,0.039079215227580066,651,Let's get you some tests to get to the bottom of this shortness of breath.
4786,4366,9,43,162,214,1.2850467289719627,0.036765162680009913,651,"I believe what I prescribed last visit were compression SOCKS, not SNAKES."
8984,4366,15,31,168,214,1.2850467289719627,0.04018630364641032,651,When did you start feeling it was hard to breathe?
6165,4370,16,44,207,267,1.2846441947565543,0.034872057474908555,651,Be honest: this desert nudist colony isn't working for you.
2574,4371,15,44,201,260,1.2846153846153847,0.03509469169950833,651,"Mr. Charmer, I do suspect family history is in play here."
947,4372,16,40,197,253,1.284584980237154,0.03619165160133168,651,"I'm going to write you a boa conscription. Get it?"""
297,4372,12,48,193,253,1.284584980237154,0.0344144919951497,651,"If your wife doesn’t mind you are wearing her boa, what’s the issue?"
4033,4374,15,40,191,246,1.2845528455284554,0.03645146301155683,651,It may be time to consider an alternative medicine practitioner.
4444,4375,9,50,180,239,1.284518828451883,0.03423115148661073,651,"It's cold-blooded, that's why."
144,4375,14,40,185,239,1.284518828451883,0.03670932130519372,651,Let's follow up in a couple of weeks.
2494,4375,14,40,185,239,1.284518828451883,0.03670932130519372,651,You seem to be experiencing some constriction.
4412,4375,10,48,181,239,1.284518828451883,0.0347409303245757,651,You're just too charming.
8319,4379,11,44,177,232,1.2844827586206897,0.03594005982037896,651,"Unbelievable as it seems, you need snake oil."
8094,4379,11,44,177,232,1.2844827586206897,0.03594005982037896,651,You should shed in 4-6 weeks. Stay on a constricted diet.
7733,4379,15,36,181,232,1.2844827586206897,0.037960030443051476,651,Surgically we will have a problem reaching your hernia.
2129,4379,13,40,179,232,1.2844827586206897,0.036963845924969804,651,Have you been in the tropics recently?
3341,4379,10,46,176,232,1.2844827586206897,0.035417070701233525,651,I see you are complaining of chest pressure.
3708,4379,10,46,176,232,1.2844827586206897,0.035417070701233525,651,"Hmm, your blood pressure is a little high. I'd like to run some more tests."
7842,4385,13,38,174,225,1.2844444444444445,0.0377427475309053,651,"Oh, I don't think you'll be feeling those aches and pains too much longer."
2058,4385,10,44,171,225,1.2844444444444445,0.036131252014482404,651,"It says here you are feeling a sensation of pressure in your neck, chest and waist.  Have you traveled to a foreign country in the past few days?"
8719,4385,12,40,173,225,1.2844444444444445,0.037213337011065245,651,It seems you have a severe case of COILITIS.
7428,4385,14,36,175,225,1.2844444444444445,0.03826483412827236,651,Looks like you have a boa obstruction.
6131,4389,16,45,210,271,1.2841328413284132,0.03450617500394967,651,"If you're feeling bound up, consider eliminating gluten from your diet."
7673,4390,14,47,203,264,1.2840909090909092,0.03430149652110142,651,Coilitis is usually a matter of internal medicine...
4770,4390,9,57,198,264,1.2840909090909092,0.032133578296885706,651,"So, how long have you have you had this constricted feeling?"
188,4392,15,41,194,250,1.284,0.03603568066686819,651,"Well, I'll need to run a series of tests to determine just what is causing your discomfort."
9006,4392,11,49,190,250,1.284,0.03420608461808511,651,This looks like a problem for the vet.
2702,4392,17,37,196,250,1.284,0.036916491020097614,651,Take this and try to relax and unwind a bit.
3405,4392,19,33,198,250,1.284,0.0377767698109486,651,"When you said python, I worried it was the Viagra."
6180,4392,12,47,191,250,1.284,0.03467253580221417,651,It appears your tension has transferred to your emotional support animal.
7580,4392,12,47,191,250,1.284,0.03467253580221417,651,Can you take a deep breath?
4690,4398,13,43,187,243,1.2839506172839505,0.03580932914375716,651,Where did Miss Eve go after the apple was eaten?
1111,4398,14,41,188,243,1.2839506172839505,0.036281099607732015,651,"Intake said you are having difficulty catching your breath, is that correct ?"
8549,4400,13,41,182,236,1.2838983050847457,0.03652277336654127,651,Would you prefer to see a veterinarian or an anesthesiologist?
5884,4400,12,43,181,236,1.2838983050847457,0.03602569843455969,651,"It may seem primitive, but, I don't have to wear rubber gloves and you don't have to cough."
4449,4400,12,43,181,236,1.2838983050847457,0.03602569843455969,651,"Been hanging out in Washington again, I see."
2701,4400,15,37,184,236,1.2838983050847457,0.03749716026255236,651,The good news is that this doesn't appear to be malignant.
8552,4404,15,35,179,229,1.2838427947598254,0.03829023680214012,651,"Looking for Xanax again, Jim?"
303,4404,11,43,175,229,1.2838427947598254,0.03623424833927479,651,"Nobody's happy about an OCD diagnosis, but we passed 'wait and see if he grows out of it' months ago."
3381,4406,11,41,170,222,1.2837837837837838,0.036987808126110196,651,"A ""tightness,"" you say?"
8871,4407,9,58,201,268,1.2835820895522387,0.031819214694150506,651,I think it's time for you to unwind.
7479,4408,16,42,203,261,1.2835249042145593,0.03539577858844397,651,"So,how long does the home shopping network recommend that you wear this ""natural body slimming belt""?"
7412,4408,15,44,202,261,1.2835249042145593,0.03497697383446146,651,"So you are saying, after he ate Eve....."
8643,4408,12,50,199,261,1.2835249042145593,0.03368933612910711,651,Spay or neuter?
2937,4408,11,52,198,261,1.2835249042145593,0.033249043979555484,651,Don't blame this on me.  You knew the possible side effects.
250,4408,15,44,202,261,1.2835249042145593,0.03497697383446146,651,"And the bad news is, 'You're not long for this mortal coil.'"
4049,4413,9,54,191,254,1.2834645669291338,0.032907737112809116,651,What makes you think that your stiff neck is related to your constricted breathing?
199,4413,12,48,194,254,1.2834645669291338,0.034297039778297365,651,Maybe a therapy boa wasn't the best choice.
6576,4413,12,48,194,254,1.2834645669291338,0.034297039778297365,651,"...and on a scale of 1-to-10, how charming do you feel?"
8778,4413,16,40,198,254,1.2834645669291338,0.03606629042626816,651,Are you experiencing any other ssssssymptoms?
3822,4417,7,56,184,247,1.2834008097165992,0.03249546264211014,651,Obviously you will have some dietary restrictions
668,4417,16,38,193,247,1.2834008097165992,0.03677217524863525,651,And... can you describe your pain?
3111,4417,12,46,189,247,1.2834008097165992,0.03493610792397525,651,Your blood pressure seems a bit high.
1223,4420,12,44,184,240,1.2833333333333334,0.035609196520021175,651,"Happens all the time. Don’t know why we keep putting the snake back in the dressing room, though."
645,4420,9,50,181,240,1.2833333333333334,0.03410883120749283,651,I call it the Constrictive Diet.
5105,4420,16,36,188,240,1.2833333333333334,0.03751646159685758,651,We are still working out the kinks in our new organic blood pressure monitor.
7721,4423,15,36,182,233,1.2832618025751072,0.037816475985540735,651,"While you may have a problem breathing, you should have no trouble relieving yourself."
8347,4423,12,42,179,233,1.2832618025751072,0.03631927658724948,651,"I'm giving you something for your congestion, but keep feeding him the mice."
7005,4425,17,30,179,226,1.2831858407079646,0.0396335490998665,651,The good news is I think we found the cause of that lisp.
4865,4425,15,34,177,226,1.2831858407079646,0.03862842840087516,651,I'll need to have you take off your snake to listen to your heart and lungs.
1584,4425,15,34,177,226,1.2831858407079646,0.03862842840087516,651,"The good news is that he's gotten much stronger.  I mean, it's good news for him..."
4958,4428,14,51,214,279,1.2831541218637992,0.033032373921448026,651,So it says here that you’re allergic to penicillin. Is that right?
8814,4429,12,38,169,219,1.2831050228310503,0.037864171172757345,651,You really shouldn't take the blue cross blue shield symbol so literally.
2358,4430,14,45,199,258,1.2829457364341086,0.034809910618105906,651,'So you rubbed the lamp and wished for ...?'
2653,4430,11,51,196,258,1.2829457364341086,0.03348492688932393,651,I suggest you stay away from apples.
738,4430,15,43,200,258,1.2829457364341086,0.03524050311870665,651,The good news is I've ruled out angina as the cause of your symptoms.
8670,4433,12,34,159,205,1.2829268292682927,0.03960295649491572,651,"Todd, I must say, you're really in a tight spot here..."
6138,4434,11,49,191,251,1.2828685258964143,0.034088316200366495,651,You’re authorized to fly with the lumbar support snake—and don’t forget your compression socks.
1081,4434,14,43,194,251,1.2828685258964143,0.0354630911125447,651,What is the problem today?
8180,4434,10,51,190,251,1.2828685258964143,0.03361756670873146,651,"Unfortunately, it looks like a pre-existing condition and won’t be covered"
4618,4434,14,43,194,251,1.2828685258964143,0.0354630911125447,651,I see the snake-oil salesman got you again.
7482,4434,15,41,195,251,1.2828685258964143,0.03590965526452191,651,Tell me where it hurts.
6800,4434,14,43,194,251,1.2828685258964143,0.0354630911125447,651,When did you first notice problems with swallowing?
8663,4440,11,47,186,244,1.2827868852459017,0.03472303093606672,651,I am going to have to refer you on to a veterinarian.
7586,4440,11,47,186,244,1.2827868852459017,0.03472303093606672,651,I see that your blood pressure is a little elevated. I'm recommending a low-sodium diet.
6963,4440,14,41,189,244,1.2827868852459017,0.03615083633406252,651,This is the worst case of constrictive pericarditis I’ve ever seen.
6258,4440,14,41,189,244,1.2827868852459017,0.03615083633406252,651,"I usually don't recommend this to my patients,but I think it's time to shuffle off this mortal coil."
1146,4440,16,37,191,244,1.2827868852459017,0.03707216873202314,651,Two drops on the forked tongue and call me in the morning.
5589,4440,11,47,186,244,1.2827868852459017,0.03472303093606672,651,"First, I'm recommending you see a podiatrist about your ingrown nail."
8603,4446,12,43,182,237,1.2827004219409284,0.035893363495937844,651,"So now that you have your diagnosis, let’s discuss your restrictions."
9239,4446,16,35,186,237,1.2827004219409284,0.03783337635202429,651,He's my emotional support snake
6588,4448,8,49,173,230,1.2826086956521738,0.0344834773538859,651,"Now as to stress reduction, I'm not sure how much time you should spend in your garden."
6039,4448,14,37,179,230,1.2826086956521738,0.037642315176255166,651,"Let's switch to the lower strength asp, Aaron."
830,4450,11,41,171,223,1.2825112107623318,0.036843553782144906,651,"And so, you really want to discuss your ingrown toenail?"
1612,4450,8,47,168,223,1.2825112107623318,0.035160347334509276,651,So how's the family?
1614,4450,15,33,175,223,1.2825112107623318,0.03897491538734154,651,You said your name is Eve?
3056,4450,11,41,171,223,1.2825112107623318,0.036843553782144906,651,Have him take 2 small rats & I'll call him in the morning.
4010,4450,10,43,170,223,1.2825112107623318,0.036291160242676826,651,Any particular stress at home recently?
6910,4455,14,44,197,255,1.2823529411764707,0.03507212362724536,651,I'd like to refer your case to a veterinarian.
6130,4455,13,46,196,255,1.2823529411764707,0.03462911149012124,651,"So far, we can conclude that a heart attack has not caused the tightness in your chest."
2135,4457,14,42,192,248,1.282258064516129,0.03573925337970029,651,So you say you have trouble breathing ?
4646,4457,18,34,196,248,1.282258064516129,0.037521909381329765,651,"I have to disagree, Mr. Wolf. I think the Sheep's Clothing would have been the better option."
6121,4457,12,46,190,248,1.282258064516129,0.03481371147116129,651,Would you kindly remove your scarf?
6902,4457,17,36,195,248,1.282258064516129,0.03708427996806931,651,And how long have you had trouble breathing?
7248,4457,17,36,195,248,1.282258064516129,0.03708427996806931,651,"Nope,it was not from the MMR vaccine. Next question..."
8517,4457,14,42,192,248,1.282258064516129,0.03573925337970029,651,It's COPD. The elephant form is more common.
7335,4457,14,42,192,248,1.282258064516129,0.03573925337970029,651,I’m afraid it’ssssssssssssss bad news...
432,4457,18,34,196,248,1.282258064516129,0.037521909381329765,651,"Yeah, there’s been a lot of that going around."
5724,4457,17,36,195,248,1.282258064516129,0.03708427996806931,651,He doesn’t like it when I fart
3585,4466,11,35,156,202,1.2821782178217822,0.03936464069193373,651,"So, Mr. Harrington, you've complained about some tightness in the chest?"
7001,4467,12,44,185,241,1.2821576763485478,0.03548061585023104,651,I took it from Manafort's closet
6217,4467,13,42,186,241,1.2821576763485478,0.03596459714389983,651,"Squeezing chest pain, cool clammy skin, feels like you're about to pass out... sir, this may come as a surprise, but it sounds like you may be having a heart attack."
5511,4469,12,42,180,234,1.2820512820512822,0.03618398733586367,651,"Well, it's not constipation."
2596,4469,10,46,178,234,1.2820512820512822,0.03515559783718817,651,To save your life I’d have to kill the snake and I just won’t do that.
1080,4469,16,34,184,234,1.2820512820512822,0.03815770826432857,651,"Ok.  I’ll prescribe a muscle relaxer for him, but not Valium. It may be addicting."
4132,4472,15,45,206,266,1.281954887218045,0.03449026571335485,651,Call me if your condition tightens.
2186,4472,16,43,207,266,1.281954887218045,0.03489915826803524,651,I think it's time to assess your pet preferences.
1082,4472,13,49,204,266,1.281954887218045,0.03365758148320698,651,"So, what happened to your clothes?"
2286,4475,7,50,170,227,1.2819383259911894,0.03418605490799981,651,"Overall, your numbers look good. But we need to discuss your blood pressure."
3731,4475,12,40,175,227,1.2819383259911894,0.036927097430869096,651,"When it comes to taking blood pressure, I'm old school."
86,4475,11,42,174,227,1.2819383259911894,0.03639540753679885,651,What kind of a pressure?
7238,4475,11,42,174,227,1.2819383259911894,0.03639540753679885,651,We'll be able to prescribe the correct snake oil once the lab identifies whether it's a boa or python.
2903,4475,12,40,175,227,1.2819383259911894,0.036927097430869096,651,"It's not yet covered by insurance, but it will definitely control your addictive cravings."
5309,4480,16,41,202,259,1.281853281853282,0.03554471650976355,651,notice any difficulty breathing lately
5868,4480,12,49,198,259,1.281853281853282,0.033818719990647915,651,"Well, it looks like we've got that tightness in your chest pegged."
7516,4480,19,35,205,259,1.281853281853282,0.03678610687779645,651,So the medical consensus is that you were definitely not on Amazon Wardrobe when you ordered the Burmese Wrap.
6627,4483,8,46,166,220,1.2818181818181817,0.035443953245280733,651,You say she wanted to honeymoon in the Amazon?
7090,4483,7,48,165,220,1.2818181818181817,0.034853447766878626,651,Limited Mobility
8624,4485,14,43,195,252,1.2817460317460319,0.03533991549651505,651,"I understand you've been eating a lot of fiber, however, you seem to be sidestepping the real issue."
231,4485,12,47,193,252,1.2817460317460319,0.034433566766122504,651,"Just tell me where it hurts, and we'll go from there."
1634,4485,12,47,193,252,1.2817460317460319,0.034433566766122504,651,Are you allergic to any medications?
8427,4485,12,47,193,252,1.2817460317460319,0.034433566766122504,651,Sorry. There's a lot of this going around.
8256,4485,14,43,195,252,1.2817460317460319,0.03533991549651505,651,Next time I would stick to a feather boa.
3963,4485,12,47,193,252,1.2817460317460319,0.034433566766122504,651,Do you feel any tightness in the chest?
2073,4491,13,34,166,213,1.2816901408450705,0.039118020089627205,651,"So tell me, exactly when did this shortness of breath begin?"
8692,4491,10,40,163,213,1.2816901408450705,0.0373811020140751,651,I'm afraid you’ll have to speak with your veterinarian about attachment issues.
1667,4493,15,39,191,245,1.2816326530612245,0.036482910965989046,651,"Stiff neck, trouble breathing, and heart palpitations - lets start you on Amoxicillin for five days - give us a call if you don't feel better in three"
5598,4493,14,41,190,245,1.2816326530612245,0.036021476749285596,651,Have you felt any tightness in your chest?
4135,4495,10,47,181,238,1.281512605042017,0.034756347305438404,651,Better out than in.
3769,4495,15,37,186,238,1.281512605042017,0.037219481220610785,651,"While Nurse Slithers takes your blood pressure and pulse, I'd like to ask you a few questions about your medical history."
1100,4495,10,47,181,238,1.281512605042017,0.034756347305438404,651,I'm giving you a prescription for antiheptamine.
6942,4495,13,41,184,238,1.281512605042017,0.03625431478604087,651,Yet you each claim the other is codependent.
3784,4499,18,40,212,270,1.2814814814814814,0.03532025495945297,651,"Well, your boa density has improved since your last visit."
5542,4500,12,41,178,231,1.2813852813852813,0.03648130603480133,651,Just a little snake oil and call me in the morning
6632,4500,13,39,179,231,1.2813852813852813,0.03699363737062385,651,We're trying out this new blood-pressure cuff.
8974,4500,17,31,183,231,1.2813852813852813,0.03897567535690381,651,You’ll really feel the squeeze when the bill arrives.
579,4503,15,44,204,263,1.2813688212927756,0.034743819745977095,651,An apple a day is good but try to avoid temptation.
8397,4504,9,45,170,224,1.28125,0.03559271228103894,651,It seems to be a case of separation anxiety.
8806,4504,10,52,194,256,1.28125,0.03315285085189271,651,Does this hurt?
5330,4504,9,54,193,256,1.28125,0.0326875246035224,651,And you say it started with a heavy sensation around your stomach then traveled to your throat?
8202,4504,15,42,199,256,1.28125,0.03538781985539159,651,"I apologize, Mr. Slithers always gets anxious at the vet..."
4665,4504,13,46,197,256,1.28125,0.03451120519938018,651,We can't figure out what's causing your symptoms. We recommended getting an MRI
9093,4509,17,45,219,281,1.2811387900355873,0.03396932503083019,651,I recommend an alarm clock that doesn’t play sounds of the rainforest.”
2561,4510,15,40,194,249,1.2811244979919678,0.03606532169212347,651,So you've described a feeling of tightness in your chest. Any shortness of breath?
8020,4510,12,46,191,249,1.2811244979919678,0.03469214008717612,651,"So, Mr. Thomas, are you experiencing any tightness in your chest?"
8029,4510,14,42,193,249,1.2811244979919678,0.035613477979275186,651,A few more questions and we should be able to wrap this up.
1458,4513,6,49,162,217,1.2811059907834101,0.034519516212356736,651,"Some vitamin A for you, and a chicken a day for him"
6954,4514,8,61,205,274,1.281021897810219,0.030886934975497302,651,"Mr. Smith, I think we've identified the cause of your high blood pressure."
4238,4515,13,42,187,242,1.28099173553719,0.03583464772675861,651,"Well,the good news is that the tightening in your chest isn't a heart attack...."
9182,4515,16,36,190,242,1.28099173553719,0.037242436925029425,651,"Take aspirin, drink plenty of fluids, get some rest, and contact your herpetologist if things don't improve."
5558,4515,12,44,186,242,1.28099173553719,0.03535292916996058,651,You feel constricted? Tell me more.
2801,4515,17,34,191,242,1.28099173553719,0.03770001969388652,651,Undress and put on the gown.
4817,4515,9,50,183,242,1.28099173553719,0.03386668673611785,651,"Lovely boa, but I'll need you to remove it so I can examine you."
3884,4520,16,43,208,267,1.2808988764044944,0.03478423746950592,651,So I'm writing you a prestriction...
8654,4520,14,47,206,267,1.2808988764044944,0.03396502023571124,651,...next question...Do you feel safe at home?
2343,4522,7,52,176,235,1.2808510638297872,0.033432430380000024,651,Then just don’t breathe out.
5294,4522,17,32,186,235,1.2808510638297872,0.03848934777929621,651,"I'm sorry, but I can't treat you until you have signed this consent form!"
5777,4522,16,34,185,235,1.2808510638297872,0.03801394011858555,651,"I dunno Doc, I just feel life's just closing in on me."
8650,4525,11,35,157,203,1.2807881773399015,0.03919490274513319,651,"Adam, Why couldn't you just eat the apple like Eve suggested?"
8165,4525,8,41,154,203,1.2807881773399015,0.037281635566001725,651,I believe your shortness of breath is due to a 150 pound weight gain.
3335,4527,11,51,198,260,1.2807692307692307,0.03326233939108669,651,"No, Dave. It's you who needs to relax."
9222,4527,9,55,196,260,1.2807692307692307,0.032357119191420265,651,Would you say its been growing in size?
238,4529,16,32,180,228,1.280701754385965,0.038829751336138925,651,"And how long have you felt this ""tightness?"""
3586,4529,10,44,174,228,1.280701754385965,0.03571963623620467,651,I asked you to undresssssss...
5197,4529,10,44,174,228,1.280701754385965,0.03571963623620467,651,When did you first feel this constriction?
8225,4529,10,44,174,228,1.280701754385965,0.03571963623620467,651,Any tingling in your extremities?
9188,4529,9,46,173,228,1.280701754385965,0.035174558279863585,651,"It's more flexible than the standard cervical collar, and it breathes!"
484,4529,10,44,174,228,1.280701754385965,0.03571963623620467,651,We haven't used leeches in years.
500,4535,19,33,201,253,1.2806324110671936,0.037378134756488685,651,Call back in two weeks for the test results.
8780,4535,19,33,201,253,1.2806324110671936,0.037378134756488685,651,My assistant will take your blood pressure.
7777,4537,8,46,167,221,1.2805429864253393,0.035306245213594364,651,Two aspirins and call your herpetologist in the morning.
1040,4538,11,47,188,246,1.2804878048780488,0.034478345200458525,651,Your vitals look good but I did notice a slight rasp in your breathing.
2705,4538,9,51,186,246,1.2804878048780488,0.03350206377438709,651,You'll need to see a herpetologist.
3788,4538,9,51,186,246,1.2804878048780488,0.03350206377438709,651,I am afraid your HMO does not cover constrictors but I am authorized to prescribe you a wide array of blood pressure medications.
5639,4538,16,37,193,246,1.2804878048780488,0.03680592770613431,651,"Feel like the walls are closing in around you, and you're short of breath... Stop watching the news and call me in a week."""
1604,4538,13,43,190,246,1.2804878048780488,0.03542773346378319,651,"With about two days of human body heat, she should be fine."
2096,4543,10,40,164,214,1.280373831775701,0.037229291446105796,651,"Well, I am noting in your chart here your weight gain."
2495,4544,11,45,183,239,1.2803347280334727,0.035134637647085326,651,"I bet he gave you that ""apple a day"" line too."
2951,4544,13,41,185,239,1.2803347280334727,0.03612151406056297,651,"I'm pretty sure that when the Evite said 'boa', it meant wear the fuzzy kind."
3999,4544,13,41,185,239,1.2803347280334727,0.03612151406056297,651,Unfortunately your insurance does not cover boas.
3289,4544,9,49,181,239,1.2803347280334727,0.03411922840798899,651,The good news is your skin condition has cleared up nicely.
6038,4548,15,44,205,264,1.2803030303030303,0.03462836949562047,651,"So, when you offered the chance on Craig's List to be someone's ""main squeeze"" you were thinking it would be...what...a woman? or something else?"
4068,4548,16,42,206,264,1.2803030303030303,0.0350418198130495,651,You can get dressed now. I'll see you in my office.
5353,4550,15,35,182,232,1.2801724137931034,0.0378528809182297,651,The good news is that this will be covered by your wrap-around policy.
2872,4550,10,45,177,232,1.2801724137931034,0.035302203608676565,651,"Sorry dude, you're afflicted with a metaphor consisting of crushing student debt, low job prospects, and high housing costs."
2304,4550,17,31,184,232,1.2801724137931034,0.0388262617242784,651,"Once again Steve, a Caduceus costume does not guarantee you free health care. Snake removal will be $7,983"
2425,4550,13,39,180,232,1.2801724137931034,0.03685380018583144,651,"Coincidentally, we also bill on a sliding scale."
7897,4550,9,47,176,232,1.2801724137931034,0.0347696214646092,651,"The side effects of the prescription are a little constriction at first, but once the skin sheds, you will be fine."
4139,4555,8,56,193,257,1.2801556420233462,0.0321085358834611,651,And... bred in captivity or in the wild?
9003,4555,16,40,201,257,1.2801556420233462,0.035695220100989834,651,"So tell me again...you were feeling kind of cold, and then you did what?"
385,4555,12,48,197,257,1.2801556420233462,0.03394927697785049,651,"Trust me, the python body wrap is currently our most popular treatment for weight loss."
2048,4558,13,44,193,250,1.28,0.03503297356702384,651,Just ice it.
6901,4558,14,42,194,250,1.28,0.03548855802937076,651,You could stand to lose 550 pounds.
7322,4558,12,46,192,250,1.28,0.03457138589775605,651,And when did the headaches start?
1513,4558,7,56,187,250,1.28,0.03216423716817238,651,And you haven't been out of the country recently?
2924,4558,14,42,194,250,1.28,0.03548855802937076,651,So let's slip a gown on and you can tell me about your symptoms.
7017,4563,16,43,209,268,1.2798507462686568,0.034670049414841676,651,"Your full physical examination today does not require for you to get completely snaked Mr. Sssssmith, you may leave your pythong on."
4727,4564,11,46,186,243,1.2798353909465021,0.03474003361118934,651,"I'm studying for my psychiatry boards, and this looks like a classic case of codependency to me."
3603,4564,10,48,185,243,1.2798353909465021,0.034247040752250824,651,And you say you're still feeling tightness in your chest?
1938,4566,15,31,172,218,1.2798165137614679,0.03953263315631227,651,"One thing I can rule out, you don’t have an intestinal parasite."
23,4566,7,47,164,218,1.2798165137614679,0.0349943653050942,651,Usually we don't allow pets in the exam room.
7658,4568,12,42,182,236,1.2796610169491525,0.03591631217163066,651,Good news! We can rule out vascular constriction.
3730,4568,15,36,185,236,1.2796610169491525,0.03739207884121614,651,"First, I want to run a couple of tests on both of you.
Then, we'll see."
1592,4570,15,41,198,254,1.279527559055118,0.03553666141275423,651,I’m going to refer you to an herpetologist.
4628,4570,18,35,201,254,1.279527559055118,0.036826920588519114,651,"First, I don't think your problem is herpes, and, second, even it it was, a herpetologist couldn't help you."
5256,4570,11,49,194,254,1.279527559055118,0.033739649328452206,651,You have a constriction of your large boa.
8666,4570,16,39,199,254,1.279527559055118,0.0359718903625343,651,That tightness in your chest?  I think I know the source.
4955,4574,13,38,178,229,1.279475982532751,0.0371640669941277,651,Your only hope for recovery is snake oil.
6745,4574,12,40,177,229,1.279475982532751,0.036645088417563955,651,The good news is we won't need to apply a tourniquet for the bite wounds
7087,4574,14,36,179,229,1.279475982532751,0.037675897414088805,651,"So, this is your new squeeze?"
7216,4574,12,40,177,229,1.279475982532751,0.036645088417563955,651,My number one question is; where does his tail start?
4483,4578,10,56,206,272,1.2794117647058822,0.03184778385673,651,"This will cure your phobia, one way or the other."
5892,4579,11,47,189,247,1.2793522267206479,0.034357244774976085,651,Some snake oil should  help ease the squeeze.
6132,4579,8,53,186,247,1.2793522267206479,0.03288881788385072,651,"I find you to be in excellent health,but I think you might be more comfortable if you removed the snake."
8678,4579,11,47,189,247,1.2793522267206479,0.034357244774976085,651,Any other symptoms besides chest tightness?
7748,4579,11,47,189,247,1.2793522267206479,0.034357244774976085,651,"Its a tight  squeeze, but i think i can fit you in at 11.30 tomorrow"
2282,4579,9,51,187,247,1.2793522267206479,0.033385470652774585,651,Look im not going to prescribe you antibiotics for that sore throat. I think you’ve just been under a bit of pressure lately.
6555,4579,10,49,188,247,1.2793522267206479,0.03387484257701351,651,"Well, let's just pretend you coughed."
7190,4579,14,41,192,247,1.2793522267206479,0.0357654329661776,651,"Well, at least, we can take you off the laxitives."
3686,4579,10,49,188,247,1.2793522267206479,0.03387484257701351,651,We will start by taking your blood pressure
1715,4579,15,39,193,247,1.2793522267206479,0.03622266561378825,651,"So Mr. Wiffel, When did you first notice someone switched your pool floater?"
7627,4588,16,35,189,240,1.2791666666666666,0.03741467124485745,651,"Service animal or not, did you leave it open in the back?"
5354,4588,11,45,184,240,1.2791666666666666,0.035007429310462246,651,This would be so much worse if you felt like an elephant were sitting on your chest.
4358,4588,16,35,189,240,1.2791666666666666,0.03741467124485745,651,What do herpetologists do to unwind?
3362,4588,15,37,188,240,1.2791666666666666,0.03694577270641409,651,Where were you when you first noticed the symptoms?
1962,4588,11,45,184,240,1.2791666666666666,0.035007429310462246,651,I am going to refer you to a snake oil salesman who I think can help you.
5765,4588,13,41,186,240,1.2791666666666666,0.035989652872742625,651,I believe an MRI + a PET scan+ a colonoscopy will give us the answers we're looking for.
372,4588,14,39,187,240,1.2791666666666666,0.03647084612930254,651,"Lets schedule one more appointment, and hope three’s the charm."
5055,4595,13,46,199,258,1.2790697674418605,0.03427770691290802,651,Let's start out with your medical hissssstory.
471,4595,11,38,166,215,1.2790697674418605,0.03766027516992616,651,Any chest constriction?
8125,4595,9,42,164,215,1.2790697674418605,0.03648778841775047,651,"How long, Mr. Jones, have you been short of breath?"
3688,4598,10,57,209,276,1.2789855072463767,0.03154312269713555,651,It’s only comforting until it’s not.
1114,4599,14,37,182,233,1.2789699570815452,0.03721543721379381,651,Feeling constricted?
1863,4599,15,35,183,233,1.2789699570815452,0.037709248667426136,651,Have you considered a faux fur boa?
2215,4599,12,41,180,233,1.2789699570815452,0.036207615648064,651,Tightness in the chest? Eliminate gluten and see if it improves.
8561,4599,15,35,183,233,1.2789699570815452,0.037709248667426136,651,I suggest you lay off the snake oil remedies.
9125,4599,13,39,181,233,1.2789699570815452,0.03671498466520011,651,"Yes, even your support animal."
4706,4604,12,46,193,251,1.2788844621513944,0.03445144111948874,651,And that's a wrap.
6743,4605,15,33,178,226,1.2787610619469028,0.03851676086075291,651,"On the bright side, since you didn’t eat the fruit there wasn’t a second fall of mankind."
1182,4605,15,33,178,226,1.2787610619469028,0.03851676086075291,651,"Sorry, but your pet insurance doesn't cover human extractions."
8626,4607,16,36,192,244,1.278688524590164,0.03697228256864196,651,This is why we recommend avoiding snake oil.
7495,4607,13,42,189,244,1.278688524590164,0.03557745898838726,651,"Your snake will be perfectly fine once you get it into a warmer, more comfortable environment."""
1462,4607,12,44,188,244,1.278688524590164,0.03510020262973803,651,I am sorry. I don't have the right form to qualify him as an emotional support pet.
2007,4607,15,38,191,244,1.278688524590164,0.03651326217847149,651,"So, you say that you feel constricted, but all the tests came back negative. Maybe it's stress?"
1246,4611,16,41,205,262,1.2786259541984732,0.0351859285062808,651,Not to worry. They shed their skin twice a year.
4137,4611,16,41,205,262,1.2786259541984732,0.0351859285062808,651,"Fortunately, the tapeworm test is negative."
7033,4611,11,51,200,262,1.2786259541984732,0.03304258238903379,651,So the notes indicate that you are experiencing difficulty breathing. Your insurance doesn't cover a physical exam so I'm prescribing an inhaler.
8604,4614,14,33,172,219,1.278538812785388,0.03883680415592952,651,"So,how long have you been feeling short of breath?"
2405,4614,10,41,168,219,1.278538812785388,0.036615980335378294,651,This blood pressure medication should even things out.
1059,4616,11,44,182,237,1.2784810126582278,0.0352807350361142,651,"Don't mind Sidney, Mr Brown. I can tell he likes you!"
2001,4616,16,34,187,237,1.2784810126582278,0.03772954801765428,651,And how long have you been experiencing shortness of breath?
8071,4616,13,40,184,237,1.2784810126582278,0.036280100279074336,651,Your x-rays came back negative.
8820,4616,14,38,185,237,1.2784810126582278,0.03676959861142472,651,I wouldn't get too wound up about this.
8541,4620,8,55,192,255,1.2784313725490195,0.032218034354567084,651,Don't listen to your wife next time.
7231,4621,14,31,167,212,1.278301886792453,0.03972210448040561,651,"Well, the good news is, your insurance DOES cover snakendectomies."
5481,4622,13,38,179,230,1.2782608695652173,0.037022077462351664,651,So how would you describe this “constriction”?
8237,4622,9,46,175,230,1.2782608695652173,0.03491052991128399,651,And you say he's always been this friendly?
1977,4622,8,48,174,230,1.2782608695652173,0.03436237504089649,651,These muscle relaxants should do the trick.
8212,4625,9,44,170,223,1.2780269058295963,0.03560578922545904,651,Hmmm...  No.  I don’t think it’s asthma.
922,4625,11,40,172,223,1.2780269058295963,0.036722888141377565,651,...and are you sleeping well?
3979,4625,8,46,169,223,1.2780269058295963,0.03503388478073275,651,All right. Quit the Alice Cooper tribute band and see me in two weeks.
7779,4625,11,40,172,223,1.2780269058295963,0.036722888141377565,651,I'm prescribing something for your blood pressure.
6435,4629,11,45,185,241,1.2780082987551866,0.034881107089677704,651,"It's alright- I'm a doctor, a professional.
Now I need you to take off that boa as well."
2722,4629,13,41,187,241,1.2780082987551866,0.03585872174275385,651,OK we'll put off the urine sample --But next time try to hold it 'til you get here
7292,4629,12,43,186,241,1.2780082987551866,0.035373291879791255,651,I think you ate a bad apple someplace.
697,4629,10,47,184,241,1.2780082987551866,0.03438187727844747,651,How long have you had these feelings of compression?
2522,4629,14,39,188,241,1.2780082987551866,0.036337667393980984,651,When did you begin to notice you were feeling constricted?
6246,4634,16,40,203,259,1.277992277992278,0.03545193792721109,651,"Well, we are all out of remedies for the constipation, so we will just need to squeeze it out of you. I have worked with this therapy snake before and she is quite gentle and quite proud of her work."
6489,4634,11,50,198,259,1.277992277992278,0.03327444350177502,651,"Fine, I'll turn up the heat."
3062,4636,9,52,191,252,1.2777777777777777,0.032921847296273614,651,I believe I recommended the Ketogenic Diet not the Pythogenic Diet.
1607,4636,13,39,182,234,1.2777777777777777,0.0365771801477515,651,That isn't the right kind of boa if you are doing drag.
1660,4636,14,37,183,234,1.2777777777777777,0.03707522822150908,651,We use him if your blood pressure is really high.
3164,4636,9,42,165,216,1.2777777777777777,0.03634144391059258,651,"So, labored breathing. Any other symptoms?"
460,4636,10,45,179,234,1.2777777777777777,0.03504058771215627,651,You can exhale now.
528,4636,11,43,180,234,1.2777777777777777,0.03556016348850541,651,Would you like a robe?
5637,4636,12,46,194,252,1.2777777777777777,0.03433229805875031,651,So you’re here because of tightness in your chest?
1359,4636,12,46,194,252,1.2777777777777777,0.03433229805875031,651,"So, why did your veterinarian refer you to me?"
1645,4636,16,38,198,252,1.2777777777777777,0.03612734288765902,651,"I'm sorry Mr. Snake, your insurance was declined."
8472,4645,15,43,205,263,1.2775665399239544,0.034651580761186004,651,I am prescribing a return trip to Borneo.
7723,4645,15,43,205,263,1.2775665399239544,0.034651580761186004,651,"Unfortunately, your healthcare plan doesn't cover a removal."
8334,4647,12,44,189,245,1.2775510204081633,0.034975145457929985,651,"When taking your blood pressure, you'll feel a little squeeze."
1251,4647,12,44,189,245,1.2775510204081633,0.034975145457929985,651,How long have you been experiencing difficulty breathing?
1998,4647,15,38,192,245,1.2775510204081633,0.03638170990844497,651,So essentially your complaint is that you are feeling somewhat constricted?
3169,4647,14,40,191,245,1.2775510204081633,0.03591897563279446,651,I don’t even know what to ssssssssay.
3469,4647,12,44,189,245,1.2775510204081633,0.034975145457929985,651,"This says you're having chest pains, is that right?"
5734,4647,11,46,188,245,1.2775510204081633,0.03449354714218878,651,"So, how was your trip to the Florida Everglades?"
6373,4647,13,42,190,245,1.2775510204081633,0.03545020176467718,651,This muscle relaxant should help.  You need to unwind.
6636,4647,14,40,191,245,1.2775510204081633,0.03591897563279446,651,I think you should try one made of feathers.
7057,4647,10,48,187,245,1.2775510204081633,0.034005128864590985,651,"Admittedly it's unusual and experimental therapy, but I have seen positive results."
9130,4647,10,48,187,245,1.2775510204081633,0.034005128864590985,651,"Well, this wraps up today’s appointment."
8971,4647,13,42,190,245,1.2775510204081633,0.03545020176467718,651,Shocked?  Hardly. You have no idea how many sex experiments gone wrong we see in the ER.
7319,4658,11,41,175,227,1.277533039647577,0.03627724799003086,651,"Well, the good news is that I think we can safely say that your crushing chest pain is not due to a heart attack"
6906,4658,13,37,177,227,1.277533039647577,0.03733642178260588,651,I'm prescribing snake oil and a constricted diet
6896,4658,12,39,176,227,1.277533039647577,0.036810644610349094,651,It says here you're experiencing some shortness of breath. Could you please remove the python so I can examine you with the stethoscope?
1553,4658,12,39,176,227,1.277533039647577,0.036810644610349094,651,The gentle pressure should make you feel less anxious.
5586,4658,12,39,176,227,1.277533039647577,0.036810644610349094,651,Your blood pressure appears to be somewhat elevated.
8312,4658,16,31,180,227,1.277533039647577,0.038871106187325304,651,Some folks felt embarrased with the gowns that opened in the back.
2703,4664,15,28,166,209,1.277511961722488,0.04066985645933014,651,"Oh, I forgot it was fashion week."
481,4665,13,50,211,274,1.2773722627737227,0.0328905055255027,651,The bad news is I can't find anything wrong with YOU...
7187,4665,19,38,217,274,1.2773722627737227,0.035244983640383136,651,"It's really nothing to worry about.  Just think of it as your ""outer colon."""
660,4667,15,41,200,256,1.27734375,0.035292152898617035,651,Come back if it lasts more than four hours.
5069,4667,17,37,202,256,1.27734375,0.036149834937704545,651,"As I told you, Mr Adam, that particular kind of apple don't keep the doctor away and bring additional consequences"
7343,4667,8,55,193,256,1.27734375,0.03211036081867716,651,After several tests I think we can finally speculate on your shortness of breath.
5601,4670,9,48,181,238,1.2773109243697478,0.03412806779433341,651,I thought you said she wasn't clingy?
8111,4670,10,46,182,238,1.2773109243697478,0.03464364634731232,651,Any difficulty breathing? Tightness in the chest?
4231,4670,11,44,183,238,1.2773109243697478,0.03515166358937617,651,Just apply this salve twice daily and it should fall off naturally in a month or two.
9179,4670,9,48,181,238,1.2773109243697478,0.03412806779433341,651,"Boas are medicine's best back brace, use with caution"
9231,4670,16,34,188,238,1.2773109243697478,0.037588902051214776,651,"Whatever you may think it is, I can assure you I am just measuring your blood pressure."
548,4670,12,42,184,238,1.2773109243697478,0.03565244274890156,651,In view of the increasing  constrictions I'm going to discontinue the snake oil.
1422,4670,11,44,183,238,1.2773109243697478,0.03515166358937617,651,You seem tense...
3549,4670,11,44,183,238,1.2773109243697478,0.03515166358937617,651,"First, let’s turn down the charm."
5087,4678,10,41,169,220,1.2772727272727273,0.03647114659228567,651,Follow up next week if you still feel constricted
5770,4678,16,29,175,220,1.2772727272727273,0.03973928202983353,651,"So, how did you get a whole human stuck up there?"
7060,4678,10,41,169,220,1.2772727272727273,0.03647114659228567,651,"While it is a bit uncomfortable, it’s safer and more effective than the keto diet."
224,4678,13,35,172,220,1.2772727272727273,0.038140235119900875,651,"Of course, we'll need to run some tests first..."
3371,4682,10,49,190,249,1.2771084337349397,0.033639492609402216,651,"Yes, caring for a pet can be constrictive."
5487,4682,12,45,192,249,1.2771084337349397,0.034588881059815925,651,"I'm an out -of -network provider for constrictor removal so you may incur increased costs, or  if you prefer, we can refer you to an in -network provider."
6160,4682,10,49,190,249,1.2771084337349397,0.033639492609402216,651,What I said was try to SHAKE your constipation
1076,4682,16,37,196,249,1.2771084337349397,0.036413474880519506,651,"Chest constriction? Hmm, difficult to diagnose at this stage. Perhaps a few more tests."
2562,4682,16,37,196,249,1.2771084337349397,0.036413474880519506,651,"Constricting chest pain, is it?  We'd better get an EKG."
4749,4687,12,40,179,231,1.277056277056277,0.03636722128367895,651,You may experience shortness of breath.
2340,4687,11,42,178,231,1.277056277056277,0.03584593795664559,651,You're going to have to remove your boa if you want me to examine you.
6695,4687,13,38,180,231,1.277056277056277,0.036881137452639066,651,I've seen this condition in some of my colleagues who work with certain insurance companies
7728,4687,10,44,177,231,1.277056277056277,0.03531696125217032,651,Side effects may include constricting chest pain.
7906,4687,6,52,173,231,1.277056277056277,0.03311666783463817,651,"I’ve done everything I can. At this point, I’m referring you to a relationship counselor."
5435,4692,9,41,163,213,1.2769953051643192,0.03665082229860594,651,let's wrap this up.
1808,4693,15,42,203,260,1.2769230769230768,0.0349086674734071,651,"So, Mr. Walters, tell me more about this squeezing sensation you seem to feel in your chest."
5167,4694,11,45,186,242,1.2768595041322315,0.03475566224581448,651,Where was Eve?
6326,4694,14,39,189,242,1.2768595041322315,0.03620543037389617,651,When did you first notice that something was wrong?
5245,4694,9,49,184,242,1.2768595041322315,0.033754574571987446,651,"No, it's not herpes... I'm referring you to a herpetologist because they know about snakes."
5773,4697,17,28,179,224,1.2767857142857142,0.03972783511762908,651,he said you swallowed his mouse
2823,4697,10,42,172,224,1.2767857142857142,0.03602820873756505,651,"If you want to change your emotional support animal to a gerbil, you'll have to get rid of Monty first."
331,4699,12,46,195,253,1.2766798418972332,0.03421394911064869,651,I'm writing you a referral to animal control.
679,4699,14,42,197,253,1.2766798418972332,0.03511884831426045,651,I'll have to refer you to a specialist...
1117,4699,8,54,191,253,1.2766798418972332,0.03232825277366698,651,"Ok Mr Smith, remove your snake wear and slip into that gown..so we can take a look at what might be causing your breathing difficulties."
1450,4699,21,28,204,253,1.2766798418972332,0.038117196683766626,651,"Alright, let's see how our new constipation treatment is working."""
4492,4699,11,48,194,253,1.2766798418972332,0.03375240313161524,651,The first thing to do for that chest tightness is to get you off cigarettes.
7758,4699,13,44,196,253,1.2766798418972332,0.03466935116688869,651,Have you considered strengthening your core?
7764,4699,12,46,195,253,1.2766798418972332,0.03421394911064869,651,According to the test results you're perfectly healthy. How long have you been feeling short of breath?
153,4706,15,43,206,264,1.2765151515151516,0.03453608275292101,651,"'It says here your name is Montgomery, but I'm going to guess that's not what people call you.'"
3189,4707,10,40,167,217,1.2764976958525345,0.03678092165093287,651,GENDER?
4234,4707,13,34,170,217,1.2764976958525345,0.03848174099513149,651,"I can understand that a person might not be comfortable in a hospital gown, but, really?"
6263,4707,12,36,169,217,1.2764976958525345,0.037923277713144424,651,I see here that your blood pressure is high and you say you feel tightness in your chest?
6022,4707,10,40,167,217,1.2764976958525345,0.03678092165093287,651,"There's no known cure, but if you lose weight it should help with the constriction."
8072,4711,17,34,195,246,1.2764227642276422,0.037155195849368765,651,"I get that you didn't want to wear a gown, but the boa is a bit much."
7870,4711,14,40,192,246,1.2764227642276422,0.03579045351314547,651,You say he's your therapy snake?  Please elaborate.
5672,4711,16,36,194,246,1.2764227642276422,0.03670592013961111,651,And was this the result of a work-related incident?
7461,4711,9,50,187,246,1.2764227642276422,0.03339216279502456,651,"So you flew back from the Everglades yesterday, Mr. Jones?"
149,4711,10,48,188,246,1.2764227642276422,0.033885403073283096,651,Have you tried Snake Oil?
5459,4711,12,44,190,246,1.2764227642276422,0.03485094764935016,651,Of course it will work. You’ll be rid of that extra belly fat in 7 days.
8308,4717,13,50,212,275,1.2763636363636364,0.03278620367033957,651,I am giving you a referral to the vet down the street
9043,4718,9,45,174,228,1.2763157894736843,0.035052681710192816,651,I will have to look into whether it's a pre-existing condition.
4632,4718,14,35,179,228,1.2763157894736843,0.03770815307585903,651,"So, your feeling a tightness in your chest."
2934,4718,6,51,171,228,1.2763157894736843,0.03335808608248213,651,"The snake is fine--but you have a very severe circulation problem"""
4569,4718,10,43,175,228,1.2763157894736843,0.0355996258089794,651,I think I might know what’s wrong with you.
4698,4722,16,39,202,257,1.2762645914396886,0.03560065427074962,651,It says here you have cobra...
4329,4723,14,38,187,239,1.2761506276150627,0.03649831757365477,651,"While the hug therapy seems to be helping, I would like to add a mild antidepressant"
7756,4724,9,46,177,232,1.2758620689655173,0.034650287179093485,651,I don’t want to jump to any conclusions. Chest pains are pretty common.
793,4724,10,44,178,232,1.2758620689655173,0.03518467570448667,651,May I prescribe a vet.
1839,4724,11,50,200,261,1.2758620689655173,0.033053184160068506,651,"Nothing serious.  It doesn’t even have an insurance code.
  You need to learn to set boundaries."
2649,4724,12,40,180,232,1.2758620689655173,0.03622981382925371,651,"Let me guess, you were just sitting on the toilet minding your own business when this happened."
2753,4724,11,42,179,232,1.2758620689655173,0.0357110684139545,651,"Well, the good news is you don't have a constricted bowel."
2769,4724,11,42,179,232,1.2758620689655173,0.0357110684139545,651,I'm referring you to a vet.
3257,4724,6,52,174,232,1.2758620689655173,0.03299523288423523,651,You say you are experiencing shortness of breath?
4243,4724,11,42,179,232,1.2758620689655173,0.0357110684139545,651,"OK, now take a deep breath and cough."
7174,4724,18,36,207,261,1.2758620689655173,0.03603914657671892,651,"Let's see, it says you have a tapeworm?"
7403,4733,15,45,212,272,1.275735294117647,0.033821730352962265,651,"Oh, that’s just what we use now to check blood pressure in your core, instead of just in one arm."
6443,4734,15,37,191,243,1.2757201646090535,0.036542477578911284,651,"A little background, have you eaten an apple recently, Mr. Adam is it, just the one name?"
7834,4734,16,35,192,243,1.2757201646090535,0.03700490241340288,651,"The good news is that we can still save your Adam's apple, the bad news is there might be hell to pay."
4722,4734,8,51,184,243,1.2757201646090535,0.03312524297969121,651,It could be slightly worse.
5446,4734,12,43,188,243,1.2757201646090535,0.035118688223573016,651,"Well if you recall, I did try to talk you out of that Amazon River trip."
7101,4734,14,39,190,243,1.2757201646090535,0.036074125527654835,651,"Oh, heck. He's up to your neck."
888,4734,9,49,185,243,1.2757201646090535,0.03363468236038238,651,I can't put my finger on it but I don't believe the tightness in your chest is due to a cold.
4473,4740,12,35,167,214,1.2757009345794392,0.03826271073361427,651,Would you please undress so I can see what the problem is?
1929,4741,13,44,197,254,1.2755905511811023,0.03454976384635309,651,"No.  I haven't ever felt like I was being squeezed by a giant snake.  Just ""yes"" or ""no"" please."
7500,4741,13,44,197,254,1.2755905511811023,0.03454976384635309,651,"Since you don’t have insurance, we squeeze it out of you"
4021,4743,11,51,203,265,1.2754716981132075,0.03271814374645192,651,Have you gotten your flu shot this season?
2691,4744,14,37,185,236,1.2754237288135593,0.036797870325552665,651,"Mr Simms, would you consider letting ME give the diagnosis?"
6917,4744,12,41,183,236,1.2754237288135593,0.035804457922504425,651,And how’s it affecting your social life?
7282,4744,8,49,179,236,1.2754237288135593,0.03372997332315564,651,I see from your interview with my PA that you feel all wound up.
8443,4744,9,47,180,236,1.2754237288135593,0.03426037254710887,651,"Copays are not the problem here, Bob."
6931,4748,11,54,211,276,1.2753623188405796,0.03186608668280176,651,I'll be taking your hiss-tory today.
884,4749,10,48,189,247,1.2753036437246963,0.03376648693334317,651,No worries!  It’s not poisonous.
3426,4749,17,34,196,247,1.2753036437246963,0.037021383039952116,651,And you say your symptoms are both a hiss and a rattle?
2840,4749,8,52,187,247,1.2753036437246963,0.03277720277874985,651,How does your insurer feel about alternative medicine?
3844,4749,12,44,191,247,1.2753036437246963,0.03472760080454714,651,"Well, the good news is - snake print look fabulous on you."
8357,4753,14,43,201,258,1.2751937984496124,0.034617942735678406,651,Have you been eating your apple a day?
1602,4753,11,49,198,258,1.2751937984496124,0.03328531824684205,651,It looks like your blood pressure is a little high.
1430,4753,16,39,203,258,1.2751937984496124,0.03547856148279988,651,An apple a day should do it.
7249,4756,10,43,176,229,1.275109170305677,0.035464360616698616,651,Let’s see ...it says here you’re feeling tightness in your chest ... and everywhere else?
5626,4756,13,37,179,229,1.275109170305677,0.037049115848965135,651,I distinctly remember you asking for boa tox.
6495,4756,8,47,174,229,1.275109170305677,0.034367282888313706,651,I'm writing him a prescription for Valium because he does seem a bit wound up.
1132,4759,16,45,219,280,1.275,0.03352956830686691,651,Take a deep breath
1664,4759,13,40,187,240,1.275,0.03588150730178788,651,How would you describe the pain?
158,4761,9,51,191,251,1.2749003984063745,0.03292678646772258,651,Don't worry he just ate an hour ago.
466,4761,11,47,193,251,1.2749003984063745,0.03388094282943315,651,"Let's see, it says here you're experiencing tightness in the chest?"
5500,4761,18,33,200,251,1.2749003984063745,0.037027366321849484,651,"He's my emotional support human"""
7485,4764,8,42,161,211,1.2748815165876777,0.036197280370899206,651,Let’s switch back to Weight Watchers.
8079,4764,11,36,164,211,1.2748815165876777,0.038021740101316835,651,Come back in two weeks and we'll check your pressure again.
1433,4766,15,42,205,262,1.2748091603053435,0.03467378919489788,651,An inhaler may help you breath better.
2993,4766,13,46,203,262,1.2748091603053435,0.03381976835472132,651,I think you need to see a veterinarian.
9165,4766,16,40,206,262,1.2748091603053435,0.03509300670952577,651,You win.  We'll do only a PSA test this year.
7092,4769,21,33,219,273,1.2747252747252746,0.03602988200165934,651,"I'm sending you to a snake-oil specialist, Donald Trump"
3796,4770,10,44,179,233,1.2746781115879828,0.035053343369101035,651,"Well after the initial tests we can say one thing for sure, it’s not asthma."
2489,4770,10,44,179,233,1.2746781115879828,0.035053343369101035,651,And you say your constipated?
8792,4770,12,40,181,233,1.2746781115879828,0.036093409612393226,651,It looks like you've really made an asp out of yourself.
862,4770,11,42,180,233,1.2746781115879828,0.03557717736695886,651,"Well, I can see why your blood pressure is high."
606,4770,13,38,182,233,1.2746781115879828,0.03660236174751501,651,This is a restricted diet.
67,4770,11,42,180,233,1.2746781115879828,0.03557717736695886,651,How long have you been experiencing tightness in your chest?
2471,4770,11,42,180,233,1.2746781115879828,0.03557717736695886,651,You’re fine. There are no bites
6483,4777,12,54,218,284,1.2746478873239437,0.031663171390348056,651,You mentioned on the phone the skin was dry and scaly....
9189,4777,15,48,221,284,1.2746478873239437,0.03282086663505568,651,How would you rate your pain on a scale of one to ten?
5512,4779,14,39,191,244,1.2745901639344261,0.035943743433861856,651,How long have you had the tightening in your chest?
5744,4779,11,45,188,244,1.2745901639344261,0.03450737025294971,651,Looks like the snake oil lotion I prescribed has a few side effects...
6811,4779,11,45,188,244,1.2745901639344261,0.03450737025294971,651,Its a new form of El Boa
6899,4782,15,40,200,255,1.2745098039215685,0.035316411739775976,651,"OK, so you were walking in the grass. You heard a rustling sound, and then what happened?"
4304,4783,15,43,208,266,1.2744360902255638,0.03430731686601617,651,"I'm sorry, but If I can't take your pulse, we simply can't find the source of your discomfort."
2621,4783,14,45,207,266,1.2744360902255638,0.03389128459804506,651,...and how long would you say you've had the tightness in the chest?
7486,4785,11,37,167,215,1.2744186046511627,0.03753120916070492,651,"Side effects? Lets see,  shortness of breath and death."
1551,4786,11,43,183,237,1.2742616033755274,0.03516722644331432,651,Good News! It’s better than getting skunked.
87,4786,12,41,184,237,1.2742616033755274,0.03567199912397597,651,Your symptoms could be one of two things...
1644,4786,14,37,186,237,1.2742616033755274,0.03666070011704818,651,It seems to work with constipation in men your age.
2775,4789,8,52,188,248,1.2741935483870968,0.03266363820672444,651,"You say you've felt this tightness in your chest since your recent trip to Columbia?"""
6381,4789,10,48,190,248,1.2741935483870968,0.03364837271906236,651,I don't care if 'ladies love it.' You need to have it removed.
6512,4789,10,48,190,248,1.2741935483870968,0.03364837271906236,651,"You have symptoms of the Burmese Python Derangement Syndrom:   sore throat, chest tightness and limited arm movement"""
6667,4792,13,45,201,259,1.274131274131274,0.034063860402279184,651,No need to worry... the boa is safe and looks great on you.
2488,4792,12,47,200,259,1.274131274131274,0.03362166448909931,651,...and you say you feel tightness in your chest?
1893,4792,13,45,201,259,1.274131274131274,0.034063860402279184,651,"What part of ""get undressed"" do you not understand?"
4359,4795,10,40,169,219,1.273972602739726,0.0364877644818817,651,I understand the nurse took your blood pressure on your leg. It's quite elevated.
4709,4795,8,44,167,219,1.273972602739726,0.0353210034727591,651,I see you got your homonyms mixed up.
4970,4795,11,38,170,219,1.273972602739726,0.03705737163057536,651,"Animal Wealfare tells us since it's winter, she not eating, so you're safe for now. Monday's a holiday so the surgery will be Tuesday."
8271,4795,7,46,166,219,1.273972602739726,0.03472292399901478,651,Have you visited any tropical regions lately?
7163,4799,14,35,181,230,1.2739130434782608,0.03741796374775718,651,Sorry. We got him to deal with the pharma reps but he doesn't seem to distinguish.
5188,4800,7,52,182,241,1.2738589211618256,0.03272050190432092,651,You say you're having trouble breathing?
3501,4800,13,40,188,241,1.2738589211618256,0.035750526213452004,651,Can you think of anything you might have been exposed to that might account for the rise in your blood pressure?
4486,4802,13,43,196,252,1.2738095238095237,0.034687705874932855,651,I can't examine you until you undress.
3528,4802,9,51,192,252,1.2738095238095237,0.03281400196163575,651,It appears your entire body is tightly constricted.
1916,4802,12,45,195,252,1.2738095238095237,0.03422889693422718,651,Here's your prescription for a support reptile
4900,4802,15,39,198,252,1.2738095238095237,0.035587582749178955,651,I’m afraid your insurance doesn’t cover this.
8,4802,13,43,196,252,1.2738095238095237,0.034687705874932855,651,Don’t be rattled.
5036,4802,10,49,193,252,1.2738095238095237,0.033292315603906844,651,So  You wanted a pet that would love you.
1055,4802,11,47,194,252,1.2738095238095237,0.033763853924012335,651,"So your blood pressure is down, but body mass is up."
5351,4809,12,48,203,263,1.273764258555133,0.03327379720898397,651,It says here you're having trouble swallowing.
4034,4809,14,44,205,263,1.273764258555133,0.034134962691330165,651,Has your wife noticed?
3279,4809,16,40,207,263,1.273764258555133,0.03497493066715666,651,I'm going to prescribe a muscle relaxant.  That will allow you to unwind and let you get on with eating that guy for lunch.
4267,4812,18,39,217,274,1.2737226277372262,0.034777440590852374,651,Take two bites of an apple and call me in the morning.
2521,4813,14,27,160,201,1.2736318407960199,0.041113315305729495,651,"I'm sorry, but all your tests are negative. I can't see any cause for the tightness in your chest."
279,4814,13,38,183,234,1.2735042735042734,0.03646450428731583,651,Any family history of boa contrictor attacks?
1452,4814,14,36,184,234,1.2735042735042734,0.03696407056907547,651,"Uh huh, I see. Let's have a look."
3233,4814,16,32,186,234,1.2735042735042734,0.03794347629392204,651,"It's herpes,all right.  I'm writing a referral to a herpetologist to look at it."
6127,4814,10,44,180,234,1.2735042735042734,0.03492295452237575,651,Here’s a prescription for some some snake oil.
6353,4814,13,38,183,234,1.2735042735042734,0.03646450428731583,651,Is there any family history of this kind of thing?
4,4819,12,43,190,245,1.273469387755102,0.03486761058617912,651,Do you feel under pressure?
7866,4819,15,37,193,245,1.273469387755102,0.036278344560471784,651,"So, your main symptom is feeling constricted???"
1281,4819,11,45,189,245,1.273469387755102,0.03438450614210519,651,Let's see...do we have your Advance Healthcare Directive on file?
3099,4822,11,48,197,256,1.2734375,0.033408166994558,651,"I’d like to see you drop about 30 lbs, Mr Farnsworth..."
5285,4823,11,51,205,267,1.2734082397003745,0.032505244106099646,651,In my experience these things usually work themselves out.
4157,4823,12,49,206,267,1.2734082397003745,0.03293556106639871,651,It’s not a permanent thing.  They shed their skins every year.
6184,4825,13,36,178,227,1.2731277533039647,0.0372189425444676,651,Medical science can't help you shuffle off this mortal coil.
6764,4825,13,36,178,227,1.2731277533039647,0.0372189425444676,651,"Relax, ringworm is treatable."
5095,4827,10,45,183,238,1.273109243697479,0.03452842027286281,651,When did you start feeling wound up?
24,4828,13,42,194,249,1.2730923694779117,0.03494988335238174,651,I don’t want to jump to any conclusions. So let’s do some blood work and test your vitals - and see if we can pinpoint what’s causing that shortness of breath.
3775,4828,8,52,189,249,1.2730923694779117,0.032550825972084405,651,Hasanything in particular brought you here today?
5613,4828,15,38,196,249,1.2730923694779117,0.03586460060138907,651,"Yes, well, on the bright side you'll grow tall and thin first."
7489,4828,10,48,191,249,1.2730923694779117,0.033531052793149684,651,I'd like to run a few tests and have you come back in a couple of weeks.
7679,4828,11,46,192,249,1.2730923694779117,0.034010573596942234,651,Have you tried a chiropractor?
6700,4833,14,43,203,260,1.273076923076923,0.034383608425910955,651,python wrap therapy is so new it's not covered by your insurance.
4957,4834,14,49,219,282,1.2730496453900708,0.032553504640158756,651,Good news — your viper signs are all within normal range.
6107,4835,11,44,187,242,1.2727272727272727,0.034644381769087344,651,"So far, all of your results are looking pretty normal."
5847,4835,11,44,187,242,1.2727272727272727,0.034644381769087344,651,Your lungs are fine
5596,4835,11,44,187,242,1.2727272727272727,0.034644381769087344,651,It’s confirmed. Slythrin House!
4921,4835,11,41,179,231,1.2727272727272727,0.035727544037333664,651,I understand you’re experiencing some constriction.
4423,4835,19,37,219,275,1.2727272727272727,0.03504579515058295,651,She's fine. She's not supposed to have feathers.
4203,4835,15,39,199,253,1.2727272727272727,0.03546315898206791,651,"Nothing to worry about, Mr. Sheldrake. His muscle tone appears to be excellent."
5610,4835,13,43,197,253,1.2727272727272727,0.034567274289614563,651,I'm ordering a series of tests so we can find out what's wrong with you.
1791,4835,15,45,215,275,1.2727272727272727,0.03349681412724069,651,So it seems you have some hypertension
894,4835,13,40,189,242,1.2727272727272727,0.0356204708246753,651,I'm prescribing a feather boa. That should relieve your chest constriction.
9094,4835,13,37,181,231,1.2727272727272727,0.03676607722817852,651,"For your high blood pressure, I’m referring you to a vet."
3227,4835,13,40,189,242,1.2727272727272727,0.0356204708246753,651,So I see from your chart you're experiencing some tightness in your chest - when did this start?
788,4846,16,38,203,257,1.272373540856031,0.03550417084734013,651,"Next time, don't try to eat a human sideways."
8936,4847,9,49,188,246,1.2723577235772359,0.033279872307225275,651,He’s bonded with you.
7254,4847,10,47,189,246,1.2723577235772359,0.033774752494943036,651,"Given the strength of her attachment, I'd urge you to rethink your view of this as some sort of illness."
2473,4847,16,35,195,246,1.2723577235772359,0.036603796769615386,651,"No, I’m not Dr. Dolittle. And no, I can’t reason with the damn snake."
1986,4847,15,37,194,246,1.2723577235772359,0.03614766842608061,651,"Just to be on the safe side, we’re gonna do some blood work, a CAT scan, MRI, and an X-Ray. Hang tight and the Nurse will be right in to move things along."
2145,4847,12,43,191,246,1.2723577235772359,0.03474337227031283,651,I think a referral is in order. Dr. Rikki-Tikki-Tavi.
192,4847,13,41,192,246,1.2723577235772359,0.03521769330923,651,"Can you tell me why you've been so wound up?"""
378,4847,14,39,193,246,1.2723577235772359,0.03568571040812308,651,Here's a prescription for separation anxiety.
688,4854,14,36,185,235,1.2723404255319148,0.03682483683899906,651,"We’ll have to run some tests, because there could be a lot of reasons why you feel you can’t breathe."
1261,4854,10,44,181,235,1.2723404255319148,0.03479349956060867,651,"So, how long have you felt this tightening in your chest?"
5118,4854,10,44,181,235,1.2723404255319148,0.03479349956060867,651,So you're experiencing a constricting sensation?
8033,4854,11,42,182,235,1.2723404255319148,0.03531229050642683,651,You should shed in 4-6 weeks.  Stay on a restricted diet.
6708,4858,11,39,174,224,1.2723214285714286,0.03645605216054563,651,"We're not sure about the final diagnosis, but you've put on a lot of weight and your skin is scaly and discolored."
3772,4859,15,41,205,261,1.2720306513409962,0.03469496221508589,651,So.. it says here you're a snake charmer and worried that you're a little too wrapped up in your work.
685,4859,14,43,204,261,1.2720306513409962,0.034267593435207716,651,Have you considered that your choice of therapy animal may be contributing to the constriction that you say you’re feeling in your chest?
3042,4859,16,39,206,261,1.2720306513409962,0.035117130383500644,651,"Monty, I suggest you use this Python to your benefit..."
3197,4862,13,42,195,250,1.272,0.03482693874934464,651,Next time I suggest you wear the gown rather than a boa.
1426,4863,13,39,187,239,1.2719665271966527,0.03590295897076936,651,I think she may have been asking for a feathered boa.
711,4863,14,37,188,239,1.2719665271966527,0.036389324953542065,651,Try this prescription. If that tightness in your chest doesn't go away call  me back.
7617,4863,13,39,187,239,1.2719665271966527,0.03590295897076936,651,"I understand it’s supporting you emotionally, but ..."
5591,4863,12,41,186,239,1.2719665271966527,0.035409913232582434,651,We think we know what’s causing the rash.
7998,4867,7,48,173,228,1.2719298245614035,0.03380349432236804,651,"Looks like a classic case of abandonment issues, but I'm just wondering, how did you manage to get your shirt off?"
4882,4867,13,36,179,228,1.2719298245614035,0.03707470032760838,651,It's unlikely your insurance will cover the procedure though I do know a local chef who might be interested.
5794,4867,8,46,174,228,1.2719298245614035,0.034370322824576936,651,"Hmm,let's see: You report you were swimming when
you felt a tightness in your chest and some abdominal pressure?"
7204,4867,9,44,175,228,1.2719298245614035,0.03492795375811329,651,You seem so wrapped up in yourself.
1015,4867,8,46,174,228,1.2719298245614035,0.034370322824576936,651,When did you feed him his last mouse?
5474,4872,14,44,207,265,1.271698113207547,0.033908222043363356,651,So when did that chest pain begin?
5263,4872,18,36,211,265,1.271698113207547,0.0355544452901366,651,"You're covered, but we're out of network for the Python.""

Miriam Salzer, Pacifica, CA"
4553,4872,15,42,208,265,1.271698113207547,0.034327179997472174,651,So let’s talk about your blood pressure.
4366,4872,14,44,207,265,1.271698113207547,0.033908222043363356,651,So these symptoms started after your trip to the Everglades?
7262,4872,20,32,213,265,1.271698113207547,0.03634960947194562,651,You'll have to relax your asp before we can begin.
2714,4872,14,44,207,265,1.271698113207547,0.033908222043363356,651,"Thank you, Mr Thompson. You can put your coat back on now."
7629,4878,11,47,196,254,1.2716535433070866,0.03353200753643405,651,"I'm afraid python is out of my scope of practice, I'm referring you to a specialist."
628,4878,16,37,201,254,1.2716535433070866,0.035777206275375006,651,And you took the subway here?  Only in New York!
1018,4878,11,47,196,254,1.2716535433070866,0.03353200753643405,651,Your blood pressure is a little higher than I'd like.
7308,4878,13,43,198,254,1.2716535433070866,0.034447651780671135,651,"Keep the snake warm and rested, it’s an endangered species. As far as your smartphone goes, you’ll just have to sift through its feces."
4164,4882,12,42,189,243,1.271604938271605,0.03500892022554932,651,Losing the weight should not be a problem.
804,4882,10,46,187,243,1.271604938271605,0.03402358336975111,651,"I'm thinking, No MRI."
4907,4882,11,44,188,243,1.271604938271605,0.0345197676750386,651,How did you get your shirt buttoned ?
769,4885,7,49,176,232,1.271551724137931,0.03342991718433884,651,You say she just asked you to hold it for a minute
5696,4885,16,31,185,232,1.271551724137931,0.03812388212758442,651,So Monty ... do you and Mister Cuddles share a health insurance plan? Or life insurance?
5502,4887,15,43,211,269,1.271375464684015,0.033969641045533586,651,This is just Sammy's way of coping with the current cold snap.
280,4888,11,48,199,258,1.2713178294573644,0.03318242131696658,651,"Good news, its not a heart a heart attack..."
2897,4888,13,44,201,258,1.2713178294573644,0.034079311174006734,651,"I don't care how warm it keeps you, you're living a very constricted life."
6379,4888,11,48,199,258,1.2713178294573644,0.03318242131696658,651,Preliminary results indicate you may be allergic to snake skin.
5144,4891,16,35,196,247,1.271255060728745,0.03647197435186238,651,"This may sound unconventional, but I'm going to prescribe opioids."
4404,4891,12,43,192,247,1.271255060728745,0.034619989565021686,651,When did your fear of snakes begin?
3656,4891,13,41,193,247,1.271255060728745,0.035092149925480265,651,I prescribe socks for you and a mouse for the snake.
9228,4891,10,47,190,247,1.271255060728745,0.03365580276359282,651,"It says here on your medical history that you list him as your 'main
 squeeze'"
2400,4891,12,43,192,247,1.271255060728745,0.034619989565021686,651,You're going to need a bigger shirt.
3165,4891,16,35,196,247,1.271255060728745,0.03647197435186238,651,Just keep it well fed
1589,4897,10,44,182,236,1.271186440677966,0.03466496899853126,651,It would appear that you have an intestinal constriction.
8538,4897,10,44,182,236,1.271186440677966,0.03466496899853126,651,I'm unsure if the cause is genetic or environmental.
6630,4899,10,41,174,225,1.271111111111111,0.03576328208762463,651,It says here that you're feeling some tightness in your chest. Have you ever had any issues handling stress or anxiety?
6828,4900,15,41,206,262,1.2709923664122138,0.034577877040972246,651,"So, exactly how long have you been wrapped up in this?"
6739,4900,16,39,207,262,1.2709923664122138,0.034998243433681055,651,"Shortness of breath, dizziness, exhaustion, numbness in the extremities - I'm just not seeing any cause for these symptoms, Mr. Kozak."
5593,4900,20,31,211,262,1.2709923664122138,0.0366315013966615,651,You're way too uptight.
1113,4900,14,43,205,262,1.2709923664122138,0.03415233693143109,651,I think this does affect your breathing.
2543,4900,13,45,204,262,1.2709923664122138,0.03372142723989286,651,"So tell me, which flight were you on?"
7272,4905,15,38,198,251,1.2709163346613546,0.035611379452394655,651,What you have is a twelve foot case of Anacondadosis.
9098,4905,10,48,193,251,1.2709163346613546,0.03329876569336526,651,"So, I gather that the weighted blanket wasn't working."
7501,4905,12,44,195,251,1.2709163346613546,0.034242558558348964,651,So tell me.  How long have you felt all wound up and short of breath?
9137,4905,9,50,192,251,1.2709163346613546,0.03281669219682996,651,"First of all, you've probably taken your last 
Uber."
3298,4905,12,44,195,251,1.2709163346613546,0.034242558558348964,651,"I know things are a little tight right now, but is your insurance up to date?"
6522,4905,9,50,192,251,1.2709163346613546,0.03281669219682996,651,And when did you first notice difficulty with your breathing?
1512,4911,13,39,188,240,1.2708333333333333,0.035771004142062794,651,I would like to see you again in six months.
2173,4911,10,45,185,240,1.2708333333333333,0.03427772201986623,651,Let me refer you to our Herpetologist.
3787,4911,11,43,186,240,1.2708333333333333,0.034782606721721884,651,How long have you had this constriction?
7240,4911,12,41,187,240,1.2708333333333333,0.03528026691855835,651,I see you’ve met the newest addition to our team. He’s great with hernia and prostate exams.
7352,4915,11,40,178,229,1.2707423580786026,0.03587935453224211,651,"So he told you to ""trussst in him"" ?"
184,4915,13,36,180,229,1.2707423580786026,0.03693154237878762,651,The apple-a-day thing? I'd let that slide.
4339,4917,14,44,208,266,1.2706766917293233,0.033795945842521935,651,I can't check your thyroid unless you take off your snake.
6044,4918,10,39,169,218,1.2706422018348624,0.0365025167800251,651,How long have you felt this constricted?
7098,4918,4,51,163,218,1.2706422018348624,0.032844575205079586,651,So tell me again when your breathing problems began?
6838,4920,14,41,200,255,1.2705882352941176,0.03477566823956809,651,Your chest sounds constricted.
4031,4920,11,47,197,255,1.2705882352941176,0.03341723540510045,651,"Yes, it's spelled the same; but it's not cross-dressing."
6362,4920,11,47,197,255,1.2705882352941176,0.03341723540510045,651,This prescription should help with the difficulty breathing.
1759,4920,16,37,202,255,1.2705882352941176,0.03565254672204463,651,"So tell me, is there any hisssssstory of molting in your family?"
6422,4924,13,40,191,244,1.2704918032786885,0.03536309977748086,651,I would recommend treading more lightly next time.
4127,4924,9,48,187,244,1.2704918032786885,0.03340094867193488,651,In rare circumstances insurance plans will cover snake oil.
8399,4924,12,42,190,244,1.2704918032786885,0.0348829107508298,651,You really are in a bind huh?
508,4924,10,46,188,244,1.2704918032786885,0.033902134676255094,651,And how long has your chest been feeling constricted?
2361,4924,10,46,188,244,1.2704918032786885,0.033902134676255094,651,"So, your chart says you're experiencing shortness of breath, constriction in the chest, and dry scaly skin.  I'd like refer you to a couple of specialists."
7028,4924,12,42,190,244,1.2704918032786885,0.0348829107508298,651,"I have this tightness in my chest, doc."
1287,4930,19,38,224,281,1.2704626334519573,0.03446239742117321,651,This isn't the blood pressure test I ordered from Amazon
468,4931,11,41,181,233,1.2703862660944205,0.035458701941320295,651,Ask all your friends to prey for you
4889,4931,10,43,180,233,1.2703862660944205,0.034933091407939286,651,This looks s-s-s-s-serious.
8197,4931,11,41,181,233,1.2703862660944205,0.035458701941320295,651,"The chest tightness is caused by separation anxiety,shall
I refer you to a vet or psychiatrist?"
7365,4934,12,49,209,270,1.2703703703703704,0.03261577161339252,651,So you say you're experiencing a tightness in your chest?
1174,4934,18,37,215,270,1.2703703703703704,0.0350572323636911,651,Please describe your Chief Complaint.
6193,4936,13,34,175,222,1.2702702702702702,0.03771417681735824,651,I'm going to prescribe some over-the-counter snake oil this time.
210,4936,13,44,202,259,1.2702702702702702,0.03396363488826363,651,"Mr. Rush, Have you ever considered owning a cat or a dog instead?"
1519,4936,14,32,176,222,1.2702702702702702,0.03825080234005636,651,The squeeze is only until you pay your balance.
4121,4936,10,50,199,259,1.2702702702702702,0.032614992064357036,651,I’ll run the usual battery of tests and we’ll see what that tells us.
6961,4940,15,37,196,248,1.2701612903225807,0.035889050210014393,651,"In the last six months, have you experienced any of the following symptoms?"
7948,4940,12,43,193,248,1.2701612903225807,0.034497454056280824,651,I'm going to prescribe a statin...your blood pressure is through the roof
4186,4940,7,53,188,248,1.2701612903225807,0.03204411056672234,651,Any other symptoms besides tightness in the chest?
2354,4940,8,51,189,248,1.2701612903225807,0.03254957580188876,651,Is says here you've been in the garden of Eden recently.
1899,4940,10,47,191,248,1.2701612903225807,0.0335376595877538,651,I'm prescribing something.  You're wound too tight.
821,4940,19,29,200,248,1.2701612903225807,0.037664617035876494,651,YOUR DEDUCTIBLE ONLY COVERS THE VENOM
1025,4940,11,45,192,248,1.2701612903225807,0.03402094169029762,651,You say you feel some constriction in your chest...
4261,4947,10,44,183,237,1.270042194092827,0.03453735346781624,651,"Sorry, insurance won't cover that. Can we interest you in an anti-depressant?"
873,4948,8,38,154,200,1.27,0.03731571132321866,651,I think we're dealing with more than just a sore throat here...
3218,4949,10,51,202,263,1.2699619771863118,0.03228736284330997,651,"So...shortness of breath, pain in your chest and swelling in your legs and feet. I’ll need to order a few tests. How’s your insurance?"
7405,4950,18,25,183,226,1.2699115044247788,0.03979677930029355,651,I'd like to schedule a colonoscopy for you.
5510,4950,11,39,176,226,1.2699115044247788,0.03617269792704586,651,"The results came back, and it appears like you have a snake constricting around you."
3534,4950,8,45,173,226,1.2699115044247788,0.034503187896574465,651,I will prescribe a daily moisturizer to minimize the shedding.
3370,4950,10,41,175,226,1.2699115044247788,0.03562488889184516,651,Worst case of 'I got a crush on you' syndrome I've ever seen.
7346,4954,14,40,198,252,1.2698412698412698,0.035037718437678785,651,Farewell to Arms.
3075,4955,6,46,163,215,1.2697674418604652,0.03437063805194272,651,At least it's solving your mouse problem.
1217,4956,12,41,188,241,1.2697095435684647,0.035151539079463924,651,"Sir, you may have entered your symptoms online but I'm the expert here."
8241,4956,10,45,186,241,1.2697095435684647,0.034153688035589894,651,"What I can do for you is put you in touch with an excellent tailor"""
6768,4956,14,37,190,241,1.2697095435684647,0.03612183540294932,651,I'll start by giving you somthing to get the tail out and then we will see how things go from there...
3895,4956,6,53,182,241,1.2697095435684647,0.03206496249782665,651,"Let's just wrap this up; oh, sorry."
911,4956,13,39,189,241,1.2697095435684647,0.035639989425733855,651,An apple a day may not be the answer.
3313,4956,10,45,186,241,1.2697095435684647,0.034153688035589894,651,I’m going to write you a referral to the best snake charmer I know
1835,4956,16,33,192,241,1.2697095435684647,0.037066740969505886,651,Do you have a family history of this?
1101,4956,13,39,189,241,1.2697095435684647,0.035639989425733855,651,"Yeah, this has been going around. Two rats a day for three days ought to fix it."
4237,4964,9,44,177,230,1.2695652173913043,0.03466374221207827,651,Reflexes... not great...
8330,4964,13,36,181,230,1.2695652173913043,0.03678945698277061,651,"I may be going out on a limb here, but by any chance have you visited the tropics recently?"
5852,4964,12,38,180,230,1.2695652173913043,0.036269710018853214,651,Are you experiencing any tightness in your chest?
1755,4967,14,41,201,256,1.26953125,0.034655682004397934,651,Would you mind removing your snake for the exam?
3084,4967,12,45,199,256,1.26953125,0.03376006198729542,651,I'm afraid your airways are a bit constricted.
7027,4967,10,49,197,256,1.26953125,0.03284002551128893,651,Alternative medicine weight loss treatments are not usually effective.
7418,4967,12,45,199,256,1.26953125,0.03376006198729542,651,I'm a bit concerned about your cholesterol.
66,4967,13,43,200,256,1.26953125,0.03421080297636976,651,"Obama-care coverage included foreign snakes such as this Burmese Python, but now we're only allowed to deal with domestic breeds from the USA."
482,4972,15,36,194,245,1.2693877551020407,0.03617279636841052,651,If the snake lasts more than 4 hours call me.
3132,4972,12,42,191,245,1.2693877551020407,0.03475777871285233,651,I'm giving you a prescription for a herpetologist.
3137,4972,14,38,193,245,1.2693877551020407,0.03570735486923573,651,"Besides your breathing problem,any other symptoms"
3473,4972,13,40,192,245,1.2693877551020407,0.03523576572751856,651,"Actually, this is the third case I’ve seen this week..."
5415,4972,13,40,192,245,1.2693877551020407,0.03523576572751856,651,I know herpetology is your passion ... but you seem too wrapped up in your work.  You should seek an escape route.
5941,4977,15,40,205,260,1.2692307692307692,0.03471506618919854,651,"Oh,have I got the perfect oil for you..."
7901,4977,8,47,179,234,1.2692307692307692,0.03373219641728215,651,I'm going to send you to a vet first to confirm the diagnosis.
7731,4977,13,30,165,208,1.2692307692307692,0.03942494625363878,651,"You're in very good health, and I anticipate you will remain so for the duration of your presidency and beyond."
8653,4977,11,41,182,234,1.2692307692307692,0.035325746920367475,651,"Well, it's not a gastric ulcer or gallstones - we'll have to order some more tests."
2070,4977,9,45,180,234,1.2692307692307692,0.03427161384075777,651,"In Florida, cases like this are fairly common."
1145,4977,13,44,203,260,1.2692307692307692,0.03384871875153292,651,"Feeling constricted, you say?"
895,4977,12,46,202,260,1.2692307692307692,0.03340712096874477,651,"I get it. Between work, family, we're all feeling squeezed."
747,4977,11,41,182,234,1.2692307692307692,0.035325746920367475,651,"I am prescribing some anti-anxiety medication for you."""
4103,4985,17,33,199,249,1.2690763052208835,0.03665556948003006,651,I squeezed you in when I heard of your emergency.
120,4985,14,39,196,249,1.2690763052208835,0.0353053526958337,651,"Your vitals look good, Mowgli."
1093,4985,13,41,195,249,1.2690763052208835,0.034843655290471155,651,"I can assure you, sir, lung cancer is the least of your worries"
249,4988,9,42,172,223,1.2690582959641257,0.03534791162748549,651,"I'm sorry, but your lab tests and imaging all came back normal. I think it's just stress."
456,4988,14,32,177,223,1.2690582959641257,0.03809817022004218,651,This is a classic case of co-dependent separation anxiety.
3048,4988,6,48,169,223,1.2690582959641257,0.03358984111022339,651,"Good news, Pythons are not endangered."
3124,4991,15,41,208,264,1.268939393939394,0.03434600058979692,651,"Okay, you feel constricted, and what else are you feeling?"
4512,4992,14,36,188,238,1.26890756302521,0.036413202061529336,651,I'm sorry but your insurance doesn't cover pre-exisssssssssting conditions.
7080,4992,12,40,186,238,1.26890756302521,0.035426075744396344,651,The snake's gonna be OK...you might rethink its feeding routine.
9140,4992,12,40,186,238,1.26890756302521,0.035426075744396344,651,There’s an experimental treatment for this. Have you heard of mongoose?
1750,4992,10,44,184,238,1.26890756302521,0.03441064371559546,651,"Before I let you know what we are going to do, I just want to know how you got your shirt on over it!"
2131,4996,15,38,200,253,1.2687747035573123,0.035361620380965034,651,"Sorry, we ran out of hospital gowns."
2439,4996,10,48,195,253,1.2687747035573123,0.03306956626616899,651,"You will need to uncoil, so I can exam you."
3887,4996,9,50,194,253,1.2687747035573123,0.03259181824393285,651,"Good news! That ""constricted feeling"" you mentioned is not your heart."
6988,4996,11,46,196,253,1.2687747035573123,0.033540509978524924,651,Good news!  We've identified what's causing the tightness in your chest
6744,4996,11,46,196,253,1.2687747035573123,0.033540509978524924,651,Good news - your blood pressure has come down.
3866,4996,14,40,199,253,1.2687747035573123,0.0349152488088012,651,Esta es la segunda anaconda argentina que he visto este ano.
8307,5002,8,45,174,227,1.2687224669603525,0.03437142800162955,651,"I’m sorry, sir, but I cannot provide my diagnosis until you sign the waiver form."
6396,5002,9,43,175,227,1.2687224669603525,0.03493393619062169,651,Have you considered dating females of a more appropriate species?
1379,5002,12,37,178,227,1.2687224669603525,0.03656958302289077,651,I’d like to run some tests to find out why you’re feeling constricted.
3949,5002,12,37,178,227,1.2687224669603525,0.03656958302289077,651,Diagnosing the cause of high blood pressure is notoriously difficult.
2031,5006,15,42,211,268,1.2686567164179106,0.03398725161135174,651,Have you tried losing some weight?
3636,5007,14,37,191,242,1.2685950413223142,0.03598952270532266,651,"I'm afraid you will have to take off your scarf if you'd like me to examine you, Mr Smith."
2597,5007,15,35,192,242,1.2685950413223142,0.036462832053497596,651,Does your Rx insurance cover snake oil?”
7638,5007,13,39,190,242,1.2685950413223142,0.035509905206185764,651,You’re the third herpetologist in my office this week.
419,5007,16,33,193,242,1.2685950413223142,0.03693007579421152,651,"So, Mr. Idle - I think you've probably squeezed about all you can out of this python gig."
6552,5007,10,45,187,242,1.2685950413223142,0.034030519204654955,651,You say your parents never hugged you?
3985,5007,15,35,192,242,1.2685950413223142,0.036462832053497596,651,We call it the 'tax payer' syndrome.
1190,5013,10,49,198,257,1.2684824902723735,0.03272880124758895,651,I think I finally got a handle on your nagging back and chest pains.
1319,5013,9,51,197,257,1.2684824902723735,0.03226105389505053,651,"Leave it on for six weeks. If it sheds its skin, come back in and we'll reset it."
4692,5013,12,45,200,257,1.2684824902723735,0.0336447930068507,651,Let's try Valium.  It helps when you're too wound up.
5940,5013,13,43,201,257,1.2684824902723735,0.034093561403271654,651,You might feel a slight pinch...
6264,5017,9,44,178,231,1.2683982683982684,0.03453307902773031,651,"I said 'on' the scales, not 'in' the scales"
7624,5018,11,51,210,272,1.2683823529411764,0.03198452223195327,651,Do you feel a crushing chest pain?
3627,5018,10,53,209,272,1.2683823529411764,0.03155751951815754,651,Unwind.
7468,5020,11,44,191,246,1.2682926829268293,0.03415108170657809,651,Let me guess...online E.D. meds?
4202,5020,10,46,190,246,1.2682926829268293,0.03366173460206606,651,When did this squeezing sensation in your chest begin?
5618,5020,17,32,197,246,1.2682926829268293,0.03695132492328276,651,I can't examine you unless you remove your snake.
603,5023,15,40,206,261,1.2681992337164751,0.03459718382747819,651,Generally an ostrich boa makes for a better fashion statement...
189,5023,14,42,205,261,1.2681992337164751,0.03416859209166763,651,"Mr. Williams, our diagnoses show both you and Bertie with species appropriate symptoms of the common cold.  So, push the fluids, and call us if either of you isn’t feeling better in a few days."
7984,5023,15,40,206,261,1.2681992337164751,0.03459718382747819,651,when did this chest tightness start?
1102,5026,11,37,172,220,1.268181818181818,0.03678025146214716,651,What made you switch from the feathered variety?
1207,5026,11,37,172,220,1.268181818181818,0.03678025146214716,651,"Looking at these lab results, I’d say we have reason to suspect a parasite."
6023,5028,13,37,185,235,1.2680851063829788,0.036212441786383984,651,And when did you begin to feel constipated?
8848,5028,10,43,182,235,1.2680851063829788,0.03467319126823531,651,‘’We need to think out of the box here.  Probiotics aren’t gonna do the job.”
1681,5028,7,49,179,235,1.2680851063829788,0.03306235692316882,651,So you say he's a hugger?
2895,5031,14,39,197,250,1.268,0.03518031578132714,651,Apparently you have an unpaid balance
1956,5031,12,43,195,250,1.268,0.034254891480800895,651,When was the first time you felt boa constricted?
4517,5031,7,53,190,250,1.268,0.03182381215505649,651,"I don't know what to tell you Stan, you just need to loosen up."
8613,5031,10,47,193,250,1.268,0.033303761983430574,651,"Fortunately, sir, it's a non-venomous species."
5436,5035,14,43,208,265,1.2679245283018867,0.03381104763836438,651,When did the sensation of tightness in your chest start?
2556,5035,13,45,207,265,1.2679245283018867,0.03338561333818692,651,You were supposed to hook-up with Eve!
2594,5035,11,49,205,265,1.2679245283018867,0.0325180511269246,651,Coverage depends on how long this condition has existed.
1816,5038,17,41,222,280,1.2678571428571428,0.03373618210728751,651,"If you could just sit tight, we'll get that specialist in to have a look-see."
7795,5038,11,38,175,224,1.2678571428571428,0.036329581245948796,651,I see no reason for concern. Feelings of constriction in the throat and chest are often just be a sign of anxiety.
7899,5038,15,30,179,224,1.2678571428571428,0.03847066702181921,651,"But of course there are caveats. Side effects include blurred vision, muscle cramping, and shortness of breath."
5104,5041,14,36,189,239,1.2677824267782427,0.03627797734640881,651,You do know that there are other methods to control your blood pressure
7426,5041,13,38,188,239,1.2677824267782427,0.03579009824838176,651,Let's run a few tests to see what's going on here
198,5041,12,40,187,239,1.2677824267782427,0.03529547598363121,651,When did you first notice the tightness in your chest?
5049,5041,11,42,186,239,1.2677824267782427,0.034793822974679804,651,"We will make this quick, I know you are on a tight schedule."
4266,5045,13,42,199,254,1.2677165354330708,0.03434345228244613,651,"You're welcome to get a second opinion, but I  strongly advise  surgery over acupuncture."
8153,5045,13,42,199,254,1.2677165354330708,0.03434345228244613,651,"One more time, breath in, breath out, please."
7937,5045,10,48,196,254,1.2677165354330708,0.03295610624767885,651,"Hmmmm, most report it feels like an elephant is sitting on the chest"
9195,5045,11,46,197,254,1.2677165354330708,0.03342495371571589,651,Your blood pressure is way up there.
6235,5045,11,46,197,254,1.2677165354330708,0.03342495371571589,651,Your stress test results are normal.
5556,5045,10,48,196,254,1.2677165354330708,0.03295610624767885,651,"Adam, can you tell me how ling has Eve been missing?"
4170,5051,16,40,213,269,1.2676579925650557,0.034282425515242916,651,I can’t tell what’s your problem. We’ll need additional testing.
5461,5052,10,41,177,228,1.2675438596491229,0.03535119218364821,651,I'm sorry but we have a no exceptions policy prohibiting comfort animals in the office.
6756,5052,10,41,177,228,1.2675438596491229,0.03535119218364821,651,I see that Patient Services has addressed your complaint about the gown coming untied.
8687,5052,13,35,180,228,1.2675438596491229,0.036954504147600584,651,"Well, then I'd recommend you stop exhaling."
4596,5055,17,31,195,243,1.2674897119341564,0.03725369033895878,651,Come back in the spring. It's hibernating.
181,5055,16,33,194,243,1.2674897119341564,0.03679439235604788,651,One asp every four hours and call me in the morning.
3941,5055,15,35,193,243,1.2674897119341564,0.03632928809969387,651,So you went as Natassja Kinski
4078,5055,10,45,188,243,1.2674897119341564,0.0339082069524382,651,So let me understand...are you feeling constipated or constricted?
590,5055,15,35,193,243,1.2674897119341564,0.03632928809969387,651,I’m referring you to a snake oil salesman.
5751,5055,10,45,188,243,1.2674897119341564,0.0339082069524382,651,And do you have any other pets?
7448,5061,14,41,203,258,1.2674418604651163,0.034418111438828815,651,I can't commit to this diagnosis till these shrooms wear off.
5560,5062,17,39,217,273,1.2673992673992673,0.03432323769820137,651,And you have how many mouse tatyoos?
7618,5063,10,42,180,232,1.2672413793103448,0.03494152945593868,651,I'm prescribing extra strength asp-irin.
3098,5064,11,44,192,247,1.2672064777327936,0.03402987699146595,651,Are you allergic to crowbars?
13,5065,15,40,207,262,1.2671755725190839,0.034480079359706164,651,His name is Monty
8949,5065,9,52,201,262,1.2671755725190839,0.031833804295999774,651,The good news is the snake is no longer in the grass.
8791,5067,16,42,219,277,1.2671480144404332,0.03358438531050642,651,Your blood pressure is through the roof.
4247,5068,11,37,173,221,1.2669683257918551,0.03663355082484102,651,When did the chest pain begin?
4535,5068,8,43,170,221,1.2669683257918551,0.034908609830201824,651,"Well, your weight is up."
8981,5068,11,37,173,221,1.2669683257918551,0.03663355082484102,651,I'm prescribing two large chickens a day for 10 days. That should unblock you.
1671,5071,9,45,182,236,1.2669491525423728,0.034018673779293,651,"I'm writing a script for two rabbits and a potent muscle relaxant. If you can, call me in two days & let me know if that helped."
3360,5071,11,41,184,236,1.2669491525423728,0.03506271836400818,651,"It’s not approved by the FDA, but I think snake oil might actually to the trick in this case."
7838,5071,10,43,183,236,1.2669491525423728,0.034544640574014615,651,"So, when did you start feeling tightness in your chest?"
5982,5074,15,37,199,251,1.2669322709163346,0.035507821448823404,651,"Sorry, we ran out of gowns."
5324,5074,11,45,195,251,1.2669322709163346,0.0336647492817173,651,"Leave it on for 24 hours, don't bathe or shower, and then..."
7905,5074,11,45,195,251,1.2669322709163346,0.0336647492817173,651,Have you noticed any tightening of the chest?
64,5074,12,43,196,251,1.2669322709163346,0.03413484809049317,651,Have you noticed any pain other than when you inhale?
254,5074,12,43,196,251,1.2669322709163346,0.03413484809049317,651,"Don’t worry, this is a non-invasive procedure."
8847,5079,13,38,189,240,1.2666666666666666,0.03565812147534083,651,How long has Bo been having digestive issues?
8627,5079,12,44,199,255,1.2666666666666666,0.033770485332375214,651,Well your blood tests seem normal...have you considered the experience you're describing is just anxiety?
5033,5079,13,42,200,255,1.2666666666666666,0.0342246135509768,651,So when did this feeling of  constriction in your chest start.
7809,5079,12,44,199,255,1.2666666666666666,0.033770485332375214,651,Blood pressure and cholesterol are good but can you explain the weight gain?
7718,5079,11,46,198,255,1.2666666666666666,0.033310166412893145,651,"So, you woke up with a chest tightness?"
5929,5079,11,34,165,210,1.2666666666666666,0.03790680212642532,651,How's that organic neck brace working for ya?
6144,5079,12,44,199,255,1.2666666666666666,0.033770485332375214,651,This relaxation technique combines the benefits of massage and a full body wrap.
5531,5079,9,42,174,225,1.2666666666666666,0.035073618720610086,651,"Let's try a regimen of snake oil...it's generic, so it should be covered by your insurance."
4887,5079,12,40,188,240,1.2666666666666666,0.0351658090147719,651,A potential side effect is delayed orgasm.
3023,5079,9,50,196,255,1.2666666666666666,0.032369896511968706,651,Does it hurt when you breathe in?
3314,5079,11,46,198,255,1.2666666666666666,0.033310166412893145,651,You put on some weight since your annual checkup.
2636,5079,11,38,176,225,1.2666666666666666,0.03618734322278729,651,See me again in two weeks and try to keep your snake in your pants.
2551,5079,14,40,201,255,1.2666666666666666,0.03467279431835917,651,The challenge will be to do it quickly so he doesn't constrict.
2279,5079,10,44,186,240,1.2666666666666666,0.034159905103643244,651,"For the boa constrictor, I'm  prescribing Benadryl 2-3 times per day until his muscles loosen up."
333,5079,11,38,176,225,1.2666666666666666,0.03618734322278729,651,Have any special medical restrictions?
3833,5079,13,38,189,240,1.2666666666666666,0.03565812147534083,651,Have you considered a weighted blanket?
5989,5095,18,33,208,259,1.2664092664092663,0.03600341866717067,651,"Well, painting it like a python might work for a while but I’m afraid surgery is the only solution for an overdose of Viagra."
4469,5095,14,41,204,259,1.2664092664092663,0.034300511742100366,651,Pets show affection in different ways
1882,5097,16,33,195,244,1.2663934426229508,0.036659680441855615,651,"Before we remove the snake, you are required to read these pamphlets about the benefits of constriction."
990,5097,7,51,186,244,1.2663934426229508,0.03225445549538211,651,"The test results are in.  As I thought, you are constricted."
847,5097,11,43,190,244,1.2663934426229508,0.034282289202887596,651,"For the last time, I still don’t think the squeezing in your chest is coming from your heart."
6376,5097,10,45,189,244,1.2663934426229508,0.03378674280792266,651,Do you have your own zoologist who you like to see or would you like me to send you out with a referral?
666,5101,14,33,182,229,1.2663755458515285,0.037327988933444876,651,Let’s do a strep test just to make sure.
833,5101,13,35,181,229,1.2663755458515285,0.03681132145688947,651,"I'm prescribing two mice and removal of your  ""Don't Tread On Me "" flag. """
7657,5101,14,33,182,229,1.2663755458515285,0.037327988933444876,651,"Well it's entirely up to you Mr Arbuthnot, but I can't make my examination if you refuse to take that boa constrictor off."
8074,5104,17,40,221,278,1.2661870503597121,0.0338628398640789,651,"Well I have to read this statement from HPPA and get your signature before we start talking in front of this, uh, third party-even if you are his main squeeze!"
6624,5105,13,44,206,263,1.2661596958174905,0.033508460121732156,651,All I know is I loose my breath after one flight of stairs
7955,5105,16,38,209,263,1.2661596958174905,0.0347835024915632,651,Seems you've got constricted airways.
8044,5107,13,40,195,248,1.2661290322580645,0.03485906152704103,651,"I'm prescribing you an anti-boatics for 7 days, 3 times a day"
6128,5107,12,42,194,248,1.2661290322580645,0.03438756036236732,651,Let me order a CT scan of the chest to figure out why you have trouble breathing.
3275,5107,10,46,192,248,1.2661290322580645,0.033424610423074555,651,The constriction diet is just another fad that doesn’t work.
4153,5107,14,38,196,248,1.2661290322580645,0.03532426975064889,651,Is Monty your stage name?
4201,5107,18,30,200,248,1.2661290322580645,0.03712685665254886,651,"Let's wait and see. After all, what does not kill you just makes you stronger"
6417,5107,13,40,195,248,1.2661290322580645,0.03485906152704103,651,"Worst case scenario, you’ll get through it in a couple of months"
3643,5113,10,42,181,233,1.2660944206008584,0.034810143302090174,651,"Well, good news is camouflage is back in fashion"
8442,5113,12,38,183,233,1.2660944206008584,0.03585726443564754,651,Looks like a codependency problem. I 'm referring you to couples' therapy.
3108,5113,7,48,178,233,1.2660944206008584,0.033177553745992225,651,Good news! It's benign.
5742,5113,11,40,182,233,1.2660944206008584,0.03533758261058619,651,Have you had trouble breathing before?
288,5117,13,32,173,218,1.2660550458715596,0.03807195549030576,651,So the drag queen auditioms didn’t specify a feather boa?
2744,5118,11,49,207,267,1.2659176029962547,0.03230507974431946,651,I'm referring you to a snake oil salesman you should see.
2328,5119,15,37,200,252,1.2658730158730158,0.035382495860968914,651,"""He's in with a parakeet and a coal miner right now."
3228,5119,8,51,193,252,1.2658730158730158,0.0321027123251004,651,"Really, diet and exercise is still the best method..."
7621,5119,15,37,200,252,1.2658730158730158,0.035382495860968914,651,"Difficulty breathing, high blood pressure, intense anxiety — I have just the drug for you . . . ."
5189,5122,11,41,185,237,1.2658227848101267,0.034932624988424296,651,Have you considered another cause rather than PETA?
2783,5122,10,43,184,237,1.2658227848101267,0.034417010079265876,651,So how would you rate your anxiety?
2652,5122,14,35,188,237,1.2658227848101267,0.036435716075558004,651,"Don't worry, when you finish shedding you'll look like all the other snakes."
690,5125,11,37,174,222,1.2657657657657657,0.03648798367948789,651,I think couples counseling might be the best bet for the two of you.
5536,5125,13,33,176,222,1.2657657657657657,0.03758859463040317,651,"Fortunately,  I know a good snake oil salesman."
4388,5125,9,41,172,222,1.2657657657657657,0.03535312517586495,651,The good news is the snake has a tumor. The bad news is it's not going to finish him before he finishes you.
4048,5128,12,31,164,207,1.2657004830917875,0.038857829324551174,651,It appears that the snake oil didn't work.
166,5129,13,42,201,256,1.265625,0.034106572270734326,651,And do you have any family history of compression by boa constrictor?
428,5129,12,44,200,256,1.265625,0.03365443532666776,651,Come back in two weeks if it's still bothering you.
4320,5129,16,36,204,256,1.265625,0.03542837897455521,651,"My first question is, “do you have matching shoes?"
5555,5132,13,38,190,241,1.2655601659751037,0.03552708952626649,651,And what is your date of birth?
8764,5132,10,44,187,241,1.2655601659751037,0.034035858302286566,651,Next time check with me first before trying a fad diet off the internet.
4520,5132,13,38,190,241,1.2655601659751037,0.03552708952626649,651,"So, when did you notice that you couldn’t swallow?"
4030,5135,15,43,217,275,1.2654545454545454,0.033313339804288127,651,No one ever reads the fine print on those Python bootcamp applications.
944,5136,10,49,201,260,1.2653846153846153,0.032399455297440684,651,I think we figured out what's causing that sore throat.
4389,5136,14,41,205,260,1.2653846153846153,0.034183692345488015,651,Tightness in the chest can be a sign of heart trouble...
6424,5138,15,35,195,245,1.2653061224489797,0.03606504616729035,651,. . . and one 3 ounce can of Snake Oil.
3697,5139,7,47,176,230,1.2652173913043478,0.0334185245200631,651,"It's been a very busy morning, so I appreciate your patience."
277,5139,14,33,183,230,1.2652173913043478,0.03718337992633343,651,"Based on your symptoms, I'd say you're having a heart attack, but we'll run some tests to be sure."
4841,5141,15,40,209,264,1.2651515151515151,0.034248174595453464,651,Let me understand this.  You were trying to raise your social media profile?
4781,5141,16,38,210,264,1.2651515151515151,0.034666159651822896,651,Any family history of high blood pressure?
6709,5143,13,40,196,249,1.2650602409638554,0.03473523011172363,651,Your constricted lifestyle may be contributing to your hypertension.
8503,5143,13,40,196,249,1.2650602409638554,0.03473523011172363,651,Just give me a call if the constriction doesn't go away within two weeks.
6722,5143,16,34,199,249,1.2650602409638554,0.03610677299126151,651,I'm his doctor; where's yours?
710,5146,6,50,178,234,1.264957264957265,0.032495424833839034,651,So how long have you been feeling this tightness in your chest?
7637,5146,9,44,181,234,1.264957264957265,0.034146741506027076,651,You thought combining a therapy animal and an anxiety vest would help?
8473,5146,11,40,183,234,1.264957264957265,0.03520461384124622,651,"Listen, impersonating a poop emoji comes with risks."
4236,5146,12,38,184,234,1.264957264957265,0.035721803927394005,651,This should keep you from getting so wound up.
6620,5146,10,42,182,234,1.264957264957265,0.034679711584662126,651,I'd like to run some tests to see what might be causing the chest tightness.
3897,5151,11,49,208,268,1.2649253731343284,0.03219960406639887,651,"I'm sorry, but I am putting you on a constricted diet."
6503,5151,15,41,212,268,1.2649253731343284,0.03389122378810678,651,This is just for the swelling. We'll have to put you on a steady dose of piranhas to eat away the infection.
7865,5151,11,49,208,268,1.2649253731343284,0.03219960406639887,651,Just feed it field mice three time daily for a week and you'll be fine.
848,5154,10,38,171,219,1.264840182648402,0.036222050991859975,651,"Tipping the scales at 200 lbs, again, Mr. Peterson?"
5310,5154,6,46,167,219,1.264840182648402,0.03383001089168742,651,I'm going to order some tests to see if we can unravel the cause of your problem.
811,5156,13,41,199,253,1.2648221343873518,0.03435679791938155,651,This will help if there's any bloating - it's for the snake.
6856,5156,13,41,199,253,1.2648221343873518,0.03435679791938155,651,"Let's see. High Blood Pressure, tightness in your chest, and stomach cramps..."
8950,5158,9,45,184,238,1.2647058823529411,0.033769317353497585,651,Take 3 tablespoons of snake oil and call me in the morning.
3328,5158,7,49,182,238,1.2647058823529411,0.03270248236441962,651,"Well, it’s not the kiss of death or anything."
4554,5158,14,44,214,272,1.2647058823529411,0.03313718854202433,651,So Adam when did the snake problem begin
8479,5158,17,29,192,238,1.2647058823529411,0.037736249965059636,651,Well....it looks like we found the cause of the tightness in your chest
2228,5162,17,25,181,223,1.2645739910313902,0.03953792580093402,651,"For now, take these medicines, go home, try to rest and avoid Discovery Channel."
5062,5163,11,42,189,242,1.2644628099173554,0.0344145657547411,651,Unfortunately this is putting a real squeeze on your insurance
6004,5163,12,40,190,242,1.2644628099173554,0.03490923535243983,651,We think your condition might be psychosomatic.
7377,5163,11,42,189,242,1.2644628099173554,0.0344145657547411,651,I don't quite understand... could you explain again what brought you in today?
1184,5166,16,37,208,261,1.264367816091954,0.03492204714081609,651,"So, you wanted to get your wife a boa?"
8793,5166,12,45,204,261,1.264367816091954,0.033191257937041106,651,Research says that big hugs help heal you.
7882,5168,12,36,179,227,1.2643171806167401,0.036444920309231785,651,"For future reference, your pet is not considered a service animal."
836,5168,12,36,179,227,1.2643171806167401,0.036444920309231785,651,"Unfortunately the side effects include asphyxiation followed by death, any vomiting?"
4480,5168,11,38,178,227,1.2643171806167401,0.03590609114686575,651,"Jerry, since last time, your weight and blood pressure has gone up quite a bit..."
5239,5168,14,32,181,227,1.2643171806167401,0.037499358476442014,651,"Yeah, there's certainly some swelling in your right big toe. Take a couple of aspirin and ice it every few hours. You'll be fine."
9174,5168,10,40,177,227,1.2643171806167401,0.03535905183326904,651,"I'm prescribing that you use a turtle neck sweater, it will be just as warm, but less constrictive."
8578,5173,12,41,193,246,1.2642276422764227,0.03452135517376972,651,Your EKG and lipid panel look good. I wouldn't worry too much about chest pains and shortness of breath in your case.
6501,5173,10,45,191,246,1.2642276422764227,0.033546325468144435,651,You're going to feel some strong compression.
7436,5173,8,49,189,246,1.2642276422764227,0.03254209492020749,651,Remember unwinding becomes more difficult as you age.
361,5176,7,56,202,265,1.2641509433962264,0.03060039433163151,651,We'll  re do your x-ray and this time take a deep breath and hold it.
5420,5177,14,33,184,231,1.2640692640692641,0.03703986155101969,651,Weight?...I'll just put 160. I don't want you to step on the scales
5372,5178,8,50,192,250,1.264,0.03220815831194621,651,Take two muscle relaxers every five minutes.
768,5178,9,48,193,250,1.264,0.032703118748884104,651,"Well, there's your problem. It's not giving you two rescue breaths after every thirty chest compressions."
5699,5180,12,47,210,269,1.2639405204460967,0.032524115792572326,651,I'm prescribing rest and relaxation. You seem pretty tightly wound.
8457,5181,10,37,169,216,1.2638888888888888,0.036526138191359275,651,Your prior doctor was what we call a snake oil salesman.
3213,5182,13,36,186,235,1.2638297872340425,0.036094719200517406,651,You appear to be a bit constricted.
6050,5182,9,44,182,235,1.2638297872340425,0.03401981419142929,651,"Next time, please make it a Boa, Anaconda is so hard to spell correctly when typing your case into the new medical records system."
2724,5184,11,45,198,254,1.263779527559055,0.033315717048905014,651,Would you say that your breathing has been somewhat constricted lately?
9161,5184,11,45,198,254,1.263779527559055,0.033315717048905014,651,I’ll tell you what’s suffocating are those gosh darn insurance companies.”
906,5184,11,45,198,254,1.263779527559055,0.033315717048905014,651,I think we have pin pointed that tight feelings your chest.
2057,5184,11,45,198,254,1.263779527559055,0.033315717048905014,651,I am going to give you a referral to an orthopedic guy for that ankle.
6271,5188,13,46,214,273,1.2637362637362637,0.03261955060218054,651,The insurance company says it's a pre-exisssting condition.
5636,5189,14,30,176,220,1.2636363636363637,0.038309301103513514,651,So once we shrug off this mortal coil...
193,5190,14,35,190,239,1.2635983263598327,0.036164252999662076,651,Just a little translation issue with our off shore back office. Should have been 2 a day with restrictions not constrictions
6644,5190,10,43,186,239,1.2635983263598327,0.034164472250462784,651,"Let's try ""conscious uncoupling."""
1649,5190,10,43,186,239,1.2635983263598327,0.034164472250462784,651,"But on the bright side, you no longer have to worry about your issues with ED."
7849,5190,11,41,187,239,1.2635983263598327,0.03467523138885122,651,I see. You told your wife you don't wear scarves. So she suggested a boa.
5025,5194,14,40,204,258,1.2635658914728682,0.03431520429133612,651,The tests say your fine!
5976,5194,11,46,201,258,1.2635658914728682,0.03297034572307333,651,I'm afraid we can only treat the symptoms.
9068,5194,7,54,197,258,1.2635658914728682,0.031086829459158027,651,This treatment isn't for everybody.
5870,5197,15,34,194,243,1.2633744855967077,0.036219324784404226,651,I know you're new to transvestism but the term boa is usually preceded by feather.
8031,5197,8,48,187,243,1.2633744855967077,0.032768407692417796,651,"You know, I said STEAK and kidney pie."
9074,5197,12,40,191,243,1.2633744855967077,0.03478230991146864,651,So. How long have the two of you been wrapped-up in this relationship?
264,5200,14,37,196,247,1.263157894736842,0.035341892336250666,651,I'm afraid your colonoscopy is going to cost triple.
9149,5200,16,33,198,247,1.263157894736842,0.0362612737190447,651,If this lasts longer than 4 hours you need to go to the emergency room
8402,5200,11,43,193,247,1.263157894736842,0.03391612341021025,651,"I recommended constricted activity, not constrictor activity."
6228,5200,15,35,197,247,1.263157894736842,0.03580453410976475,651,You're having trouble breathing?
4832,5200,11,43,193,247,1.263157894736842,0.03391612341021025,651,"So, it says here you're feeling a little physically constricted."
4638,5200,12,46,208,266,1.263157894736842,0.032744371896313906,651,Your glucose is fine. You'll need to schedule a return appointment to address any other concerns.
2418,5200,10,35,164,209,1.263157894736842,0.0373136135369739,651,Your blood pressure is somewhat high...
740,5200,10,45,192,247,1.263157894736842,0.033427355837194736,651,Ignore what I said last time. Fresh air is overrated.
2037,5200,12,41,194,247,1.263157894736842,0.034397946684166854,651,Nonsense. It’s not medical costs squeezing you.
845,5200,14,42,210,266,1.263157894736842,0.03359969536414304,651,I think you have about two hours to live.
2221,5200,18,34,214,266,1.263157894736842,0.03524813192101706,651,Your asp is hanging out.
8833,5211,14,43,213,270,1.262962962962963,0.033256754171950606,651,It seems to be that you have a broken toe.
4134,5212,17,32,202,251,1.2629482071713147,0.03629130005096998,651,Here's a prescription.  Call me in a couple of weeks if your chest tightness persists.
4630,5212,14,38,199,251,1.2629482071713147,0.03494911915211964,651,Don't you think that your comfort pet is a bit unnerving?
5439,5212,14,38,199,251,1.2629482071713147,0.03494911915211964,651,Boas are so last season.
3122,5212,10,46,195,251,1.2629482071713147,0.033074928415166946,651,Do you have any pet allergies?
8168,5212,12,42,197,251,1.2629482071713147,0.03402493070659714,651,"It's a new, more comprehensive way of measuring your blood pressure."
1720,5212,14,38,199,251,1.2629482071713147,0.03494911915211964,651,I can see your tapeworm has really gotten out of control.
3101,5212,15,36,200,251,1.2629482071713147,0.035402167157805677,651,I know I should have chosen “Truth”.
4395,5219,9,43,180,232,1.2629310344827587,0.03427571632180554,651,Well the good news is your crippling loneliness is cured.
6835,5219,12,37,183,232,1.2629310344827587,0.0358717401011105,651,"So, why do you think you're short of breath?"
1242,5221,11,45,199,255,1.2627450980392156,0.03320092858128292,651,There is very limited data regarding constriction as a viable weight loss method.
1156,5221,12,43,200,255,1.2627450980392156,0.03366274129938001,651,That crushing feeling in hour chest? Not a heart attack.
3051,5221,13,41,201,255,1.2627450980392156,0.034118303664140745,651,"OK, so you ordered this on Amazon and..."
4685,5221,10,47,198,255,1.2627450980392156,0.032732600958828705,651,And any difficulty breathing?
8080,5221,8,51,196,255,1.2627450980392156,0.0317752447554829,651,*And how was your relationship with the python before this incident?
5020,5226,13,36,187,236,1.2627118644067796,0.03595883179368396,651,It's your anxiety that's the issue here.
1390,5226,12,38,186,236,1.2627118644067796,0.03545385109237862,651,I recommend that you go back to the snake charmer in the medina.
4959,5226,17,28,191,236,1.2627118644067796,0.03791155088769194,651,Next time I'd go with the feathered option.
8459,5226,11,40,185,236,1.2627118644067796,0.034941573098454755,651,"As a fan of The Big Lebowski, all I can say is consider yourself lucky - and remember 'A wiser fella once said, sometimes you eat the bear, and sometimes, well, the bear eats you.'"
4328,5230,13,42,204,259,1.2625482625482625,0.03375715673573265,651,"Looks like it's either you or your pet. But first, I must look at the extinct animals list."
2999,5230,9,50,200,259,1.2625482625482625,0.03193469243514351,651,"If you experience any further tightness of the chest, schedule a follow up immediately."
4352,5230,6,56,197,259,1.2625482625482625,0.03049645542455723,651,And how long have you been in a symbiotic relationship?
1972,5233,8,47,185,240,1.2625,0.03299932905788497,651,The good news is that your snake’s LDL is low. The bad news is that you’re going to die.
4885,5233,11,41,188,240,1.2625,0.03454791207483923,651,I’ll need pre-approval from your insurance before I sell you the oil.
6474,5233,13,37,190,240,1.2625,0.03554283662996418,651,I'm not sure; sounds like snake coil to me.
6924,5233,10,43,187,240,1.2625,0.03403954648998826,651,"Sorry, you'll have to remove the snake too before I can examine you."
8909,5233,12,39,189,240,1.2625,0.03504890486473968,651,I'm going to need the snake's head in front.
9096,5233,10,43,187,240,1.2625,0.03403954648998826,651,Here's a note for the herpetologist down the street.
7449,5239,12,34,175,221,1.262443438914027,0.03706040311271217,651,"I'm going to suggest a different weight-control program for you, Mr. Harris."
6951,5239,10,38,173,221,1.262443438914027,0.035933310567922365,651,Not covered by your policy.Take two aspirin and I’ll see if YouTube has a DIY video that does.
8946,5239,9,40,172,221,1.262443438914027,0.03535629326043355,651,There is a slight risk of death. But I wouldn’t get too wrapped up on it.
7972,5242,7,50,187,244,1.2622950819672132,0.03213099609368887,651,Hmm...your blood pressure is a little high.
7545,5242,9,46,189,244,1.2622950819672132,0.03316419208749202,651,20 minutes in the sun and you should feel less constricted!
2204,5242,12,40,192,244,1.2622950819672132,0.0346562797640081,651,I understand you have squeezing chest pain.  We will have to order a battery of tests.
2484,5242,15,34,195,244,1.2622950819672132,0.036086726331801364,651,Now you see why fad diets aren't a good idea?
3705,5242,17,30,197,244,1.2622950819672132,0.03700965474291465,651,Take two of these and coil me in the morning.
6243,5247,8,43,174,225,1.2622222222222221,0.03436755370688194,651,Initial tests indicate you've been under a lot of  stress lately.
4223,5248,10,50,207,267,1.2621722846441947,0.031761821838539823,651,Do you feel safe in your home?
757,5249,8,38,160,206,1.2621359223300972,0.036364723154209244,651,"The good news is, it'll live"
7417,5250,11,43,194,248,1.2620967741935485,0.0337957506713827,651,Two teaspoons of snake oil and call me in the morning.
5693,5250,17,31,200,248,1.2620967741935485,0.036579392294920916,651,Couple's therapy is next door.
3973,5250,13,39,196,248,1.2620967741935485,0.03474841707450018,651,Let's cut back on the LSD/CBD oil I gave you. How about chamomile?
5225,5250,7,51,190,248,1.2620967741935485,0.03180492590716036,651,"Yup, he takes your blood pressure then tells me in Parseltongue."
934,5250,15,35,198,248,1.2620967741935485,0.035675652971243116,651,Have you ever tried wearing a poncho?
2317,5255,10,40,179,229,1.262008733624454,0.03508738475193097,651,I think you know what I'm going to tell you.....You've got cancer.
2454,5255,7,46,176,229,1.262008733624454,0.0334097060371869,651,An apple in the evening will help him unwind.
6829,5255,11,38,180,229,1.262008733624454,0.03562906031799,651,No need for a follow-up appointment...
8353,5258,13,40,199,252,1.2619047619047619,0.034368825676336666,651,You mentioned that your chest feels tight  ...
841,5258,9,48,195,252,1.2619047619047619,0.03247672958046734,651,"It says here that you’ve been feeling 
extraordinarily uptight lately."
5326,5258,12,42,198,252,1.2619047619047619,0.033905701951714766,651,That boa will kill on the runway.
8283,5258,11,44,197,252,1.2619047619047619,0.03343616412369413,651,Well it appears from your chart that you've been feeling a bit constricted lately?
8323,5258,12,42,198,252,1.2619047619047619,0.033905701951714766,651,"I’m afraid these test results confirm my suspicions, it has returned and spread over your entire body."
7780,5263,12,37,184,233,1.261802575107296,0.03573527419284532,651,On a scale of 1 to 10 how much pain do you have?
2087,5263,14,33,186,233,1.261802575107296,0.03675604926721229,651,You looked as though you needed a hug.
4625,5265,11,45,200,256,1.26171875,0.03308690552543067,651,"So, when did you decide to tie the knot?"
7070,5265,11,45,200,256,1.26171875,0.03308690552543067,651,"I went to Dartmouth Medical School my friend. Trust me over whatever you Googled and WebMD, it’s just anxiety."
4830,5265,10,47,199,256,1.26171875,0.03262063859501855,651,Good news first: the endoscopy shows no blockage.
8247,5268,11,34,169,214,1.2616822429906542,0.037278824119798756,651,"Well,clearly you're aspmatic"
8788,5269,14,34,189,237,1.261603375527426,0.03631958600780529,651,The small print in your insurance policy carries an exclusion for prehistoric conditions.
1919,5269,6,50,181,237,1.261603375527426,0.03214110579139417,651,"The sooner you get cold-hearted about him, the sooner he'll slither away."
8647,5269,10,42,185,237,1.261603375527426,0.03429404474009997,651,"You feel a tightness in your chest? Okay, let's have a look."
155,5269,11,40,186,237,1.261603375527426,0.03481148101448106,651,"If it gets any worse, call 911"
1707,5269,13,36,188,237,1.261603375527426,0.03582393923053088,651,"and you're getting in your 10,000 steps, yes?"
3368,5269,13,36,188,237,1.261603375527426,0.03582393923053088,651,"Patient complains of ""being up to here"" with snakes and alligators."
5933,5275,10,48,202,260,1.2615384615384615,0.03229085790495455,651,"The good news is, according to my research, it is non-venomous"
5240,5275,17,34,209,260,1.2615384615384615,0.03536381925270761,651,Who is your insurer?
8368,5275,7,54,199,260,1.2615384615384615,0.03088040503519791,651,There's a cream for this.
2450,5278,8,41,169,218,1.261467889908257,0.03504420696474857,651,Let's try a muscle relaxer.
8959,5278,9,39,170,218,1.261467889908257,0.03564231161041297,651,"Good news, lungs are strong. Bad news, they're the snake's."
2926,5280,12,39,190,241,1.2614107883817427,0.03492016193762819,651,I 'm just saying that just getting the vaccination may an easier way to protect yourself.
3428,5280,12,39,190,241,1.2614107883817427,0.03492016193762819,651,So how long have you felt constriction in your chest and shortness of breath?
5584,5280,12,39,190,241,1.2614107883817427,0.03492016193762819,651,How long have you had this choking feeling?
8896,5280,10,43,188,241,1.2614107883817427,0.03391550407302674,651,I think the tightness in your throat is a reaction you're having to the boa constrictor.
7713,5284,13,43,208,264,1.2613636363636365,0.03329425979797856,651,You’re lucky. That’s a rare boa dilator.
4868,5285,12,34,176,222,1.2612612612612613,0.03691202226828801,651,"I've heard of a snake in the grass but really, a snake in the ass?"
135,5285,10,38,174,222,1.2612612612612613,0.035790611822660856,651,I'll need to see your snake is what a lot of urologists say.
2916,5285,9,40,173,222,1.2612612612612613,0.03521651811285851,651,I'm going to give you something to relieve the constriction.
7871,5285,8,42,172,222,1.2612612612612613,0.03463290922440954,651,I’m sure a few more tests will get to the bottom of this pressure you’re feeling.
6933,5289,8,48,189,245,1.2612244897959184,0.032535754492442004,651,It's a prescription for muscle relaxants. You should feel significant relief in one to two hours.
5574,5289,12,40,193,245,1.2612244897959184,0.034531135831366785,651,"A feeling of tightness in your chest doesn't always mean heart disease, so you can go about your normal daily activities."
4866,5289,12,40,193,245,1.2612244897959184,0.034531135831366785,651,"It says  right there: ""Flotation device: 
ages 7 to12."""
4494,5289,9,46,190,245,1.2612244897959184,0.03304589726040769,651,Our tests indicate your air passages are constricted.
4053,5289,13,38,194,245,1.2612244897959184,0.035012217112848826,651,How long have you had this tight feeling in your chest?
33,5289,9,46,190,245,1.2612244897959184,0.03304589726040769,651,I’m gonna go ahead and run some labs.
3403,5289,14,36,195,245,1.2612244897959184,0.035486777150231956,651,We expect full payment before you're consumed whole.
2825,5296,12,46,210,268,1.2611940298507462,0.03252909659358712,651,"Sir, I think that when you say you have the snake ""wrapped around your little finger,""  you may be misreading the situation."
3911,5296,11,48,209,268,1.2611940298507462,0.03209660399854243,651,"Well, I'll be.  Lab reports you have worm."
1511,5298,10,45,194,249,1.2610441767068272,0.033191854304281204,651,Have you been having any difficulty sleeping?
533,5298,5,55,189,249,1.2610441767068272,0.03065552343830496,651,"Well, Mr. Thurgood, your tests are looking pretty good, however that tightness in your chest you have been experiencing recently may be related to those long ""fitness walks"" in the Everglades."
3337,5298,13,39,197,249,1.2610441767068272,0.03462458717565785,651,"For most people, wearing a boa means pink feathers."
1193,5298,10,45,194,249,1.2610441767068272,0.033191854304281204,651,Any aching muscles or throat constriction?
3561,5302,7,46,177,230,1.2608695652173914,0.033283629634566124,651,A therapy python isn't exactly what I had in mind.
6562,5302,9,54,213,276,1.2608695652173914,0.03063177354940326,651,"I doubt that your crushing chest pain is a heart attack""."
6212,5302,14,32,184,230,1.2608695652173914,0.03706219048166157,651,It can be very expensive to determine what is causing the tightness in your chest.
3507,5302,12,42,199,253,1.2608695652173914,0.03378728365325634,651,"Mmm-so your major symptoms is a ""constricting feeling when you take a deep breathe.""  Well I think we can skip the chest x-ray"
8826,5302,9,48,196,253,1.2608695652173914,0.0323646681877729,651,And when was the last time you watched Monty Python?
3323,5302,9,42,179,230,1.2608695652173914,0.03440558911168103,651,You'll do just about anything to get that handicap parking permit.
684,5302,12,42,199,253,1.2608695652173914,0.03378728365325634,651,The tests came back positive - he just wants a hug.
2318,5302,8,50,195,253,1.2608695652173914,0.031876357230989416,651,Any problems with your appetite?
2482,5302,10,46,197,253,1.2608695652173914,0.03284572032231333,651,"Yeah, we see a lot this time of year."
7852,5311,15,43,222,280,1.2607142857142857,0.03278501734481406,651,"It says here that you ordered the ""feather boa"" but this arrived in the mail instead..."
2960,5312,16,35,206,257,1.2607003891050583,0.03520305578125531,651,Most people don’t know this but it’s actually pronounced boner constrictor.
718,5312,9,49,199,257,1.2607003891050583,0.032038466061039786,651,"For a few more weeks, let's keep you on the restricted diet."
3566,5312,12,43,202,257,1.2607003891050583,0.03343141943739262,651,"I’d say there’s a frog in your throat, but it’s a bit more drastic then that"
4208,5315,8,45,181,234,1.2606837606837606,0.03347562087591998,651,Frankly Mr Smith we don't see many cases of this.
4426,5315,15,31,188,234,1.2606837606837606,0.03711326277545192,651,We'll keep running laboratory tests until we find the explanation for your complaints of a choking feeling and crushing chest pain.
4617,5315,8,45,181,234,1.2606837606837606,0.03347562087591998,651,When nurse Gomez told you to take off your clothes ... she also meant your spirit animal.
7463,5315,16,29,189,234,1.2606837606837606,0.0376042113859028,651,"As your veterinarian, I don’t like your high-millenial diet.”"
7720,5319,13,48,223,284,1.2605633802816902,0.03169083206775588,651,Well it looks like you’ve lost about three pounds this week. You’re doing very well on this new diet. Besides the airplane  issue any other side effects?
7360,5320,15,38,208,261,1.260536398467433,0.03439586917710883,651,"So, how long have you been a Goop subscriber?"
6157,5321,11,40,187,238,1.2605042016806722,0.03468232793210847,651,"It's not cancerous, but that doesn't mean it's not benign."
4987,5321,11,40,187,238,1.2605042016806722,0.03468232793210847,651,"Unfortunately, this is not covered under your health insurance plan..."
4974,5321,14,34,190,238,1.2605042016806722,0.03618335989622023,651,Be more selective for your next costume party.
3186,5324,12,32,171,215,1.2604651162790699,0.03770588010723823,651,Worst case scenario is that he turns around and bites you.
2546,5325,13,43,209,265,1.260377358490566,0.033183043612984846,651,"I see your problem Mr. Snake, your eyes are just bigger than your belly."
6699,5325,9,51,205,265,1.260377358490566,0.03141278920557629,651,And when did you first start feeling this constriction?
957,5327,13,37,192,242,1.2603305785123966,0.035281710667209164,651,They told you to learn Python and now it's consuming you?
8684,5327,9,45,188,242,1.2603305785123966,0.033281069700148096,651,We can be as aggressive as possible.  I see your insurance covers coexisting conditions.
119,5327,14,35,193,242,1.2603305785123966,0.03576438849483236,651,No really. Snake oil is an actual remedy.
8636,5327,8,47,187,242,1.2603305785123966,0.03276182570586504,651,We'll give it four weeks: If you don't lose 20 pounds then we can consider bariatric surgery
6648,5331,15,34,197,246,1.2601626016260163,0.03582435848171044,651,... and do you have any family history of being crushed by a snake?
3602,5331,11,42,193,246,1.2601626016260163,0.033921212233473254,651,The test results show that you are in a bind.
8914,5331,9,46,191,246,1.2601626016260163,0.032928416736452026,651,Right now there's a lot of this going around.
1382,5334,16,26,181,223,1.2600896860986548,0.03890047355667725,651,"Even for a veterinarian, you're too wrapped up in your work."
5290,5334,8,42,173,223,1.2600896860986548,0.03449715487730097,651,"So, have you been experiencing any tightness in you chest recently?"
2614,5334,14,30,179,223,1.2600896860986548,0.03784770212123098,651,Let’s try an inhaler.
8803,5337,18,35,220,273,1.26007326007326,0.034529574458218505,651,"...And the next time you’re in the Amazon rain forest, don’t ask the locals about pet adoption..."
3240,5338,8,49,193,250,1.26,0.03208923301517206,651,"From now on, try wearing less constrictive clothing"
4568,5338,12,41,197,250,1.26,0.03403282138946032,651,So tell me. Where do you feel the constriction?
2395,5340,9,41,177,227,1.2599118942731278,0.03466992624979102,651,Your blood pressure is a bit high so I recommend a smaller viper.
4363,5340,13,33,181,227,1.2599118942731278,0.03685027986003424,651,The good news is the tightness you feel in your chest is not a cardiopulmonary event...
2940,5342,13,40,201,254,1.2598425196850394,0.034128714126922914,651,"Well, you do have high blood pressure, but I am a cardiologist.  What you need is a herpetologist."
3069,5342,10,46,198,254,1.2598425196850394,0.03273226775353138,651,Please keep your feet tucked in when the mountain lion gets here to distract your snake.
9205,5342,13,40,201,254,1.2598425196850394,0.034128714126922914,651,"I would like for you to lose that 10 pounds around your middle, then see me in six months."
1628,5345,10,40,181,231,1.2597402597402598,0.03481974351167981,651,"If you want to dance at The Velvet Spike, get one with feathers."
6577,5345,13,34,184,231,1.2597402597402598,0.03640528925763844,651,"So, the nurse says your bowels have been a bit constricted lately?..."
580,5345,11,38,182,231,1.2597402597402598,0.03535616005908382,651,I see you’re allergic to peanuts.
2253,5345,12,36,183,231,1.2597402597402598,0.03588455893595377,651,"If this doesn't work after three days, we'll try Spanx."
4908,5345,15,30,186,231,1.2597402597402598,0.037425019943095494,651,Have you tried a laxative?
7944,5345,10,40,181,231,1.2597402597402598,0.03481974351167981,651,"OK, but airlines will still require you to fasten your seat belt."
1483,5351,11,45,202,258,1.2596899224806202,0.032861126518702294,651,"I'm sorry Mr Johnson, your insurance only covers squeezing sensations, not crushing sensations."
6666,5352,12,37,186,235,1.2595744680851064,0.03546535706915052,651,Squeezing chest pain?  I need to refer you to the cardiologist.
4734,5352,11,39,185,235,1.2595744680851064,0.03494883836275733,651,"Having a little difficulty breathing, are we?"
4114,5352,13,35,187,235,1.2595744680851064,0.03597446040149249,651,"You didn't want single-payer healthcare to tread on your taxes, so your insurance company is squeezing you instead."
8851,5352,10,41,184,235,1.2595744680851064,0.03442457049506837,651,It all started when I swallowed a fly.
1616,5352,8,45,182,235,1.2595744680851064,0.03335132014624786,651,You came all the way to Canada from where?
3163,5352,8,45,182,235,1.2595744680851064,0.03335132014624786,651,That's a wrap.
6822,5358,16,36,210,262,1.2595419847328244,0.03470275240963322,651,"First of all, repeat whatever you did when you took off that shirt."
1440,5358,11,46,205,262,1.2595419847328244,0.032527583846503054,651,Now when did you start feeling this tightening feeling?
5960,5358,9,50,203,262,1.2595419847328244,0.03161564146630713,651,I'm going to prescribe something to slough off this mortal coil.
2829,5361,11,40,188,239,1.2594142259414225,0.03455410411879226,651,Take two wombats and call me in the morning
8411,5361,9,44,186,239,1.2594142259414225,0.03352111418221168,651,Cut down on the apples.
5193,5363,11,47,208,266,1.2593984962406015,0.03220322750179104,651,"Have you ever had any feelings of:
__chest tightness?__suffocation?__neck pain?"
7860,5364,10,43,190,243,1.2592592592592593,0.033670033670033676,651,This is exactly why I warned you about snake-coil remedies.
6364,5364,11,34,171,216,1.2592592592592593,0.03697238111859774,651,"Unfortunately, Mr. Smith, your insurance doesn't cover cosmetic snake removal."
1550,5364,5,53,185,243,1.2592592592592593,0.03104223722994239,651,I understand you can't wrap your head around this either.
3488,5364,12,39,192,243,1.2592592592592593,0.034665421350124584,651,And how much does your friend weigh?
726,5368,12,40,195,247,1.2591093117408907,0.03428347086934362,651,"We could removed it, but it will just grow back."
3541,5368,10,44,193,247,1.2591093117408907,0.03330954453349347,651,You're wound too tight!
4199,5368,9,46,192,247,1.2591093117408907,0.03281174253401685,651,"""It worries me that you seem to have gained a few pounds."""
1834,5371,15,42,221,278,1.2589928057553956,0.032900089505715414,651,There’s been some of that going around.
7957,5371,15,42,221,278,1.2589928057553956,0.032900089505715414,651,Any allergies to medications?
4742,5373,11,43,197,251,1.2589641434262948,0.03343956448497609,651,A muscle relaxant prescription should help you get rid of this person.
1205,5373,20,25,206,251,1.2589641434262948,0.0374840907931126,651,"Your chart says you're due for your prostate exam, but your snake has already taken of that."
3239,5373,8,49,194,251,1.2589641434262948,0.03197791336320111,651,"So, we've got increasing constriction of the torso. Anything else?"
8048,5373,11,43,197,251,1.2589641434262948,0.03343956448497609,651,How soon after you refused a bite of Ms. Eve's apple did this happen?
8385,5377,8,42,174,224,1.2589285714285714,0.034362427191472464,651,"Might I suggest a veterinarian?"""
3989,5377,7,44,173,224,1.2589285714285714,0.03377481259148336,651,"Im prescribing a very gentle conditioner for rough, scaly areas."
190,5379,13,40,202,255,1.2588235294117647,0.03400988128461221,651,I'm afraid I cannot examine your if you're half snaked.
1465,5379,13,40,202,255,1.2588235294117647,0.03400988128461221,651,No eating apples and  stay away from gardens
1931,5379,9,48,198,255,1.2588235294117647,0.032142776054275006,651,So you say your arms aren't moving when you try to hug him back?
5579,5379,8,50,197,255,1.2588235294117647,0.03165879908249426,651,Shortness of breath... high blood pressure... I’ll prescribe a statin and order some unnecessary tests!
2334,5383,12,35,181,228,1.2587719298245614,0.03617579301464775,651,"Symptom ""tightness around chest and stomach""  when did this all begin?"
886,5384,11,38,183,232,1.2586206896551724,0.03522123122157186,651,"Yes I have seen the studies on anxiety and swaddling, but I believe they were with blankets.."
1620,5384,11,38,183,232,1.2586206896551724,0.03522123122157186,651,You say he loves you but you need for him to loosen up.
3583,5384,13,34,185,232,1.2586206896551724,0.036265315860142686,651,After the stress test you will have one minute to run
8132,5387,15,38,210,263,1.258555133079848,0.03416243290173364,651,Most people prefer them over our standard patient gowns
8265,5387,11,46,206,263,1.258555133079848,0.0324186925599665,651,I'm prescribing 25 mg. of charm tablets taken daily with woodwind accompaniment.
676,5389,11,39,186,236,1.2584745762711864,0.034817812063909694,651,And how long have you worn the choker?
4669,5389,9,43,184,236,1.2584745762711864,0.03376619587021813,651,"The good news is, your blood pressure’s down."
6198,5389,14,33,189,236,1.2584745762711864,0.036338218406733076,651,"Here's permission to take your Boa on the plane, but you'll still need to wear a seat belt."
6261,5389,8,45,183,236,1.2584745762711864,0.0332279093061847,651,"Hmm, bit of tightness in the chest you say?"
6387,5389,14,33,189,236,1.2584745762711864,0.036338218406733076,651,"So, when you agreed to this, you thought your wife meant a feather boa?"
6612,5389,14,33,189,236,1.2584745762711864,0.036338218406733076,651,At least you won’t feel so squeezed by my bill.
7942,5389,14,33,189,236,1.2584745762711864,0.036338218406733076,651,Ever think about a simple feather boa?
6167,5389,13,35,188,236,1.2584745762711864,0.035838583820925946,651,And you really think you’re a Gryffindor?
7310,5389,10,41,185,236,1.2584745762711864,0.03429603490539155,651,You both could shed a few pounds.
8674,5398,9,36,164,209,1.2583732057416268,0.03654165788010213,651,"- Well, maybe no more jungle fever perfume."
7371,5399,13,36,191,240,1.2583333333333333,0.035425126153536234,651,Focusing on the scales is not the way to lose that holiday weight.
5928,5399,11,40,189,240,1.2583333333333333,0.0344267999677643,651,Bank of America has upped its penalties.
9091,5399,12,38,190,240,1.2583333333333333,0.0349295299067595,651,"It's not a heart attack per se, but your valves are pretty constricted."
1979,5399,13,36,191,240,1.2583333333333333,0.035425126153536234,651,Normally I would advise against a less constrictive diet.
196,5399,12,38,190,240,1.2583333333333333,0.0349295299067595,651,So you say it feels like a snake is wrapped around you?
2784,5399,12,38,190,240,1.2583333333333333,0.0349295299067595,651,"I’ll order some tests - don’t worry, we’ll get to the bottom of that high blood pressure."
5235,5399,13,36,191,240,1.2583333333333333,0.035425126153536234,651,"I'm sorry I have to ask this, but did the snake eat your clothes?"
3782,5406,11,33,169,213,1.2582159624413145,0.03729199318169915,651,Before we treat you- have you recently traveled to any countries in South America or Africa?
4496,5407,6,51,187,244,1.2581967213114753,0.031473517660523635,651,"There’s acupressure and then there’s ACUPRESSURE, Mr. Gibson."
7374,5407,9,45,190,244,1.2581967213114753,0.033042039952043245,651,We determined she loves you & won't squeeze you to death so you have nothing to worry about.
8331,5407,11,41,192,244,1.2581967213114753,0.03404760095859679,651,It could be because you are transitioning from Adam to Eve
9207,5407,8,47,189,244,1.2581967213114753,0.03252760428883,651,"Sorry, you're only covered for venomous reptiles."
4428,5411,12,40,196,248,1.2580645161290323,0.03416093225129197,651,"Yes,but the symbol for medicine has two snakes.  
I have no idea what to do about one."
4912,5411,9,46,193,248,1.2580645161290323,0.032695866767309165,651,Im scheduling you for a Coilastophy immediately!
2207,5411,14,36,198,248,1.2580645161290323,0.03510368952145218,651,Pressure in the neck area? You might be wearing your boa a bit too tight
956,5411,13,38,197,248,1.2580645161290323,0.034635518693213414,651,"Okay, Adam. I guess an apple a day didn't work."
2222,5411,13,38,197,248,1.2580645161290323,0.034635518693213414,651,"How long have you felt ""constricted""?"
5700,5416,9,47,196,252,1.257936507936508,0.03235964712271704,651,This isn’t a garden variety illness. It might rattle you.
6014,5416,10,45,197,252,1.257936507936508,0.03284457817416253,651,You said I have the chicken pox?! There must be a missed snake.
2817,5418,10,37,174,221,1.257918552036199,0.03579577870670777,651,"We believe it's compression sickness, but we'll need bloodwork to confirm"
285,5419,10,46,200,256,1.2578125,0.03250762895942621,651,"Well, there's absolutely nothing wrong with your lungs...we'll have to do some more tests."""
420,5419,14,38,204,256,1.2578125,0.03434086428981613,651,You’re too tense! You must learn to unwind after you capture your prey.
1429,5419,12,42,202,256,1.2578125,0.033436812802174296,651,I am writing you a prescription for sssssssssoloft.
2289,5419,10,46,200,256,1.2578125,0.03250762895942621,651,The results of your stress test are inconclusive.
3493,5419,11,44,201,256,1.2578125,0.03297549386234702,651,"So you climbed the ladder, then what happened?"
536,5424,12,34,179,225,1.2577777777777779,0.03647375901935203,651,Somehow I don't think that is how the Cleopatra diet works.
3457,5424,7,44,174,225,1.2577777777777779,0.03364405443149005,651,why not a cat?
4190,5424,9,40,176,225,1.2577777777777779,0.034803555536096376,651,When did you first notice there was no way out?
8973,5424,14,30,181,225,1.2577777777777779,0.037545974169900596,651,"By the way, the boa is very becoming."
2104,5428,10,47,203,260,1.2576923076923077,0.03218011923566494,651,There is a high possibility that you will die.
3461,5429,13,33,183,229,1.25764192139738,0.0365628322231106,651,"Actually, your blood pressure is normal."
1439,5429,9,41,179,229,1.25764192139738,0.03440376750478946,651,We'll have to contact your insurance company to get a pre-cert to have that Boa surgically removed.  We'll get back to you in a day or two.
8749,5429,11,37,181,229,1.25764192139738,0.03549971773619434,651,So...your shortness of breathe started in the Garden of Eden?
1357,5429,13,33,183,229,1.25764192139738,0.0365628322231106,651,You'll have to get a different comfort animal and come back. But here's a prescription for high blood pressure.
4678,5433,10,48,206,264,1.2575757575757576,0.03186163422555761,651,"Your healthcare provider covers birds of prey attacks, not snakes. Was this a preexisting condition?"
7631,5433,11,46,207,264,1.2575757575757576,0.032310507538697596,651,"Yes, chest constrictions are one of the side effects of Boa-tox. Let’s try Croc-bitus instead."
9121,5433,12,44,208,264,1.2575757575757576,0.03275322975361734,651,Let me know if your breath feels constricted in the next few weeks.
1851,5436,8,44,181,233,1.257510729613734,0.03346823517470244,651,We'll start with some muscle relaxants.
9009,5436,7,46,180,233,1.257510729613734,0.03291085075869719,651,The good news is you can float.
9208,5436,15,30,188,233,1.257510729613734,0.03713641665595701,651,"No, I don't think he'll work as a flotation device."
9225,5436,12,36,185,233,1.257510729613734,0.03561063658376512,651,"I'm sorry, you'll  have to pay up front if things are a little tight."
7686,5440,16,37,215,268,1.257462686567164,0.03410595061962354,651,"Who's been charming who?"""
5544,5440,16,37,215,268,1.257462686567164,0.03410595061962354,651,"If you don't have a bowel movement within 12 hours, schedule another appointment so we can discuss other options."
233,5440,9,51,208,268,1.257462686567164,0.0311057054087912,651,I'm referring you to a witch doctor.
6141,5443,11,39,187,237,1.2573839662447257,0.034687739272912355,651,"Well, I guess I did suggest a cold compress."
4273,5443,9,43,185,237,1.2573839662447257,0.03364110349400496,651,"Since there's no ICD code for the procedure, you'll have to pay out-of-pocket for the boa removal.  Sorry."
8746,5443,12,37,188,237,1.2573839662447257,0.03519938865450852,651,You'd be surprised how many patients still prefer the stethoscope.
7943,5443,12,37,188,237,1.2573839662447257,0.03519938865450852,651,"Other than a constricted airway, do you have any other ailments?"
5889,5443,8,45,184,237,1.2573839662447257,0.03310537929866921,651,"If you want to be held and squeezed, please try the internet instead of the pet store the next time."
7725,5443,9,43,185,237,1.2573839662447257,0.03364110349400496,651,The tightness in your chest could be bronchitis or pneumonia. We'll run some tests.
9088,5449,7,39,160,206,1.2572815533980584,0.035547901089127074,651,"It might make you feel thinner, but you are still overweight."
219,5449,9,35,162,206,1.2572815533980584,0.0368561075757905,651,So when did your shortness of breath issues first start?
5819,5449,11,31,164,206,1.2572815533980584,0.03811944463701067,651,Do you have a family history of diabetes or high cholesterol?
2858,5452,10,42,189,241,1.2572614107883817,0.033792598374420516,651,And how long were you in Florida?
3184,5452,12,38,191,241,1.2572614107883817,0.0348008045613542,651,A dog’s not a bad pet
5328,5452,10,42,189,241,1.2572614107883817,0.033792598374420516,651,We're going to the vet next.
8000,5452,8,46,187,241,1.2572614107883817,0.032753372523638,651,Asp-IRIN. I said take Asp-IRIN.
8361,5452,11,40,190,241,1.2572614107883817,0.03430040599623027,651,Do you have a Living Will?
1785,5457,8,47,190,245,1.2571428571428571,0.03241170418356571,651,"You say your breathing feels constricted, right?"
8736,5457,11,41,193,245,1.2571428571428571,0.03392471936717906,651,Now explain to me one more time how this happened.
9029,5457,15,33,197,245,1.2571428571428571,0.03584285989641029,651,Honestly? I've heard of worse diet plans.
8892,5460,12,40,197,249,1.2570281124497993,0.03403924466753278,651,Take two aspirin and in the morning call the vet.
8340,5460,10,44,195,249,1.2570281124497993,0.033074082717198555,651,"Before we get started, let's double check the blood pressure the admissions nurse recorded. It seems a bit high."
5651,5460,15,34,200,249,1.2570281124497993,0.03543773444316465,651,I recommend an apple a day.
3294,5460,16,32,201,249,1.2570281124497993,0.035891790669180766,651,"So, I'm a litte confused...which one of you is the service animal?"
8218,5460,9,46,194,249,1.2570281124497993,0.032580781645136433,651,Was it something ate you?
539,5465,8,39,167,214,1.2570093457943925,0.03532025826213392,651,"I'm prescribing you a topical ointment, that should help you with your dry and scaly skin."""
3155,5465,10,35,169,214,1.2570093457943925,0.036541409136236186,651,I can tell you it’s not Cancer or AIDs.
5182,5467,9,47,197,253,1.256916996047431,0.03224760962278702,651,I told you you might feel a little pressure.
7171,5467,10,45,198,253,1.256916996047431,0.03273038226129743,651,Now turn your head and cough.
6034,5467,11,43,199,253,1.256916996047431,0.03320613677556668,651,When did you start feeling under insurmountable pressure?
4420,5467,15,35,203,253,1.256916996047431,0.035044627347221045,651,"No, that's not what a herpetologist does."
1079,5467,12,41,200,253,1.256916996047431,0.03367517061789932,651,Make friends with the snake or you've got about eight minutes to live.
3288,5467,13,39,201,253,1.256916996047431,0.034137760804300234,651,.....and has it helped your sore throat?
2759,5467,13,39,201,253,1.256916996047431,0.034137760804300234,651,It seems you have a parasite.
1658,5467,10,45,198,253,1.256916996047431,0.03273038226129743,651,"This new compression garment should do the trick.  Just be sure and give it the occasional mouse, or the side effects could prove fatal."
3682,5467,12,41,200,253,1.256916996047431,0.03367517061789932,651,"I'm sorry, but your insurance does not include a pythonectomy."
4377,5476,8,40,170,218,1.2568807339449541,0.03489863649150721,651,"All the tests came back negative, so we're ruling out a heart attack as the cause of that pressure you're feeling in your chest."
2284,5477,12,42,203,257,1.2568093385214008,0.03332155811284796,651,"You should probably quit smoking, it’s not good for you"
6795,5477,10,46,201,257,1.2568093385214008,0.03239642834786351,651,A little snake oil will get you back on your feet.
323,5479,10,37,175,222,1.2567567567567568,0.03565310586678822,651,I can't say we've had a LOT of success with this diet.....
6149,5479,9,39,174,222,1.2567567567567568,0.03507676169918354,651,"Yeah, I think it's too late."
8631,5481,6,46,174,226,1.2566371681415929,0.032922257057943854,651,Were you claustrophobic before your trip to the Amazon?
3135,5481,6,46,174,226,1.2566371681415929,0.032922257057943854,651,I'll prescribe a muscle relaxant.  Your hands and arms should release within two days and you'll be good to go.
449,5481,11,36,179,226,1.2566371681415929,0.03578451960854455,651,"Jewish mother?  Me, too. 'Never leave home without a wrap.'"
367,5481,10,38,178,226,1.2566371681415929,0.03523067522556606,651,"Lab results are in.Your ex wife was right, men are snakes."
2674,5485,14,40,211,265,1.2566037735849056,0.03350817710724789,651,"I'm prescribing a muscle relaxant --for Slithers, and a generic cat replacement for You"
1324,5486,12,35,183,230,1.2565217391304349,0.03589566166698184,651,"Okay, so the lap-band surgery was safer and wasn't that expensive, and there's no way to really tell if you've lost any weight."
2715,5486,10,39,181,230,1.2565217391304349,0.03482174559150608,651,We'll need to do some tests to rule out COPD.
4264,5486,12,35,183,230,1.2565217391304349,0.03589566166698184,651,"This might explain the blood pressure, but you should have felt this coming on."
4276,5486,13,33,184,230,1.2565217391304349,0.03642074692734702,651,So you say you've been feeling a little pressure in your chest and breathing is difficult?
5113,5486,11,37,182,230,1.2565217391304349,0.0353627805223939,651,"You know, there are other ways to cut out carbs"
8796,5486,10,39,181,230,1.2565217391304349,0.03482174559150608,651,"I'm prescribing an audition with with Cirque  du Soliell ."""
1955,5492,12,45,212,269,1.2565055762081785,0.032318944379587156,651,It's just stress.
8781,5493,6,48,180,234,1.2564102564102564,0.032224140452411044,651,Have your wife keep feeding it twice a day.
8018,5493,10,40,184,234,1.2564102564102564,0.03442564434197826,651,So tell me about this tight feeling.
6051,5493,11,38,185,234,1.2564102564102564,0.03495436208080898,651,I'm going to order some lab tests to see if we can get to the bottom of what's causing your breathing problem.
5145,5493,13,34,187,234,1.2564102564102564,0.035988502451590416,651,"I'd say you are too wrapped up in your work, but..."
6021,5493,9,42,183,234,1.2564102564102564,0.03388867876215394,651,Come back in a week if your rat problem persists.
3319,5493,8,44,182,234,1.2564102564102564,0.03334306686746957,651,Obviously an eating disorder...
2273,5493,6,48,180,234,1.2564102564102564,0.032224140452411044,651,She's just affectionate.  Show some heart!
785,5493,8,44,182,234,1.2564102564102564,0.03334306686746957,651,Constriction is more of a mental health issue.
3495,5493,9,42,183,234,1.2564102564102564,0.03388867876215394,651,We're going to get you down to X-ray...
8827,5502,8,45,185,238,1.2563025210084033,0.0329837211791613,651,"I know this diagnosis is ubiquitous, but you really do seem to have a constriction of the bowels."
8658,5502,11,39,188,238,1.2563025210084033,0.03455861000407481,651,You thought you were buying a scarf?
8622,5502,9,43,186,238,1.2563025210084033,0.03351690743024604,651,"Naked and afraid, or have you been draining the swamp once too often?"
8236,5502,20,21,197,238,1.2563025210084033,0.038902602910100996,651,"We can't help you, but  I am sending you to a veterinary clinic that might suggest a better diet for him."
3664,5502,11,39,188,238,1.2563025210084033,0.03455861000407481,651,Neither of you will be able to lead normal lives until you both get over this unnatural attachment to each other.
2278,5502,12,37,189,238,1.2563025210084033,0.03506785916301091,651,My advice is to stop playing around in the grass.
5747,5502,8,45,185,238,1.2563025210084033,0.0329837211791613,651,We recommend that you contact a veterinarian at your earliest convenience.
7732,5509,12,38,192,242,1.256198347107438,0.034673001668036045,651,Have you considered SPANX?
2818,5509,11,40,191,242,1.256198347107438,0.03417491284359032,651,"Unfortunately, your policy doesn’t cover snake charming."
3717,5509,11,40,191,242,1.256198347107438,0.03417491284359032,651,So mister Bluth what brings you in today?
6354,5509,6,50,186,242,1.256198347107438,0.031566798758249345,651,On the bright side it seems your blood pressure has stabilized.
9177,5509,12,38,192,242,1.256198347107438,0.034673001668036045,651,Please fill out your insurance info and sign here...
6037,5514,18,37,230,285,1.256140350877193,0.03340154024677592,651,DO YOU HAVE ANY ALLERGIES?
8693,5515,9,45,192,246,1.2560975609756098,0.03280631671040115,651,Some fiber might loosen it up a bit; alternatively I'd suggest a long walk through the dog park.
7746,5515,12,39,195,246,1.2560975609756098,0.034290034004524815,651,It's not FDA-approved but let's try it.
1776,5517,17,30,203,250,1.256,0.036209120420225976,651,I see that I am no longer your main squeeze.
5797,5517,13,38,199,250,1.256,0.03438875318154943,651,You’ve improved your diet and exercise and still your your blood pressure is too high
8501,5517,11,42,197,250,1.256,0.0334414311486377,651,The good news: I'm not as concerned about that tightening in the chest you called in about...
7980,5520,12,41,201,254,1.2559055118110236,0.03355757660907696,651,"There are better ways to feel loved, Mr. Thornton."
5564,5521,10,36,173,219,1.2557077625570776,0.035943731742157335,651,He does the overdue payment therapy.
8452,5522,4,49,170,223,1.2556053811659194,0.0319166785275184,651,So it says here you're experiencing tight bands of pressure across your chest.
9023,5522,11,35,177,223,1.2556053811659194,0.03607586967761211,651,"I regret to inform you that, because you've been wearing the snake since before the inception date of your insurance, the Company has declined coverage for the Reptile Intervention Procedure (R.I.P.)."
626,5522,11,35,177,223,1.2556053811659194,0.03607586967761211,651,I'm going to write you a prescription for one less snake.
698,5522,7,43,173,223,1.2556053811659194,0.033761987483609805,651,"If you don't lose weight with this program, we'll have to resort to drastic measures."
7615,5522,13,31,179,223,1.2556053811659194,0.03717884694382502,651,"Mr. Jones,  I can find nothing wrong with you but I am going to suggest you see a therapist to help you with the pressure you've been experiencing lately."
4713,5527,13,43,214,270,1.2555555555555555,0.03263765300374856,651,I recommend you cross the equator and jump out when your friend reverses his spiral.
16,5527,8,53,209,270,1.2555555555555555,0.030455413985678418,651,So what is your family hisssstory?
722,5529,8,42,177,227,1.2555066079295154,0.03396429428713777,651,I see we've gained a few pounds...
2337,5529,10,38,179,227,1.2555066079295154,0.03509334632407898,651,I'm afraid you have herpetology.
3459,5529,10,38,179,227,1.2555066079295154,0.03509334632407898,651,It's warmer in here.  You can remove that.
7793,5529,8,42,177,227,1.2555066079295154,0.03396429428713777,651,I'm putting you on a restricted diet.
8829,5529,13,32,182,227,1.2555066079295154,0.036721893482218756,651,Have you considered couple's therapy?
8839,5529,7,44,176,227,1.2555066079295154,0.03338545269311284,651,What did I tell you about avoiding apples?
4909,5535,12,35,184,231,1.2554112554112553,0.03575717926798244,651,How's your main squeeze?
5731,5535,14,31,186,231,1.2554112554112553,0.0367948760157091,651,"Wow, your blood pressure is really high."
4799,5535,8,43,180,231,1.2554112554112553,0.033585738127739455,651,Tightness and a squeezing sensation in your chest and arms. Definitely a heart attack.
4555,5535,14,31,186,231,1.2554112554112553,0.0367948760157091,651,"Remember, I warned you that micro-dosing acid had some side effects."
9039,5539,9,53,216,278,1.2553956834532374,0.030336079588261622,651,HAve you been under any kind of pressure lately?
4491,5540,8,44,183,235,1.2553191489361701,0.033218802439195,651,Here is a prescription for a muscle relaxant
8290,5540,9,42,184,235,1.2553191489361701,0.033761799191252745,651,The good news is you have not been bitten.
4171,5540,9,42,184,235,1.2553191489361701,0.033761799191252745,651,Here's a prescription for some deconstrictants
73,5540,13,34,188,235,1.2553191489361701,0.035851639867310124,651,"Tightness of the throat due to anxiety""  isn't turning out to be a complete misdiagnosis on my part, now is it"
5547,5544,9,43,187,239,1.2552301255230125,0.03339359849587618,651,I hope that your wait was not too long.
2683,5544,4,53,182,239,1.2552301255230125,0.030648489064146803,651,It's winter.  A mink would be warmer.
8725,5546,8,46,189,243,1.2551440329218106,0.03251758435833721,651,"I'm writing a prescription for Adderall and vodka;
should do the trick."
4282,5546,10,42,191,243,1.2551440329218106,0.03354718412239765,651,The pressure should let up as soon as it digests its last meal!
352,5546,10,42,191,243,1.2551440329218106,0.03354718412239765,651,Some muscle relaxer should do it.
953,5546,10,42,191,243,1.2551440329218106,0.03354718412239765,651,Try not to exhale for a bit.
1890,5546,14,34,195,243,1.2551440329218106,0.03551695514290313,651,Are you under a lot of pressure in your zoo career?
3074,5546,11,40,192,243,1.2551440329218106,0.03405031126968276,651,"We like to call the procedure "" Squeeze 'em until they pay up"""
3260,5546,11,40,192,243,1.2551440329218106,0.03405031126968276,651,So you're feeling a little chest pressure?
5997,5546,12,38,193,243,1.2551440329218106,0.0345461116854346,651,"So take 3 of these, and the human should clear right up"
6629,5546,9,44,190,243,1.2551440329218106,0.03303639549832598,651,"Everything seems fine, except a little tightness around the chest..."
8037,5546,14,34,195,243,1.2551440329218106,0.03551695514290313,651,You can put your jacket back on.
9169,5556,8,47,192,247,1.2550607287449393,0.03218228577355597,651,I'm going to write you a script for a snake charmer.
3423,5556,16,31,200,247,1.2550607287449393,0.036041947629008836,651,"So tightness of breath, trouble going to the bathroom- any skin loss?"
2777,5556,11,41,195,247,1.2550607287449393,0.03368152972092189,651,Sounds like restricted blood flow. Here’s an Rx for Viagra.
1930,5556,9,45,193,247,1.2550607287449393,0.03268967461632184,651,"I can remove the snake, but is not covered by your plan in the winter."
1849,5556,11,41,195,247,1.2550607287449393,0.03368152972092189,651,I'm worried about you blood pressure. Why not try to unwind a little bit?
117,5561,18,40,240,298,1.25503355704698,0.03234893984256024,651,Fortunately I took Python in college.
9118,5562,11,42,198,251,1.254980079681275,0.03332354369135695,651,"It's the latest in full-body, simultaneous blood pressure monitoring"
4744,5562,11,42,198,251,1.254980079681275,0.03332354369135695,651,You bought the wrong kind of boa.
4354,5562,10,44,197,251,1.254980079681275,0.03284183390417801,651,"Now that the anesthesia has worn off, we need to have a frank discussion. I’m a veterinarian and the snake is here for help with an eating disorder."
7507,5565,13,39,203,255,1.2549019607843137,0.0338993261428364,651,We'll schedule you for an X-ray.
3567,5566,10,46,203,259,1.2548262548262548,0.032176229363258854,651,"I distinctly said service animal to depend on, not servile dependence​."
7470,5566,8,50,201,259,1.2548262548262548,0.031232182297435396,651,So you're saying you feel a bit constricted lately?
8354,5566,7,52,200,259,1.2548262548262548,0.03074929183854215,651,"Now if you'll just remove your snake, the examination can begin."
586,5569,8,37,163,208,1.2548076923076923,0.03590135499788339,651,"You can’t turn your head, so just cough.”"
8469,5569,11,31,166,208,1.2548076923076923,0.037792336404448616,651,Have there been any changes in appetite?
151,5571,10,47,206,263,1.2547528517110267,0.031857235425868435,651,I think it is safe to say your chest pain is not from your heart.
3088,5571,9,49,205,263,1.2547528517110267,0.03139838212969341,651,All the tests came back within the normal range...
6197,5573,8,38,166,212,1.2547169811320755,0.03545960513116345,651,"So, tightness in the chest, wheezing, shortness of breath. The doctor will be in shortly."
8724,5574,13,29,174,216,1.2546296296296295,0.037981865422837,651,Cobra is used for payment not preventing an exam
4891,5574,10,35,171,216,1.2546296296296295,0.03624118009378602,651,Let's take your temperature.
4686,5574,11,33,172,216,1.2546296296296295,0.03683055058950818,651,He obviously likes you. What we need to worry about is the big squeeze.
1299,5577,7,42,171,220,1.2545454545454546,0.03401506715249038,651,Aww he's an affectionate one isn't he; just look at the hug!
7475,5577,11,34,175,220,1.2545454545454546,0.03637401263331927,651,"Come on sir, 
You can’t call Donald trump a snake and not expect him to come after you"
6536,5579,13,31,180,224,1.2544642857142858,0.03703008361176514,651,"Except for his body temperature, all reads fine. You might want to hug him more, even casually, during the cold season."
3162,5579,12,33,179,224,1.2544642857142858,0.03648545813601487,651,"And yes, this is one of the potential side effects of the recommended medication."
3174,5579,16,25,183,224,1.2544642857142858,0.038617902622910365,651,Our colon constrictor is trained to release only after you flush.
1673,5579,11,35,178,224,1.2544642857142858,0.03593257878994312,651,"OK ,One more try, Deep Breath."
1814,5583,11,36,181,228,1.2543859649122806,0.035505473539571064,651,"Would you say it's more of an aching pain, or a burning pain?"
705,5583,10,38,180,228,1.2543859649122806,0.03495705634926824,651,"I normally treat bowel constrictions,
but give this a whirl and see me again in 2 weeks."
588,5583,8,42,178,228,1.2543859649122806,0.03383356415276674,651,About how long have you been experiencing this chest tightness?
8902,5583,11,36,181,228,1.2543859649122806,0.035505473539571064,651,You should try not to get so wrapped up in work.
5107,5587,7,45,180,232,1.2543103448275863,0.03289636231204995,651,I recommend aloe vera for my patients with scaly skin.
6575,5587,16,27,189,232,1.2543103448275863,0.037656894174796965,651,Don't worry-I'll help you with your shoes.
4205,5589,11,38,187,236,1.2542372881355932,0.03469140726524356,651,It's psychosomatic.
4859,5589,8,44,184,236,1.2542372881355932,0.03309543258495489,651,I'm afraid the gown is not optional.
725,5591,11,39,190,240,1.2541666666666667,0.034303142742984356,651,"So, how are the kids?"
782,5591,13,35,192,240,1.2541666666666667,0.03530496578413667,651,It's all in your head.
6032,5591,12,37,191,240,1.2541666666666667,0.03480765871948745,651,I' m sorry but I can't treat you until you provide the co-pay
2,5594,8,46,190,244,1.2540983606557377,0.032400919197676355,651,"So,when did you first notice your high blood pressure?"
8436,5594,11,40,193,244,1.2540983606557377,0.03392659215305128,651,I recommend getting a second opinion.
7218,5594,7,48,189,244,1.2540983606557377,0.03187613843351548,651,"well, let's see, the slugs didn't work, then we tried the leeches and they didn't work, now....."
5161,5594,10,42,192,244,1.2540983606557377,0.03342577286612489,651,"Sir, you seem to have ordered the wrong type of boa!"
1708,5594,8,46,190,244,1.2540983606557377,0.032400919197676355,651,"We might be able to remove it sooner, but you'll probably have to wait until 2020."
3071,5594,7,48,189,244,1.2540983606557377,0.03187613843351548,651,"don’t worry, your wraparound insurance policy covers you without a deductible."
5764,5600,8,47,193,248,1.2540322580645162,0.03206875198829399,651,Your tests came back normal.  Are you getting enough fiber in your diet?
1256,5600,9,45,194,248,1.2540322580645162,0.03257383485187591,651,"So, instead of going on the ""freeze your fat"" diet you elected to apply the snake oil directly?"
1794,5602,12,40,200,252,1.253968253968254,0.03367920346070661,651,"On a scale from 1 to 10, how much do you feel loved?"
5146,5602,7,50,195,252,1.253968253968254,0.031244055083937988,651,It says here that you have been suffering from chest pain.
2583,5604,12,41,203,256,1.25390625,0.03332477534519322,651,"Well, fashion choice aside, you should have been a little suspicious finding a discount boa at an Everglades tourist trap."
3655,5605,11,44,205,260,1.2538461538461538,0.03252701096968222,651,Try fasting for a couple  weeks.
8329,5605,12,42,206,260,1.2538461538461538,0.032980395272371385,651,"Surprisingly, your pressure is normal."
3452,5605,13,40,207,260,1.2538461538461538,0.033427630816764246,651,"Don’t worry, there’s a pill for this too."
691,5605,13,40,207,260,1.2538461538461538,0.033427630816764246,651,Ancient remedies are ancient for a reason.  This'll relieve your gas and constipation jusssst fine.
2687,5605,13,40,207,260,1.2538461538461538,0.033427630816764246,651,Have you noticed any trouble breathing lately?
6297,5610,7,36,154,197,1.2538071065989849,0.03645342633083918,651,You're blood pressure seems to be a little high.
4688,5611,16,35,213,264,1.253787878787879,0.03436505611889145,651,"It appears that your COBRA Health Care doesn't cover ""Cobra for weight reduction"""
1587,5612,14,41,217,272,1.2536764705882353,0.03284009650537527,651,"So let me recap, you've been experiencing a squeezing sensation for the last month. But what made you come today?"
2123,5613,11,48,217,276,1.2536231884057971,0.03127639898106214,651,So what's wrong with you?
7386,5613,10,50,216,276,1.2536231884057971,0.030852271749249115,651,"Despite the chest pain, it’s not a heart attack. We’ll keep running tests."
1338,5615,9,36,168,213,1.2535211267605635,0.03593463715751371,651,Tests indicate you are allergic to reptiles.
2557,5615,17,38,229,284,1.2535211267605635,0.03304170589253753,651,"I'm sorry, we would like to help, but you are out of network."
6345,5617,11,33,173,217,1.2534562211981566,0.03667920578609817,651,"Sorry, your insurance dosen't cover this."
8620,5617,7,41,169,217,1.2534562211981566,0.03427370051608827,651,Just slough off your things and we'll rattle through the tests.
4831,5619,12,33,180,225,1.2533333333333334,0.03634054100635983,651,How long have you had the sore throat?
4197,5619,10,37,178,225,1.2533333333333334,0.0352316596439884,651,And we don't have to squeeze the little pump to tighten it around your arm.
2384,5621,11,36,182,229,1.2532751091703056,0.035367537477128515,651,One obvious sign should have been there's no feathers.
4374,5621,9,40,180,229,1.2532751091703056,0.03426736007296486,651,"I guess the 'take two aspirin and call me in the morning' routine won't work this time."""
5587,5621,8,42,179,229,1.2532751091703056,0.03370380684666488,651,With your co-pay that will be $30.00 for the office visit and $85.00 for rats for your snake.
6426,5621,8,42,179,229,1.2532751091703056,0.03370380684666488,651,"It says here you've been having trouble breathing, have you considered less constrictive clothing?"
8915,5621,10,38,181,229,1.2532751091703056,0.034821793991452514,651,"Hmm...according to these lab results, your breathing is fairly constricted."
661,5626,12,35,186,233,1.2532188841201717,0.035483323711250826,651,Next time can we just stick with the feather boa?
1070,5626,9,41,183,233,1.2532188841201717,0.03388318546792147,651,Is that one flu shot or two?
4994,5626,12,35,186,233,1.2532188841201717,0.035483323711250826,651,I suggest we add feathers and try to pass it off as a fashion statement.
5923,5626,13,33,187,233,1.2532188841201717,0.0360009017893353,651,Tightness in the chest is typical in this type of case.
6011,5626,10,39,184,233,1.2532188841201717,0.034424830072224244,651,So you say this is your main squeeze.
3821,5631,5,50,182,237,1.2531645569620253,0.03130402833822216,651,"Fortunately, it is a python and not an anaconda, and it appears to have eaten recently.  We'll see."
3157,5631,9,42,186,237,1.2531645569620253,0.0335107895064053,651,Jungle Book?  Can’t say I have read it.
1290,5631,10,40,187,237,1.2531645569620253,0.03404013394697794,651,I'd say you have about  5 minutes left. Any last words?
1415,5631,11,38,188,237,1.2531645569620253,0.034561371860992396,651,"I'm going to prescribe you oxycodone to help with the pain."""
5886,5635,11,39,191,241,1.2531120331950207,0.034176785426468306,651,"So, Adam, you are saying that an apple a day has caused this pre-existing condition?"
5157,5635,12,37,192,241,1.2531120331950207,0.03467896781477496,651,"No, I would not recommend flying."
1064,5635,12,37,192,241,1.2531120331950207,0.03467896781477496,651,You may have used too much snake oil.
8563,5635,13,35,193,241,1.2531120331950207,0.03517398122632039,651,'Sore throat'
585,5635,9,43,189,241,1.2531120331950207,0.03314960586287826,651,Your circulation seems to be constricted.
2713,5635,11,39,191,241,1.2531120331950207,0.034176785426468306,651,It appears you have a constriction in your airways.
1325,5635,11,39,191,241,1.2531120331950207,0.034176785426468306,651,This is what's known as a python wart.  I'll give you some drops and it might fall off in a few weeks
7180,5635,9,43,189,241,1.2531120331950207,0.03314960586287826,651,Gastric bypass surgery remains the preferred method
2856,5643,13,36,196,245,1.2530612244897958,0.034779380204575196,651,"This is not FDA approved and it originated from a trible tradition, but it’s effective in treating constipation."
4857,5643,7,48,190,245,1.2530612244897958,0.03176270226691413,651,"The good news is, you're not snakebit."
4605,5643,10,42,193,245,1.2530612244897958,0.033305213876441545,651,She’s also your Emergeny contact?
4353,5643,10,42,193,245,1.2530612244897958,0.033305213876441545,651,"Come back next week, if you can...."
3065,5643,8,46,191,245,1.2530612244897958,0.03228506250032037,651,When did the scales first start appearing?
5943,5648,11,41,197,249,1.2530120481927711,0.03344171417922102,651,Are you feeling any pressure in your chest?
7010,5648,9,45,195,249,1.2530120481927711,0.03245878952291113,651,Have you ingested any rodents in the past 24 hours?
4409,5648,10,43,196,249,1.2530120481927711,0.03295391679707708,651,"I can get the snake off. But I must warn you, if this happens again, a python and a shirt do not constitute an outfit."
3641,5651,14,36,203,253,1.2529644268774704,0.03448287833544769,651,I’m not sue what’s constricting your airways…let’s run some tests.
7829,5651,14,36,203,253,1.2529644268774704,0.03448287833544769,651,So today we have our blood pressure gauge in training.
4918,5651,11,42,200,253,1.2529644268774704,0.033090181452151694,651,When did you start feeling a tightness in your throat?
3232,5651,8,48,197,253,1.2529644268774704,0.03163623426982675,651,It's OK but my wife personally goes with chinchilla.
431,5655,11,43,203,257,1.2529182879377432,0.03274867246861236,651,"Well, I said to put some _re_-strictions on your activity, but I guess this could work, as well."
6767,5655,9,47,201,257,1.2529182879377432,0.03180688420903247,651,Well at least he's friendly.
926,5657,11,44,206,261,1.2528735632183907,0.032416740213797,651,You should avoid fashion weeks...
5708,5657,11,44,206,261,1.2528735632183907,0.032416740213797,651,You've put on a few pounds since I last saw you.
6091,5659,6,55,204,265,1.2528301886792452,0.02978395078548806,651,So what alternative therapies are you using?
6476,5660,15,39,219,273,1.2527472527472527,0.033141640596376754,651,How long have you had this chest tightness?
5488,5661,12,27,163,202,1.2524752475247525,0.03911606521254878,651,I'm afraid you're going to have to shuffle off this mortal coil.
9037,5662,9,35,166,210,1.2523809523809524,0.03623415957950616,651,"unfortunately we don’t provide
couple’s therapy"
2969,5663,10,34,170,214,1.2523364485981308,0.03639382326690041,651,"Unfortunately, for some reason your blood pressure has skyrocketed."
4659,5663,7,40,167,214,1.2523364485981308,0.034538087165409626,651,"Yeah, it can take up to a week to get used to the shallow breathing and full body numbness, but I can give you something for the bulging eyeballs."
3045,5665,7,41,170,218,1.2522935779816513,0.03413592455927654,651,"Well, the medical name is encirclification, but first let's talk about what to do."
2102,5666,9,39,178,226,1.252212389380531,0.034528398471249375,651,"*Sigh* ""Back at it again are we, Phil?"""
4225,5666,11,35,180,226,1.252212389380531,0.03564930622774258,651,"I know I said to keep your neck warm this winter and wear a boa, but..."
6697,5666,15,27,184,226,1.252212389380531,0.03779151361852746,651,Mine's bigger.
446,5666,9,39,178,226,1.252212389380531,0.034528398471249375,651,"So I read your chat, but why don't you tell me exactly what happened?"
1563,5670,6,46,178,230,1.2521739130434784,0.032424325311555716,651,"Now remember, this snake oil script is a topical."
7831,5670,12,34,184,230,1.2521739130434784,0.03576549389176894,651,There are easier ways to lose weight.
5390,5672,8,43,183,234,1.2521367521367521,0.033207623532318084,651,Please remove everything but your underwear and slip into the gown. Then I'll come back to do the exam.
8560,5673,9,42,187,238,1.2521008403361344,0.033386640417860526,651,"So let’s see, shortness of breath, elevated blood pressure, and increased heart rate."
1991,5673,14,32,192,238,1.2521008403361344,0.035943759718575094,651,Now you say it started out quite small....
6670,5673,10,40,188,238,1.2521008403361344,0.03391349258414041,651,"It’s probably not covered by your insurance, but there is a type of oil that could help you."
1496,5673,8,44,186,238,1.2521008403361344,0.03285133996549439,651,"With the symptoms you described: shortness of breath, right arm hurts and chest pain, all lead me to thinking you are having a heart attack.  These algorithms are so helpful!"
2226,5673,12,36,190,238,1.2521008403361344,0.034943374493322826,651,Really nothing that a more positive attitude wouldn't solve.
246,5673,12,36,190,238,1.2521008403361344,0.034943374493322826,651,Do you think these shoes are too casual?
771,5673,7,46,185,238,1.2521008403361344,0.032307171288515193,651,My suggestion is to use the feather type next time
3266,5680,12,37,193,242,1.2520661157024793,0.03455120337277494,651,What snake?
5924,5680,10,41,191,242,1.2520661157024793,0.03354401438256282,651,The weight loss outcomes compare very favorably with bariatric surgery
2935,5680,12,37,193,242,1.2520661157024793,0.03455120337277494,651,I’m writing instructions for safer ways for you to lose weight.
2806,5680,9,43,190,242,1.2520661157024793,0.03302890437318418,651,"The good news is: you have thirty seconds to live. The bad news is: twenty nine, twenty eight, twenty seven....."
3123,5680,11,39,192,242,1.2520661157024793,0.03405133297981472,651,"And, you're pregnant."
6702,5680,12,37,193,242,1.2520661157024793,0.03455120337277494,651,I want you to try this feather boa I'm prescribing--you should feel less constricted right away.
7909,5680,13,35,194,242,1.2520661157024793,0.035043944288728264,651,This pressure you feel -- does it often seem to come on at mealtimes?
8422,5680,10,41,191,242,1.2520661157024793,0.03354401438256282,651,The good news: you’ll have a friend for life.
4418,5688,15,32,199,246,1.2520325203252032,0.03559771538965607,651,Can you be more specific about where you feel this tightness?
933,5688,12,38,196,246,1.2520325203252032,0.034170825641687885,651,The Guinness Book of Records people are on their way to measure your tapeworm.
1164,5688,15,32,199,246,1.2520325203252032,0.03559771538965607,651,"Normally, I would recommend a conventional colonoscopy, but since you prefer traditional medicine..."
164,5691,6,51,193,250,1.252,0.030818551759129124,651,So you are having restricted movement?
2757,5691,6,51,193,250,1.252,0.030818551759129124,651,I'm writing you a one-time prescription for Snake Charmer.
9019,5693,13,38,203,254,1.2519685039370079,0.033905389271920876,651,"Here’s a new prescription, seems the last one did nothing for your high blood pressure."
1345,5693,8,48,198,254,1.2519685039370079,0.03152717022241648,651,It looked so easy when Britney Spears did it.
7131,5693,9,46,199,254,1.2519685039370079,0.032016949481839724,651,I'm still going to order an enema. You're very constricted.
4111,5696,7,51,200,258,1.251937984496124,0.030732231420389437,651,I wouldn't worry Mr. Schmank... constricted breathing is perfectly normal with this sort of thing.
8931,5696,10,45,203,258,1.251937984496124,0.032170787937716494,651,"Yes, a lot of it is in your head."
1180,5696,13,39,206,258,1.251937984496124,0.03354771445256261,651,Stop watching British comedies
7683,5696,12,41,205,258,1.251937984496124,0.0330951048067781,651,"I’m sorry. Your HMO Will only allow two rats per  week, at least until molting  season."
822,5696,15,35,208,258,1.251937984496124,0.034435091267902576,651,I don't get paid enough for this.
2213,5701,9,48,205,262,1.251908396946565,0.03138885070445861,651,What do you usually feed him?
6858,5702,12,43,211,266,1.2518796992481203,0.03242767745536713,651,"As a physician, over the course of my career, I've seen many reasons why people come into the office complaining of shortness of breath"
4184,5703,10,48,212,270,1.2518518518518518,0.031238176686454063,651,I see that you are married
5133,5704,9,54,223,286,1.2517482517482517,0.02969482986643531,651,. . . and you know it's unhealthy to get too wrapped up in your work.
6097,5705,9,34,164,207,1.251207729468599,0.03654090193054718,651,"...On a scale of 1 to 10, how would you say the male enhancement pills are working?"
1305,5706,9,36,170,215,1.2511627906976743,0.03563843440732989,651,Tests show your new pet is fine.  I encourage you to continue bonding with it.
5269,5707,10,35,174,219,1.2511415525114156,0.03579975360140294,651,"Mr. Boa, I'm afraid that you have a serious case of humanitis."
3704,5708,12,32,179,223,1.251121076233184,0.03649525451628822,651,"Doctor, ""Marital staus?""
Adam, ""It's complicated."""
8929,5708,9,38,176,223,1.251121076233184,0.03479520328427734,651,I raised him since birth and now he has separation anxiety.
8416,5710,7,43,177,227,1.251101321585903,0.033241104784887364,651,Do you get short of breath easily?
6256,5710,10,37,180,227,1.251101321585903,0.03495605172237755,651,"Well I'm no wizard but I'm pretty sure the Sorting Hat would say, ""Slytherin!"""
2780,5710,8,41,178,227,1.251101321585903,0.033822416859519165,651,I've never used the phrase 'wardrobe malfunction' in my patient notes before.
3223,5713,7,44,180,231,1.251082251082251,0.03287962332375619,651,"We think we’ve figured out what causing that crushing chest pain, and it may not be your heart."
612,5713,9,40,182,231,1.251082251082251,0.03400524462080611,651,"On a scale of 1 to 10, 10 being the worst pain and 1 being no pain, how much pain are you experiencing?"
3102,5713,10,38,183,231,1.251082251082251,0.03455430765657516,651,I’m not sure if this is covered under your medical plan or his ...
6867,5713,11,36,184,231,1.251082251082251,0.03509478157119138,651,"Well, that just about wraps it up for today.""

submitted by Susan Davidson, s.davidson@starpower.ne"
7030,5713,10,38,183,231,1.251082251082251,0.03455430765657516,651,"So, how to you like our new exam gowns?"
8267,5713,11,36,184,231,1.251082251082251,0.03509478157119138,651,I’m not seeing anything in your blood work which which might explain the tightening feeling in your chest.
7247,5719,12,35,188,235,1.251063829787234,0.0352135392288001,651,You first saw it in your toilet?
2595,5719,9,41,185,235,1.251063829787234,0.033628597913228905,651,"We'll have to wait until the tests come back, but I don't think it's malignant."
6438,5719,10,39,186,235,1.251063829787234,0.03416508227336545,651,We have no data to show this as an effective weight loss treatment.
349,5719,12,35,188,235,1.251063829787234,0.0352135392288001,651,"We can help you Mr. Jones, but please stop calling it a 'hissssterectomy.'"
3129,5723,11,38,190,239,1.2510460251046025,0.034304134522402746,651,The good news is no one will notice your overweight.
6012,5723,8,44,187,239,1.2510460251046025,0.0327305991723022,651,You say you're having shortness of breath?
1730,5723,14,32,193,239,1.2510460251046025,0.0358085907078776,651,I suggest next time you just get a pair of Spanx.
7757,5723,8,44,187,239,1.2510460251046025,0.0327305991723022,651,You're all wrapped up and ready to go.
1341,5727,11,39,193,243,1.2510288065843622,0.0339267760531377,651,You've got the grip.
2347,5727,11,39,193,243,1.2510288065843622,0.0339267760531377,651,Next time come directly to me; not some snake oil salesman!
6057,5727,13,35,195,243,1.2510288065843622,0.03491484502901638,651,"You're concerned you may have contracted Dengue fever in South America, any other worries?"
6196,5730,13,36,198,247,1.2510121457489878,0.03452748441754945,651,Your tests came back positive.  You have chest pains and you are a little short of breath.
7364,5730,10,42,195,247,1.2510121457489878,0.03306661841606423,651,Any problems with shortness of breath?
4588,5730,9,44,194,247,1.2510121457489878,0.03256510317139229,651,I'm not a dermatologist so I do not know when he will shed his skin.
2166,5733,7,49,195,251,1.250996015936255,0.031226521314463525,651,I'm going to revert to 'At least do no harm.'
2249,5733,13,37,201,251,1.250996015936255,0.03415158405057664,651,"ohhhh,the internet says it's a snake,does it? see this stethoscope? It means I'm the doctor. So,I'll ask for the third time: will you please put on your gown?"
2878,5733,11,41,199,251,1.250996015936255,0.03320520551424554,651,"So, you are saying your throat feels contracted?"
4704,5733,8,47,196,251,1.250996015936255,0.031732761357354394,651,A pity you don't reciprocate her feelings.
8945,5733,11,41,199,251,1.250996015936255,0.03320520551424554,651,Let's forget about the shortness of breath for a moment and talk about the itching
6893,5738,10,44,201,255,1.2509803921568627,0.032386726129154234,651,"Well first, I think we should do something about your blood pressure."
7891,5738,13,38,204,255,1.2509803921568627,0.03378661730261624,651,"Hello Tom, it's good to see you again. You always have such interesting underwear."
9032,5738,15,34,206,255,1.2509803921568627,0.034688506670257774,651,No worries.  A little snake oil should loosen that up.
2740,5741,10,45,204,259,1.250965250965251,0.03206109544384303,651,The results say you're gonna kill at fashion week.
6871,5741,11,43,205,259,1.250965250965251,0.03252451542371714,651,I’m going to start you with a cold blood panel.
7054,5741,14,37,208,259,1.250965250965251,0.03387676033821446,651,"Your annual medicare examination is complete.
You're in perfect health for a man your age."
2184,5741,8,49,202,259,1.250965250965251,0.031113555182306126,651,All your test results are normal. You just need to loosen up.
8828,5745,10,46,207,263,1.2509505703422052,0.03174444767004392,651,"As an endangered species, I’m just verifying, you do have a DNR on file with us.  Right?"
2618,5745,12,42,209,263,1.2509505703422052,0.03264598068844111,651,My professional opinion is that you have a Lady Gaga Competetiveness Disorder
2422,5745,10,46,207,263,1.2509505703422052,0.03174444767004392,651,You say you are experiencing a tightness in your chest?
6009,5748,10,47,210,267,1.250936329588015,0.03143639330087543,651,Yeah - two a day until it goes away. But I’m not sure whether to write mongooses or mongeese...
76,5749,13,42,216,271,1.2509225092250922,0.0324266330294319,651,I understand snake oil is not covered by your plan.
7423,5749,13,42,216,271,1.2509225092250922,0.0324266330294319,651,It's a natural cough suppressant.
6499,5751,11,47,217,275,1.250909090909091,0.0312719248056793,651,The x-rays show no cause for your episodic shortness of breath.
3572,5752,14,43,226,283,1.2508833922261484,0.031895265498271305,651,I see your first name is Eve. And your family name?
5059,5753,14,29,185,228,1.25,0.03697284499079072,651,The good news is that your EKG results rule out your heart as the cause of the tightness in your chest.
4495,5753,12,38,198,248,1.25,0.03392503008381573,651,I see a constriction.
4476,5753,15,39,222,276,1.25,0.032818822325218024,651,"It's normal to feel all choked up at your daughter's wedding. 
Any other issues?"
4178,5753,11,42,203,256,1.25,0.03274605199972399,651,Middle class squeeze.  It’s going around.
3981,5753,14,40,218,272,1.25,0.03273741985195315,651,"Adam Johnson
100 Pleasant Lane
Garden of Eden Nudist Colony, NJ
Occupation: Snake charmer
Allergies: Apples, Brunettes named Eve, poison ivy
""Says here you're having work anxieties?"""
5166,5753,10,35,175,220,1.25,0.03565493496996936,651,"If you're feeling smothered and she can't let go, here's the name of an in network couple's therapist."
5721,5753,7,49,196,252,1.25,0.031118303728104525,651,This is what happens when you wear a boa before Labor Day.
5841,5753,12,44,216,272,1.25,0.03189785901950502,651,"Very good. Our 'Restrictor Constrictor,' Emma, has helped you lose thirty-five pounds."""
5115,5753,12,38,198,248,1.25,0.03392503008381573,651,"Drink plenty of water, get lots of rest and stay wrapped up."
6125,5753,10,41,193,244,1.25,0.033300429013583294,651,Let's start with a relaxant.  You seem pretty tightly wound.
6878,5753,12,32,180,224,1.25,0.03634925608153451,651,The symptoms point to Psoriasis
6463,5753,7,45,184,236,1.25,0.03240843296469038,651,This is not what I meant by a diet constriction.
6470,5753,10,38,184,232,1.25,0.03442206182161019,651,"In your case, it's not politics that's making it hard to breath"
6590,5753,10,38,184,232,1.25,0.03442206182161019,651,Good news. Your insurance covers pre-existing conditions.
6787,5753,11,37,188,236,1.25,0.03456232969535516,651,How long have you had this shortness of breath Mr. Smith?
3905,5753,13,37,202,252,1.25,0.034030370966329306,651,"I warned you at your last visit, Mr. Little, about the health risks of hiking in the Everglades."
7287,5753,11,35,182,228,1.25,0.03537036441320954,651,I’m afraid this isn’t covered by your insurance.
7302,5753,12,37,195,244,1.25,0.03429841540555655,651,You're guaranteed to lose weight without surgery.
8456,5753,10,40,190,240,1.25,0.033662944959099855,651,"So you say your chest is a bit tight, right?"
8485,5753,12,41,207,260,1.25,0.032868504382441564,651,"Three rats a day for your pet, starting now. For you, a weighted blanket and a shrink."
8571,5753,10,39,187,236,1.25,0.03403663625102412,651,When did you decide to give him up as a pet
9101,5753,13,33,190,236,1.25,0.03559042971561637,651,Just sit tight and the doctor will be right in.
6313,5753,9,44,195,248,1.25,0.03244931551783603,651,The good news is: I think it likes you.
3763,5753,7,40,169,216,1.25,0.03425722227806045,651,Sorry sir you are not on the endangered species list.
4331,5753,8,45,191,244,1.25,0.03227159502790776,651,Your insurance will authorize physical therapy to strengthen your core. That should take care of it.
223,5753,12,32,180,224,1.25,0.03634925608153451,651,How long  have you been wearing your wife's boa?
7185,5753,15,33,204,252,1.25,0.034947178071623994,651,"Yeah, I know it’s rough!  You’re the third one today . Sometimes it’s really not psychosomatic"
8263,5753,7,44,181,232,1.25,0.032755477886027264,651,I need to listen to your heart. Can you unwrap?
8897,5753,12,34,186,232,1.25,0.035489665336872964,651,"Normally, I’d just write a prescription for snake oil, but your condition calls for stronger medicine."
1220,5753,13,29,178,220,1.25,0.037360505737450526,651,"We've eliminated asthma, pneumonia, and sinusitis. I'm beginning to suspect your breathing difficulty may result from an allergy to pets."
7514,5753,10,38,184,232,1.25,0.03442206182161019,651,Fill this script for snake oil and text me in a few days if your symptom hasn’t improved.
206,5753,12,34,186,232,1.25,0.035489665336872964,651,I see here you have Omamba Care...how has that been working out for you?
3752,5753,14,40,218,272,1.25,0.03273741985195315,651,Can you tell me what happened?
302,5753,12,43,213,268,1.25,0.03221255709314753,651,Just looks like a sore throat.
560,5753,10,42,196,248,1.25,0.0329485650741675,651,No problem. I'll prescribe him Valium.
1733,5753,9,38,177,224,1.25,0.03465765582065099,651,"Shortness of breath, high blood pressure... I’m going to schedule you for an EKG and a stress test."
1857,5753,7,52,205,264,1.25,0.030241757386915546,651,You might feel a small pinch.
1601,5753,8,39,173,220,1.25,0.03447103692786923,651,"Look at it this way. Camo is in, feathers are out. And, it's not venomous."
1988,5753,12,30,174,216,1.25,0.037267799624996496,651,I said you needed sodium restriction. Not boa constriction.
3661,5753,7,47,190,244,1.25,0.031744676439106626,651,"I understand the benefits, but your blood pressure is through the roof."
2191,5753,7,42,175,224,1.25,0.03348247650912125,651,I'll need to order some tests to see what's causing this constriction.
2476,5753,13,36,199,248,1.25,0.03440287094209403,651,"What seems to be the problem here, Sir?"
3143,5753,10,39,187,236,1.25,0.03403663625102412,651,"So, how long have you been experiencing your current symptoms?"
3145,5753,11,44,209,264,1.25,0.03209025611286236,651,"How many times have I told you not to get too wrapped up in your work, it's dangerous."
3654,5753,10,44,202,256,1.25,0.03227486121839514,651,In my experience the oil form is just as ineffective.
3597,5753,12,35,189,236,1.25,0.03508014624622208,651,"On your mother's side, then?"
1902,5753,15,33,204,252,1.25,0.034947178071623994,651,I'm afraid it's hereditary
3622,5753,9,44,195,248,1.25,0.03244931551783603,651,"You know the old adage Mr. Smith, ”let pythons be pythons.” I think it's time for you to reconcile."
693,5801,12,43,214,269,1.2490706319702602,0.03210603834469611,651,You say cat had your tongue last week?
217,5801,11,45,213,269,1.2490706319702602,0.03167104938181135,651,You indicate here that you are experiencing some constriction in your chest?
4460,5803,14,38,213,265,1.2490566037735849,0.03329663449009268,651,It's normal to feel some tightness in the chest when being consumed by a constrictor
4765,5804,14,37,210,261,1.2490421455938698,0.03364405586992594,651,First case of yourus toastus I've seen in a while.
7894,5804,8,49,204,261,1.2490421455938698,0.030904495397683134,651,You’re right. A lot of medicine is just snake oil.
8183,5804,15,35,211,261,1.2490421455938698,0.03407924498348291,651,So it started as a growth on your neck?
3880,5807,14,36,207,257,1.2490272373540856,0.03400149863151083,651,It’s nothing serious; a sun bath and some rat broth might make her feel better until she gets back on her stomach.
3377,5808,13,37,203,253,1.2490118577075098,0.03390999705379874,651,I can assure you the tightness you feel in your chest is not your heart.
6333,5808,12,39,202,253,1.2490118577075098,0.033444256660922385,651,Sorry if I wasn't clear. I never meant to say take two asps and call me in the morning.
5548,5808,17,29,207,253,1.2490118577075098,0.03571227081181748,651,"Have you been having any trouble swallowing, have you been feeling any tightness in the chest, any cramps in the abdomen, ..."
8189,5808,9,45,199,253,1.2490118577075098,0.03200639801415785,651,"So, how long have you had this pressure in your chest?"
3229,5808,8,47,198,253,1.2490118577075098,0.031512535874691196,651,Your chest x-ray confirms severe boa-constriction of you lungs.
1539,5808,11,41,201,253,1.2490118577075098,0.03297193817497939,651,"Sorry I misplaced my glasses. What, exactly, did you want me to notice about that scaly rash?"
787,5808,12,39,202,253,1.2490118577075098,0.033444256660922385,651,I'm going to refer you to a specialist.
6010,5808,11,41,201,253,1.2490118577075098,0.03297193817497939,651,I can see why you have a bit of tightness in your chest!
4351,5816,18,26,205,249,1.248995983935743,0.03656497184490445,651,All the tests indicate that you have been under a lot of pressure lately
6161,5816,14,34,201,249,1.248995983935743,0.03474833386098565,651,How else did you think you were going to lose 50 pounds in one week?
667,5818,8,45,192,245,1.2489795918367348,0.03215579882528694,651,Very stylish scarf but you'll have to remove it.
3702,5818,12,37,196,245,1.2489795918367348,0.03417337296059856,651,And just how long have you felt this shortness of breath?
6158,5818,10,41,194,245,1.2489795918367348,0.03317992478590401,651,"As an avid amateur herpetologist, I'm tempted
to just watch..."
5320,5821,8,44,189,241,1.2489626556016598,0.032491684398422434,651,"No, I’ve never heard of “Take Your Owner to the Vet Day”..."
8752,5821,12,36,193,241,1.2489626556016598,0.03455462547173756,651,The bad news is that your insurance doesn't cover this.
6551,5823,11,37,189,237,1.248945147679325,0.034432349869945374,651,"Yeah, I don't see anything that would explain the chest tightness. Have you tried yoga?"
4192,5823,10,39,188,237,1.248945147679325,0.03390912873815443,651,"I suggest, you stay off the jungle gym for a while."
7558,5823,9,41,187,237,1.248945147679325,0.03337770672162984,651,I'm sorry - hospital gowns cost extra.
1262,5823,12,35,190,237,1.248945147679325,0.03494773845833123,651,I'm going to give you a note saying you need emotional support so you can take your snake on the plane and in restaurants.  I hope I get to see what happens when it sees some nut's emotional support poodle.
1378,5827,9,40,184,233,1.2489270386266094,0.033747004142342156,651,"So, I see you’ve recently been to southern Florida."
6544,5827,12,34,187,233,1.2489270386266094,0.03535330667316863,651,I’m going to run some tests but it looks like a classic class of compression.
6936,5827,7,44,182,233,1.2489270386266094,0.03263223793256231,651,"Well, your temperature is down."
3681,5830,13,31,185,229,1.2489082969432315,0.03630342853655411,651,It appears that you are a little wrapped up in yourself!
8601,5831,7,42,176,225,1.248888888888889,0.03335184671067474,651,The tests came back positive.   You have a boäl constriction.
1528,5831,9,38,178,225,1.248888888888889,0.03452116391979599,651,"Well the strep test came back negative, so there's not much I can do for you."
4674,5833,9,37,175,221,1.248868778280543,0.034927266847667476,651,I would not call this a successful weight-loss option.
6781,5833,10,35,176,221,1.248868778280543,0.03551125602821103,651,We'll have to do more tests.  That tightness in your chest is not your heart.
2109,5835,8,38,171,217,1.2488479262672811,0.034738131116823896,651,"You're a herpetologist?  As I tell many of my patients, getting too wrapped up in your work is bad for your health."
5009,5835,11,32,174,217,1.2488479262672811,0.036534175042198094,651,We'll do a battery of tests to discover what's causing the pressure in your chest.
2728,5837,11,48,223,282,1.24822695035461,0.030687526061301706,651,It appears that you have intimacy issues.
1077,5838,9,48,209,266,1.2481203007518797,0.03097325626925239,651,"Your blood pressure’s up just a tad. But  otherwise, that about wraps things up.




Kay Spencer, New York, NY"
1063,5839,12,41,209,262,1.248091603053435,0.032644914936310554,651,I’m feeling a little constricted.
6634,5839,11,43,208,262,1.248091603053435,0.032193834944230365,651,It's time to talk about your co-pays.
8445,5841,10,44,204,258,1.248062015503876,0.032053374250283886,651,"Normally we'd say to take two of these, but why don't we start with just one and see how you do."
3064,5841,11,42,205,258,1.248062015503876,0.032520485599815595,651,And what were you hoping to cure with the snake oil?
1635,5843,12,39,203,254,1.2480314960629921,0.03332674874359441,651,It turns out that your insurance company considers only true feather boas to be a covered condition.
169,5843,5,53,196,254,1.2480314960629921,0.029879993952350522,651,We don't recommend it as a pool toy.
3966,5843,8,47,199,254,1.2480314960629921,0.03140353187558465,651,The snake says you have high blood pressure. The salt in your diet is killing you slowly.
5930,5846,10,42,198,250,1.248,0.03271490578071354,651,This should help with the scaly skin.
7097,5846,9,44,197,250,1.248,0.03222012641478521,651,My notes say that you've just returned from the Amazon.
8986,5846,10,42,198,250,1.248,0.03271490578071354,651,"When I prescribed massage therapy, this is not what I had in mind."
4466,5849,12,37,197,246,1.2479674796747968,0.03404921913505909,651,I think one more week and we will have those love handles all but gone.
6726,5849,13,35,198,246,1.2479674796747968,0.03453307586961687,651,"I'm sorry, but this is not covered under your HMO."
6206,5849,14,33,199,246,1.2479674796747968,0.03501024613347006,651,Your blood pressure is still too high.
5056,5849,12,37,197,246,1.2479674796747968,0.03404921913505909,651,Let's forgo the exam and focus on the history. Do you have any allergies?
4144,5849,13,35,198,246,1.2479674796747968,0.03453307586961687,651,We're pretty constricted here in terms of treatment options...
2723,5849,10,41,195,246,1.2479674796747968,0.033060267891963493,651,"If I don't say so, Sam, your generation has taken college initiations to a whole new level."""
3700,5855,10,40,192,242,1.2479338842975207,0.03341598130680023,651,"The MRI, Colonoscopy and Cardiogram are fine. I don't see any physical reason for your symptoms"
292,5855,12,36,194,242,1.2479338842975207,0.03442691621835588,651,"I see, the turtlenecks were not on sale?"
5545,5857,13,33,192,238,1.2478991596638656,0.0353218393720921,651,Sounds like asthma.
1779,5857,13,33,192,238,1.2478991596638656,0.0353218393720921,651,So for how long have you had this shortness of breath?
3755,5857,10,39,189,238,1.2478991596638656,0.033782549845131425,651,"Security is fine, but I suggest that you give each other a little more space."
5123,5857,13,33,192,238,1.2478991596638656,0.0353218393720921,651,You’re having some tightness around your chest.
8740,5857,13,33,192,238,1.2478991596638656,0.0353218393720921,651,Call me in two weeks if the symptoms don’t go away.
8026,5857,11,37,190,238,1.2478991596638656,0.03430332192225439,651,How long have you had these dreams?
6350,5863,8,42,184,234,1.2478632478632479,0.033069255368622784,651,"Mr. Smith, you'll have to shed your clothing for this exam."
6511,5863,11,36,187,234,1.2478632478632479,0.034693269822588586,651,"So, what was it like seeing Samuel L. Jackson on your flight?"
8951,5863,10,38,186,234,1.2478632478632479,0.03416051127935616,651,"Hang in there, Henry. I just need one more x-ray."
1254,5863,5,48,181,234,1.2478632478632479,0.0313612552409408,651,"Although your blood pressure is really high, the good news is that your cholesterol level has never been lower."
617,5867,12,33,185,230,1.2478260869565216,0.03563253405615863,651,"Fred, I can't imagine why you're having sexual problems?"
2459,5867,10,37,183,230,1.2478260869565216,0.034550440269155006,651,"I'm sorry but I only have experience in C++, not Python."
7694,5867,15,27,188,230,1.2478260869565216,0.037196697756246976,651,"As a vegan and animal rights activist, you can ""just say no""."
3094,5867,9,39,182,230,1.2478260869565216,0.033996479855376495,651,The urine tests came back inconclusive
7004,5867,8,41,181,230,1.2478260869565216,0.033433342075263606,651,"Actually, my speciality is internal medicine. You need to consult either a dermatologist, or perhaps a herpetologist. I’m not sure!"
2485,5872,12,32,182,226,1.247787610619469,0.03606066499099971,651,Her owner was here last week for the same thing.
1529,5872,7,42,177,226,1.247787610619469,0.0332222023015955,651,I’m a little concerned about your cholesterol levels.
5952,5874,8,39,175,222,1.2477477477477477,0.034196720841559614,651,Compensating for something?
3573,5874,7,41,174,222,1.2477477477477477,0.03359540101961068,651,You feel constricted?   I've got three more patients and a tee-time at noon.
1363,5876,7,40,171,218,1.2477064220183487,0.033980757227145594,651,You say that you can’t move your arms?
4106,5876,11,32,175,218,1.2477064220183487,0.03638411194893724,651,Just go home and use it as a pool float.
8830,5876,7,40,171,218,1.2477064220183487,0.033980757227145594,651,"We will attempt to remove her without harm, but in the future I suggest you not share the same bed for emotional support."
8760,5876,10,34,174,218,1.2477064220183487,0.03579840313711143,651,Have you been eaten regularly?
5789,5876,10,34,174,218,1.2477064220183487,0.03579840313711143,651,Please remove your garter. The doctor will be with you shortly.
2720,5881,15,40,228,283,1.2473498233215548,0.032188218372464696,651,According to your symptoms of shortness of breath and crushing chest pressure you are having a heart attack.  We will be transferring you to the local ER.
2392,5882,7,52,208,267,1.247191011235955,0.02994494146398903,651,"Honestly, not the first time I've seen this"
8105,5883,14,37,212,263,1.247148288973384,0.03341446243528911,651,I'll ask the nurse to check your blood pressure before we go any further.
7970,5883,10,45,208,263,1.247148288973384,0.03162951320162106,651,So  tell me...how long have you been having this crushing chest pain?
5005,5883,12,41,210,263,1.247148288973384,0.0325342312434985,651,Is the herpetologist in network?
5429,5883,12,41,210,263,1.247148288973384,0.0325342312434985,651,It appears you have boa constrictive heart failure.
4270,5887,9,46,204,259,1.247104247104247,0.03147176707358442,651,Many of my patients feel chest tightness but it's usually not anything serious.
8576,5888,9,45,201,255,1.2470588235294118,0.03178477056579837,651,You say the pain extends from your neck to the knees.  Can you be more specific?
4761,5888,14,35,206,255,1.2470588235294118,0.03412717547011646,651,It looks like a second-degree boa constriction.
5394,5888,13,37,205,255,1.2470588235294118,0.033671733136840215,651,"You could have contracted this anywhere, humans are known to be almost everywhere"
1506,5891,12,38,201,251,1.247011952191235,0.03356275182677298,651,I suggest you return that jacket as quickly as you can
4314,5891,12,38,201,251,1.247011952191235,0.03356275182677298,651,"You should stop using those ""snake oil"" cures."
5489,5891,15,32,204,251,1.247011952191235,0.03495820132767175,651,You say your GP mentioned something about a constricted airway.
3156,5894,11,39,197,247,1.2469635627530364,0.033437320766865244,651,"He is our new intern, specialized in measuring blood pressure. Please, breath normally."
6472,5894,9,43,195,247,1.2469635627530364,0.03243799935640128,651,"I told you to use snake oil, not snake coil."
5513,5894,12,37,198,247,1.2469635627530364,0.03392594477647472,651,I’m going to prescribe a moisturizer.
3512,5894,11,39,197,247,1.2469635627530364,0.033437320766865244,651,It appears as though something is constricting your blood vessels.
1154,5894,12,37,198,247,1.2469635627530364,0.03392594477647472,651,"Something seems to be constricting your diaphragm.
You might want to see a specialist."
170,5894,9,43,195,247,1.2469635627530364,0.03243799935640128,651,How long have you been experiencing constricted breathing?
3299,5900,13,34,196,243,1.2469135802469136,0.03479236812570145,651,I imagine it seemed funnier before the feathers came unglued.
6311,5900,16,28,199,243,1.2469135802469136,0.03622898404392586,651,"I know you’ve been under a lot of pressure lately.”

Submitted for — Craig Tharp. Please advise if this needs to be submitted differently. Thanks"
7409,5900,10,40,193,243,1.2469135802469136,0.03329382036855516,651,I recommend that you get your asp up and get some exercise.
7961,5900,8,44,191,243,1.2469135802469136,0.03225613437306377,651,Your temperature seems to be lower than normal.
8998,5900,11,38,194,243,1.2469135802469136,0.033800719071550155,651,"First, tell me where you got that sweater?"
4174,5905,10,39,190,239,1.2468619246861925,0.033656889813382586,651,"The ""Sorting Hat"" put you in Slytherin and there you shall stay."
7055,5905,12,35,192,239,1.2468619246861925,0.034685836408333004,651,Largest herpetic lesion I have ever seen.
7977,5905,10,39,190,239,1.2468619246861925,0.033656889813382586,651,Herpetic problems are frequently associated with feeling under pressure.
8216,5905,7,45,187,239,1.2468619246861925,0.0320515944807272,651,Does shortness of breath run in your family?
6688,5905,9,41,189,239,1.2468619246861925,0.033130435013631276,651,"Sorry, we ran out of casts."
1712,5905,11,37,191,239,1.2468619246861925,0.034175235765505824,651,You're just lucky he's watching his cholesterol
130,5911,11,36,188,235,1.2468085106382978,0.0345614212937429,651,"Well yes, I imagine you do feel a tightening in the chest."
3133,5912,10,37,184,231,1.2467532467532467,0.03441727122991194,651,Have you felt shortness of breath during exercise or tightness in your chest?
8657,5912,10,37,184,231,1.2467532467532467,0.03441727122991194,651,That's not exactly what's meant by a Lap Band.
4380,5912,6,45,180,231,1.2467532467532467,0.03215547379989576,651,I'm going to prescribe a laxative. That should help with the periodic constrictions you're feeling.
6259,5912,9,39,183,231,1.2467532467532467,0.033865986520533235,651,I'm recommending a less constrictive diet for you.
7135,5912,11,35,185,231,1.2467532467532467,0.03495986377001074,651,"Don’t worry about non poisonous snakes. 
Worry more about  climate change deniers and big pharma."
2150,5917,7,42,178,227,1.2466960352422907,0.03309353265752779,651,Her name is Eve
4785,5917,11,34,182,227,1.2466960352422907,0.03537119228060817,651,"Constriction in the mid-section is a sign of anxiety, Mr. Dobson.  Are you feeling anxious?"
4867,5917,10,36,181,227,1.2466960352422907,0.0348157494311487,651,"Non-venomous, crushed, initial enconter...W59.13.  There’s an ICD 10 code for everything ."
6614,5917,10,36,181,227,1.2466960352422907,0.0348157494311487,651,The system's a squeeze on us all.
6943,5917,6,44,177,227,1.2466960352422907,0.03249918566449987,651,"I’m going to order some tests, so we can find out what’s causing these contractions."
2002,5922,12,30,177,219,1.2465753424657535,0.0368087659115824,651,The hospital and myself would like to thank you for testing our new blood pressure monitoring system .
8211,5923,9,49,214,272,1.2463235294117647,0.03048347921434749,651,So I heard you've been having been having digestive problems?
9175,5924,10,46,212,268,1.2462686567164178,0.031220328001978565,651,"Other than feeling a bit squeezed, how's your general health?"
4935,5924,14,38,216,268,1.2462686567164178,0.032962242465794274,651,Sounds like COPD
2006,5926,8,48,204,260,1.2461538461538462,0.030887802425419057,651,"Medicare For All will cover for the python, but regarding your foot fungus problem you are on your own."
1157,5926,10,44,206,260,1.2461538461538462,0.03183482995198471,651,It's like Rolfing.
6459,5928,12,39,205,256,1.24609375,0.03309413882180072,651,"Not to worry, it's just your reptilian complex."""
4601,5928,9,45,202,256,1.24609375,0.03167507315935885,651,If you could show me exactly where it hurts that would help
203,5930,11,40,201,252,1.246031746031746,0.032967550947102756,651,Prescribing snake oil is frowned upon in this business.
7359,5930,14,34,204,252,1.246031746031746,0.03437612654220263,651,A nudist colony you say...and a garden...and an I Pad?
7235,5930,8,46,198,252,1.246031746031746,0.03149604347936584,651,I think it's just the pressures of modern day society......
7079,5930,11,40,201,252,1.246031746031746,0.032967550947102756,651,"Yes, I have seen this before.  It is the Eve syndrome;  just don't eat any apples for a while"""
8727,5930,10,42,200,252,1.246031746031746,0.03248445569680846,651,I'm concerned about your unexplained weight loss.
2710,5935,11,39,198,248,1.2459677419354838,0.03331710538541951,651,"Not ""Argh.""  Say ""Ahh."""
6549,5935,13,35,200,248,1.2459677419354838,0.03428307508092443,651,There’ll be a co-pay.
7015,5935,11,39,198,248,1.2459677419354838,0.03331710538541951,651,Does Any one in your family have the same problem
8391,5935,12,37,199,248,1.2459677419354838,0.0338035408520132,651,"So...you say this has been going on for thousands of years, ever since your wife gave you a bite of an apple in a garden?"
5089,5935,8,45,195,248,1.2459677419354838,0.031813203589884216,651,"I realize you are very attached to your owner, but sometimes when you love someone you have to set them free."
4278,5940,15,30,199,244,1.2459016393442623,0.03562405685903087,651,"The nurse said you were having breathing problems but I’m a veterinarian. 
What do you think I...can...oh."
1000,5940,11,38,195,244,1.2459016393442623,0.03367711349579453,651,Take a deep breath and hold it.
5148,5940,13,34,197,244,1.2459016393442623,0.03466425681090026,651,Would you say the pressure is like an elephant sitting on your chest?
6452,5940,9,42,193,244,1.2459016393442623,0.03266014768131349,651,Have you tried Tums?
9153,5944,8,43,189,240,1.2458333333333333,0.03247567304678895,651,"When the constrictions start coming 3 minutes apart, that's we can perform the surgery to remove the boa."
664,5944,11,37,192,240,1.2458333333333333,0.0340480814481842,651,"Your bloodwork came back negative, so it seems that your shortness of breath must be psychosomatic."
6928,5944,9,41,190,240,1.2458333333333333,0.03300813298762419,651,"You're in good shape apart from your heart rate, which looks a bit elevated for some reason ..."
4924,5944,11,37,192,240,1.2458333333333333,0.0340480814481842,651,"This new therapy may not be covered
 by your insurance"
637,5944,9,41,190,240,1.2458333333333333,0.03300813298762419,651,Are you allergic to anything besides reptiles?
7367,5944,11,37,192,240,1.2458333333333333,0.0340480814481842,651,Give him two Quaaludes and call me in the morning.
2645,5950,5,48,183,236,1.2457627118644068,0.031130219475369026,651,"I assure you, that tightening in your chest is NOT a heart attack."
6518,5950,10,38,188,236,1.2457627118644068,0.03390281253840371,651,Has your blood pressure always run a bit high?
910,5950,11,36,189,236,1.2457627118644068,0.034430549294195756,651,This is the new and very fashionable Boa diet.
2644,5950,6,46,184,236,1.2457627118644068,0.03170414154760454,651,"You're cholesterol's a touch high, but nothing to be concerned about."
2654,5950,8,42,186,236,1.2457627118644068,0.03282189276446964,651,Call me in a couple of days if it doesn't get better.
5491,5950,8,42,186,236,1.2457627118644068,0.03282189276446964,651,"Okay, open your mouth and cough for me."
5740,5950,10,38,188,236,1.2457627118644068,0.03390281253840371,651,So I see we're here for a routine colonoscopy.
5851,5950,10,38,188,236,1.2457627118644068,0.03390281253840371,651,I told you I am here about the toe fungus.
8441,5958,11,50,232,293,1.2457337883959045,0.02986465003089356,651,"So, the music wasn't completely effective."
5192,5959,13,31,188,232,1.2456896551724137,0.035880707475814955,651,I still can't believe Samual Jackson slept through the entire flight.
8017,5959,8,41,183,232,1.2456896551724137,0.03317876059746328,651,Does this run in your family?
5909,5959,10,37,185,232,1.2456896551724137,0.034285101144028586,651,This is the worst case I've seen of 'ring around the collar.'
5130,5959,10,37,185,232,1.2456896551724137,0.034285101144028586,651,Muscle relaxant. Sending you to the vet.
8371,5963,11,34,183,228,1.2456140350877194,0.03523233202525129,651,SPF 50 on the legs and face and you'll be totally protected.
8616,5963,10,36,182,228,1.2456140350877194,0.0346795956907557,651,...and any other serious allergies?
4479,5963,11,34,183,228,1.2456140350877194,0.03523233202525129,651,"Yes, he does seem to be attached to you and I can see the attraction. But I must warn you, it could be hazardous to your health."
287,5963,10,36,182,228,1.2456140350877194,0.0346795956907557,651,You've gained weight.
6608,5967,9,37,178,224,1.2455357142857142,0.03451165203589813,651,"Remember, your health care plan will only cover the antivenom if your case is deemed medically necessary."
7843,5967,10,35,179,224,1.2455357142857142,0.03508692866505039,651,It seems as if you've shuffled ON  this mortal coil.
6935,5967,19,17,188,224,1.2455357142857142,0.03989283764338087,651,Learn Python.
4324,5970,10,47,216,273,1.2454212454212454,0.030825035838989923,651,"No, I've never been to the Amazon. Why do you ask?"
5395,5971,7,39,170,216,1.2453703703703705,0.03409825519163581,651,There's no danger unless you provoke her.
4277,5972,11,42,208,261,1.2452107279693487,0.0321877673012085,651,"Your  calcium score was zero,  so we'll need to perform a few more tests to get to the cause of your chest pressure."
6164,5972,11,42,208,261,1.2452107279693487,0.0321877673012085,651,You seem to be quite wrapped up in your work.
3161,5972,7,50,204,261,1.2452107279693487,0.03030119784388994,651,Now listen carefully. You need to do what I tell you for a change. Do NOT take a deep breath.
5227,5975,10,43,204,257,1.245136186770428,0.032044003459795425,651,My remote says your blood pressure is 230 0ver 90
1051,5975,11,41,205,257,1.245136186770428,0.03251487337229235,651,The fruit of knowledge has been known to cause digestive problems.
2153,5975,13,37,207,257,1.245136186770428,0.033436726152329205,651,Are you in a committed relationship?
5185,5975,11,41,205,257,1.245136186770428,0.03251487337229235,651,Turn your head and cough.
1313,5979,6,50,197,253,1.2450592885375493,0.03037046809085627,651,Now I will take your blood pressure.  You may feel some pressure with the cuff.
6731,5979,10,42,201,253,1.2450592885375493,0.03237041424519727,651,He was looking for Eve and got turned around.
4082,5979,13,36,204,253,1.2450592885375493,0.03379278781288449,651,"Everything looks good. I'm just recommending some feathers for your boa."""
5169,5982,9,43,197,249,1.2449799196787148,0.03220736211541068,651,A Sore throat you say?
88,5982,12,37,200,249,1.2449799196787148,0.03368199844666719,651,"... so after running a full battery of tests, I finally have your results here, and it would appear that the diagnosis is: pythons don't make for good service animals."
1934,5982,10,41,198,249,1.2449799196787148,0.03270629586806223,651,"I’ ll prescibe some meds for anxiety and depression.
You should feel the tightness in your chest loosen."
7460,5985,12,35,194,241,1.2448132780082988,0.0344277503839438,651,He's my emotional constraint animal.
2666,5985,10,39,192,241,1.2448132780082988,0.0334082879429111,651,"Your pain, is it more internal or external, and on scale of 1 to......"
3167,5985,15,29,197,241,1.2448132780082988,0.03590270792479541,651,Your designer compression stockings appear to be riding up.
3857,5985,13,33,195,241,1.2448132780082988,0.03492632450044642,651,And which part feels constricted...?
5122,5985,12,35,194,241,1.2448132780082988,0.0344277503839438,651,Test results indicate your breathing issues are related to an unusual constriction in you throat area.
1125,5990,5,48,184,237,1.2447257383966244,0.031015929763744912,651,Hold still--this may pinch a bit.
2880,5990,7,44,186,237,1.2447257383966244,0.032148146302403674,651,Well we got a lot of feedback that the traditional gowns were too revealing.
4240,5992,14,29,190,233,1.2446351931330473,0.03625582528899288,651,Boas are so twenties.
8113,5992,15,27,191,233,1.2446351931330473,0.036762528958627506,651,The chart notes say you're having problems with high blood pressure. How long has this been a problem?
5912,5992,10,37,186,233,1.2446351931330473,0.03415391917766063,651,The guy at the pet store said he was starved for attention...
1980,5995,12,44,222,278,1.2446043165467626,0.03128441672293175,651,"It’s flu season, so that explains the difficulty breathing."
8075,5996,7,42,180,229,1.244541484716157,0.03283907587247174,651,Would you describe your mouse eating as moderate
8054,5996,8,40,181,229,1.244541484716157,0.03341721524260942,651,"No, it wouldn’t work differently in Australia."
4315,5996,11,34,184,229,1.244541484716157,0.035094534984947204,651,Do I have this right -- your breathing feels constricted?
7164,5999,10,35,180,225,1.2444444444444445,0.03494768072429205,651,I think a simple boa-dilator should clear this right up.
4842,5999,9,37,179,225,1.2444444444444445,0.03437525052017097,651,"Well, Monty, we’ve diagnosed the tightness in your chest."
1405,6001,17,20,184,221,1.244343891402715,0.0392246506435017,651,"No, shuffling off this mortal coil is not going to work. Try jumping, instead."
6932,6001,7,40,174,221,1.244343891402715,0.03357409515645858,651,Everyone needs a hug once in awhile.
6789,6003,9,46,207,262,1.2442748091603053,0.031153243581016593,651,I don't care what Google said - that's not going to help you get rid of your turkey neck.
3286,6003,11,42,209,262,1.2442748091603053,0.0320783339839113,651,And your problem is.....
3927,6005,11,31,175,217,1.2442396313364055,0.03638586431240522,651,We can apply medical leeches to help with that pooling blood collecting in your legs.
8744,6005,6,41,170,217,1.2442396313364055,0.033325427742494584,651,"I'm thinking we should switch to the Paleo diet, it's less restrictive."
388,6007,12,39,207,258,1.244186046511628,0.03286468407273661,651,"A comfort animal is suppose make you feel better, not to feel more comfortable."
1395,6007,9,45,204,258,1.244186046511628,0.03145787517846103,651,Take a deep breath and let’s start again.
8702,6009,7,48,199,254,1.2440944881889764,0.030775900385036945,651,You’re wrapped tight and need to unwind.
3870,6009,9,44,201,254,1.2440944881889764,0.031771075340451135,651,"“So, tightness of chest? Any clues as to cause?”"
6680,6009,10,42,202,254,1.2440944881889764,0.03225715145790271,651,That feeling of your breathing being constricted Mr. Jones is due to a giant Boa snake that has wrapped itself around your body. I hope this helps you some.
7958,6012,12,37,201,250,1.244,0.0335613087614761,651,I just ran your test and it turns out you're actually a Hufflepuff.
8569,6012,13,35,202,250,1.244,0.03403659735989127,651,"Now we'll get some leeches going on your legs, feet, and toes and that frostbite will be taken care of in no time."
648,6012,13,35,202,250,1.244,0.03403659735989127,651,"""I think you need to see a zookeeper, not a doctor."""
4604,6012,9,43,198,250,1.244,0.03209323766176385,651,I suggest you keep him distracted.
413,6012,12,37,201,250,1.244,0.0335613087614761,651,"Unfortunately, you are now ineligible to donate your organs."
1567,6017,10,40,196,246,1.2439024390243902,0.03293251307493107,651,"Here’s your prescription for Prozac. If it doesn’t loosen up in a few weeks, give me a call and we’ll up your dose."
2985,6017,7,46,193,246,1.2439024390243902,0.03138468418675236,651,I wouldn't worry. He's not venomous.
1047,6017,4,52,190,246,1.2439024390243902,0.02975645115893125,651,Hang in there:  after two weeks or so the snake should grow bored of you and then just hunt for mice in your apartment.
7120,6017,11,38,197,246,1.2439024390243902,0.033432535392039095,651,please put your shoes on and follow me to the xray room.
5859,6017,11,38,197,246,1.2439024390243902,0.033432535392039095,651,"Your bloodwork came back normal. If you don't feel better in a week, give the office a call."
8927,6017,12,36,198,246,1.2439024390243902,0.03392518869585529,651,You should keep it wrapped until the swelling goes down.
1475,6017,10,40,196,246,1.2439024390243902,0.03293251307493107,651,"Well since you've stopped feeding him, your temperature is down, but your blood pressure is still very high."
6834,6024,14,41,228,283,1.243816254416961,0.031696131373871804,651,"On the bright side, you won’t have to explain to your mother why you missed the State of the Union."
2663,6025,8,43,191,242,1.243801652892562,0.03223861434444117,651,"I see you elected NOT to wear the provided privacy gown."""
2516,6025,13,33,196,242,1.243801652892562,0.034796409856087014,651,I have a diagnosis for the tightness in your chest.
2301,6025,8,43,191,242,1.243801652892562,0.03223861434444117,651,I believe I know the cause of your sore throat.
7577,6028,12,34,192,238,1.2436974789915967,0.03468662322321815,651,The regular mouse traps weren't working
4007,6028,11,36,191,238,1.2436974789915967,0.03417169310652412,651,We're trying some non-traditional methods to reduce the swelling.
3434,6028,6,46,186,238,1.2436974789915967,0.03147091523059545,651,"When I said you could benefit from more hugs, this was not what I had in mind."
3147,6028,13,32,193,238,1.2436974789915967,0.03519402010984999,651,"I know how it sounds, but the herpetologist can only help you with the snake."
7619,6028,8,42,188,238,1.2436974789915967,0.032578105334371145,651,I doubt the procedure will be more invasive than the snake.
5669,6033,10,47,218,275,1.2436363636363637,0.030626366120442356,651,When did you first notice this symptom?
5951,6034,10,37,187,234,1.2435897435897436,0.034023714645426986,651,I told you—a dog would have been better.
5918,6034,8,41,185,234,1.2435897435897436,0.03292792550467778,651,I considered a colonoscopy but I don't think the snake could handle the propofol
9011,6034,8,41,185,234,1.2435897435897436,0.03292792550467778,651,"When I suggested you restrict your carb intake, this isn’t quite what I had in mind."
6334,6034,10,37,187,234,1.2435897435897436,0.034023714645426986,651,And how long do you think you’ve been all bound up?
2970,6034,11,35,188,234,1.2435897435897436,0.034558582123538566,651,"It'll be a bit of a squeeze, but I think I can book you for a 3:00pm check-up next Tuesday."
515,6034,8,41,185,234,1.2435897435897436,0.03292792550467778,651,"Well to start, you put on the wrong type of Boa"
7264,6040,9,48,214,271,1.2435424354243543,0.03046857408195038,651,This one perplexes me.  I'm sending you to a specialist.
8516,6041,10,36,184,230,1.2434782608695651,0.03441038732509418,651,So is this shortness of breath only with exercise?
2216,6042,10,35,181,226,1.2433628318584071,0.03480950950208245,651,You seemed to have put on a bit of weight since your last visit.
3868,6042,9,37,180,226,1.2433628318584071,0.03423989756133294,651,Does it feel like an elephant is sitting on your chest?
8032,6042,7,41,178,226,1.2433628318584071,0.03307125415645108,651,And what is your pain level without Monty Python?
835,6045,11,42,210,263,1.2433460076045628,0.03196962527278442,651,I'd like you to have these tests and see me again in two weeks.
6646,6045,13,38,212,263,1.2433460076045628,0.032864981930866316,651,I'd advise you to also stay away from ladders.
8355,6047,9,45,205,259,1.2432432432432432,0.03135036054079868,651,When did you first notice this writhing?
7816,6047,7,40,175,222,1.2432432432432432,0.033440636328003474,651,You can get dressed now.  Or not.
6046,6047,9,36,177,222,1.2432432432432432,0.03463821085616266,651,"How's the external, extra-strength vasoconstriction prescription working for your ?"
5365,6047,14,35,210,259,1.2432432432432432,0.0336525841278211,651,I'm referring you to a specialist named Jack Hannah.
3364,6047,10,43,206,259,1.2432432432432432,0.03182413185817436,651,"It's still not a lap band, Mr. Perkins."
2747,6047,7,40,175,222,1.2432432432432432,0.033440636328003474,651,You seem consumed by your condition
1412,6047,7,49,203,259,1.2432432432432432,0.030380661300591572,651,It’s our new all-natural weight loss treatment.
8700,6047,12,39,208,259,1.2432432432432432,0.03275112049233236,651,Did the snake tell you that an apple a day would keep the doctor away?
1441,6055,8,46,201,255,1.2431372549019608,0.031169250205067875,651,"Yup, this is better than a chiropractor. Now, just stay there for another twenty minutes and whatever he does, don’t struggle. He’ll think you’re prey."
1596,6055,9,44,202,255,1.2431372549019608,0.03166071148088209,651,"Warm in the winter, cool in the summer, with the added benefit that you may lose a bit of weight."
3171,6055,15,32,208,255,1.2431372549019608,0.03446261177352742,651,"On a scale of 1 to 10, with 1 being the least and 10 the worst, how would you rate your pain?"
912,6055,12,38,205,255,1.2431372549019608,0.033091330146494034,651,So you say your are under a lot of pressure at work?  Have you tried yoga?
1119,6059,12,37,202,251,1.2430278884462151,0.03344146311177591,651,He's not really bonding with you; but I'm sure he wants you to become part of his life.
4574,6060,8,36,170,214,1.2429906542056075,0.034851297206411155,651,You'll only need to wear this compression bandage for a few more days!
6895,6061,9,42,196,247,1.242914979757085,0.03230833328366532,651,"This is the most extreme case of a ""suffocating relationship"" I've ever seen.  I am referring to to a veterinarian."
1186,6061,12,36,199,247,1.242914979757085,0.033801987017021924,651,What do you think might be causing this crushing pain that you feel?
5865,6061,7,46,194,247,1.242914979757085,0.03127295607626577,651,Your blood pressure seems a little high. Try to drop a few pounds before our next visit.
3032,6064,10,39,194,243,1.242798353909465,0.03316324760520809,651,Your chest pains are definitely not a heart attack.
5741,6064,10,39,194,243,1.242798353909465,0.03316324760520809,651,That crushing feeling... the labs and contrast studies showed nothing.  I may have to actually examine you.
3397,6066,9,40,190,239,1.2426778242677825,0.03299472235667692,651,"Sir, I don't know why his wife has no interest in apples and I understand you're frustrated, but can you please release this nice man?"
5999,6066,13,32,194,239,1.2426778242677825,0.03506128540520329,651,Slow deep breaths and meditation help
7327,6066,10,38,191,239,1.2426778242677825,0.03352330847502864,651,Not the first bad case of Boa Constrictor I've seen. It's been going around.
2839,6069,8,41,186,235,1.2425531914893617,0.03280388808325793,651,"Sorry, I wasn't paying attention.  Did you say it feels like an elephant sitting on your chest"
3192,6070,10,45,213,268,1.242537313432836,0.0311057054087912,651,"Let's see.  Temperature, check.  Blood pressure, check. Heart rate, check, probably need to get a  closer look at that, little elevated but nothing to worry about now.  Well, guess that does it..... insurance lady is down the hall"
8638,6071,12,40,212,264,1.2424242424242424,0.032310507538697596,651,"Yes, your blood pressure is a little high. Let's see if exercise helps."
686,6071,11,42,211,264,1.2424242424242424,0.03186163422555761,651,I warned you about Chiropractics....
2074,6071,14,36,214,264,1.2424242424242424,0.03319004701982589,651,"Either way, you’ll shuffle off a mortal coil."
7776,6071,10,36,185,231,1.2424242424242424,0.03427731000615556,651,You'll feel better when you regurgitate the apple.
1948,6075,10,43,207,260,1.2423076923076923,0.031715296692945864,651,"Unfortunately, your insurance doesn't cover this."
8139,6076,11,33,183,227,1.2422907488986785,0.03523010588156047,651,"You don't need an x-ray, but the python will."
7872,6076,8,39,180,227,1.2422907488986785,0.03352917916872241,651,"So, your symptoms include shallow breathing?"
4089,6076,9,37,181,227,1.2422907488986785,0.034105581517216696,651,"Sir, these fad diets are difficult to maintain."
1330,6076,8,39,180,227,1.2422907488986785,0.03352917916872241,651,"""Dr. Rosenblatt is one of the best herpetologists in the country."
4028,6080,7,48,201,256,1.2421875,0.030564635135330545,651,"If I had to bet, I’d go for your wheezing being asthma-related."
7192,6080,11,40,205,256,1.2421875,0.03250762895942621,651,This is one Florida diet too many.
7853,6080,9,44,203,256,1.2421875,0.03155109238615684,651,"Yeah, I'm getting a rather high blood pressure reading."
79,6083,10,34,179,223,1.242152466367713,0.03508039338783551,651,"Having...trouble...breathing...Okay, and how long has this been going on for?"
2060,6083,8,38,177,223,1.242152466367713,0.03390922755193605,651,Moments like this make me realize that I'm interfering in Darwinism
7510,6083,11,32,180,223,1.242152466367713,0.035651551772446735,651,I don't care if your underwear is dirty; the snake has got to go.
1685,6086,12,37,203,252,1.242063492063492,0.033322452925476205,651,"We’ve already discussed how your diet  choices affect your digestion, Mr. Snake."
7997,6086,14,33,205,252,1.242063492063492,0.03425821034488501,651,So...are we ready to shuffle off this mortal coil?
8491,6086,13,35,204,252,1.242063492063492,0.03379357072732152,651,"It's obvious he is a loving pet Arlo.....he has a crush on you. I'm prescribing a mild sedative for you, but keep him away from your Viagra!"
1499,6089,5,43,171,219,1.2420091324200913,0.032418055671112556,651,For your shortness of breath I am prescribing an exhaler.
7560,6090,12,44,225,281,1.2419928825622777,0.030986263086620704,651,"For weight loss, diet may have been the better option"
7668,6091,10,40,198,248,1.2419354838709677,0.032695866767309165,651,"I know you want to avoid medication, but we're running out of options."
3765,6091,9,42,197,248,1.2419354838709677,0.03219269856341739,651,"Sorry, we are on a tight schedule."
3591,6091,10,40,198,248,1.2419354838709677,0.032695866767309165,651,"Unfortunately your insurance doesn’t cover wraparound services but keep your head up, usually this problem solves itself."
7755,6091,8,44,196,248,1.2419354838709677,0.03168154001819482,651,I believe your problem is your outfit is to constricting.
694,6091,9,42,197,248,1.2419354838709677,0.03219269856341739,651,The good news is I can write you a prescription for mice bait. The bad news is this is likely coming out-of-pocket.
2008,6096,11,37,196,244,1.2418032786885247,0.03354858816126442,651,"Yeah, Id'e say it was more from compression rather than congestion."
5134,6096,8,43,193,244,1.2418032786885247,0.03200490083329431,651,"Don't get too choked up, but I'm sorry to say your insurance only covers boa constrictors, not pythons."
2750,6096,12,35,197,244,1.2418032786885247,0.03404760095859679,651,Snake-assisted gender transition is still in its infancy.
624,6096,10,39,195,244,1.2418032786885247,0.033042039952043245,651,"I view of our Hippocratic Oath, I'm limited to prescribing muscle relaxers for it."
7278,6100,10,46,217,273,1.2417582417582418,0.030712810339850245,651,You are in luck. I once treated a Radio City Music Hall dancer who was allergic to her boa.
8065,6101,9,40,191,240,1.2416666666666667,0.032872512005628726,651,"Now bear in mind this is just a temporary cure for your low blood pressure"""
898,6101,8,42,190,240,1.2416666666666667,0.03233781906798067,651,"Well, I guess we all feel the squeeze around this time of year."
2209,6101,12,34,194,240,1.2416666666666667,0.0344267999677643,651,"Chest pain, shortness of breath, numbness in your arm... no, it's definitely your heart. Self-diagnosing on webMD and youtube's never a good idea, Fred"
3193,6101,11,36,193,240,1.2416666666666667,0.033916619120037676,651,"Now Mr Jones, when did this pain in your chest start to bother you?"
7859,6101,6,46,188,240,1.2416666666666667,0.031240991263081806,651,'How about just getting a gerbil or a puppy?
6117,6106,10,45,214,269,1.241635687732342,0.03100296835365077,651,I understand you've researched your symptoms online.
8677,6107,10,37,189,236,1.2415254237288136,0.03376619587021813,651,If you quit smoking you'd breathe better.
6202,6107,12,33,191,236,1.2415254237288136,0.034817812063909694,651,I understand exposure therapy went awry today.
4956,6107,10,37,189,236,1.2415254237288136,0.03376619587021813,651,You will have to remove the snake Mr Johnson if I am going to examine you properly.
2667,6107,9,39,188,236,1.2415254237288136,0.0332279093061847,651,The bad news is your health insurance doesn't cover a snakectomy. The good news is there is snake charmer next door.
31,6107,13,31,192,236,1.2415254237288136,0.03533188451814643,651,So we're going to recommend you stop smoking...
7568,6107,9,39,188,236,1.2415254237288136,0.0332279093061847,651,It'll be easier on both of us if you start wearing boas instead of anacondas.
25,6107,6,45,185,236,1.2415254237288136,0.031558008124758716,651,Do you have a family history of chest constriction?
3441,6114,12,40,213,265,1.241509433962264,0.03220134719827516,651,"Yes,you ARE losing weight,but that's NOT a tapeworm."
8306,6114,13,38,214,265,1.241509433962264,0.03264221998915951,651,"You misread my handwriting; the prescription said ""shrink wrap."""
5766,6116,9,38,185,232,1.2413793103448276,0.033594316785056005,651,Take this to the hamlet apothecary and he'll give you something to help you shuffle of this mortal coil.
6095,6116,14,28,190,232,1.2413793103448276,0.036265315860142686,651,When did you first notice  this problem?
3668,6116,9,38,185,232,1.2413793103448276,0.033594316785056005,651,"So, you'd say your cough is about the same?"
6972,6116,11,34,187,232,1.2413793103448276,0.03468740586909295,651,Any chest pain or tightness?
2731,6116,9,38,185,232,1.2413793103448276,0.033594316785056005,651,I'm writing you a referral to see a constrictorvascular surgeon.
3569,6116,15,33,213,261,1.2413793103448276,0.03385818090085553,651,At least it's not syphilis.
689,6116,8,33,162,203,1.2413793103448276,0.036009698423571775,651,"No - I said dietary ""restrictions""."
2342,6116,15,26,191,232,1.2413793103448276,0.036776244197472927,651,"On the bright side, if you were a mouse, you’d have been charged for missing your appointment."
3560,6124,14,34,209,257,1.2412451361867705,0.03377287053771219,651,"First we'll do the blood work, then I have some thoughts on accessorizing."
3992,6124,12,38,207,257,1.2412451361867705,0.032860449159855046,651,Your breathing seems restricted so lay off the sports for about 2 weeks .
6655,6124,7,48,202,257,1.2412451361867705,0.030460055081422518,651,Interesting medical hiss-tory.
2791,6127,11,33,184,228,1.2412280701754386,0.03509134187961619,651,We find this test gives a more accurate read of blood pressure in high-stress events.
1651,6127,10,35,183,228,1.2412280701754386,0.03453634914476107,651,Let me suggest a puppy. Snakes are not known to be affectionate.
4456,6129,15,38,229,282,1.2411347517730495,0.03209038403125339,651,That constricting feeling ... definitely caused by a constrictor.
208,6130,5,51,197,253,1.2411067193675889,0.02971424494999633,651,"The good news is that there's no poison in your system."""
1043,6130,10,41,202,253,1.2411067193675889,0.03224568708964536,651,I'm gonna send you to this snake oil guy I know.
3867,6132,11,32,181,224,1.2410714285714286,0.03550849583252004,651,"I know you hate your annual exam, but you can’t slither your way out of this one."
7804,6132,4,46,174,224,1.2410714285714286,0.031314281374352645,651,I advise that next time you skip the prop when reciting Shel Silverstein.
4519,6134,9,42,198,249,1.2409638554216869,0.032077868490427326,651,So’you’ve been experiencing shortness of breath?
4862,6135,5,43,172,220,1.240909090909091,0.03228910826731814,651,The good news is the strep culture came back negative.
3406,6136,12,42,220,274,1.2408759124087592,0.03147450553315303,651,Constipation is not normally treated with naturopathic techniques.
2851,6137,13,33,199,245,1.2408163265306122,0.03441229481407663,651,"Want to watch your blood pressure there, Mr Hackley."
8086,6137,10,39,196,245,1.2408163265306122,0.03292169525270597,651,It says here your last doctor prescribed snake oil?
8362,6137,10,39,196,245,1.2408163265306122,0.03292169525270597,651,"Just to be clear, when a script calls for a ""boa"" to be worn, it's usually a ""feather boa""."
4950,6140,6,40,170,216,1.2407407407407407,0.0332950301510947,651,I’m sorry sir but Medicare doesn’t cover boa constrictors.
9242,6140,12,41,217,270,1.2407407407407407,0.031779533603392904,651,"Claustrophobic cuddling is technically a symptom, not a disease."
6112,6142,6,46,189,241,1.2406639004149378,0.031127246811297183,651,Hear one charmer and call me in the morning.
4768,6142,10,38,193,241,1.2406639004149378,0.03327488663386815,651,At least you aren’t wearing fur.
6151,6142,11,36,194,241,1.2406639004149378,0.03379047539038359,651,"Unfortunately, Mr. Williams, your insurance only covers feathered boa removals...."
2749,6142,10,38,193,241,1.2406639004149378,0.03327488663386815,651,"There's no cure, so just think of it as a fashion statement."
2447,6142,12,34,195,241,1.2406639004149378,0.034298314444290996,651,"I'm concerned about your blood pressure, Mr. Capibara."
1428,6142,11,36,194,241,1.2406639004149378,0.03379047539038359,651,"Im sorry Mr. Collins,  but non -emergency use of an urgent care facility is not covered by your HMO insurance"
494,6142,11,36,194,241,1.2406639004149378,0.03379047539038359,651,"Doc, my chest is feeling a little tight."
2487,6149,9,46,211,266,1.2406015037593985,0.030738187980158618,651,"You may experience some  slight discomfort ."""
1844,6149,11,42,213,266,1.2406015037593985,0.03164777777321294,651,Now when I said you should start doing crunches...
4150,6149,16,32,218,266,1.2406015037593985,0.03381487737934931,651,What elephant?
7729,6152,6,39,167,212,1.240566037735849,0.033676590714131836,651,"A support animal is efficacious for your condition, but there may be some slight side effects."
3976,6153,8,41,188,237,1.240506329113924,0.03255852509447316,651,So this seems to fulfill your emotional needs but its putting some restrictions on your breathing needs.
7234,6153,5,47,185,237,1.240506329113924,0.030867206530080567,651,It's normal separation anxiety.  She should be ready to leave in no more than six months.
4631,6155,12,39,211,262,1.2404580152671756,0.03241499414153325,651,Have you had any tightness in the chest?
8471,6155,7,49,206,262,1.2404580152671756,0.030074815565230277,651,"I suppose Boa Constrictive Bronchiolitis could be considered a pre-existing condition, but...."
851,6157,11,34,188,233,1.240343347639485,0.034553745227375296,651,Or you could just add some fiber to your diet.
1654,6157,12,32,189,233,1.240343347639485,0.0350850392230978,651,"It's nothing a few mice won't fix. Now, how will you be paying? Insurance or Amex?"
6060,6157,15,26,192,233,1.240343347639485,0.0366327173634466,651,Your chest tightness is probably not cardiac.
6982,6160,13,29,187,229,1.240174672489083,0.03603287467580849,651,I think your anxiety is getting worse.
8799,6161,7,47,200,254,1.2401574803149606,0.03064523350798125,651,So you say you are feeling bound up?
3579,6161,12,37,205,254,1.2401574803149606,0.033086905207437574,651,Okay then. Please explain where you're feeling tightness...
7864,6161,6,49,199,254,1.2401574803149606,0.03013316685762126,651,"Aside from macabre, it's the closest we have to a nonsurgical tummy-tuck."
8270,6161,7,47,200,254,1.2401574803149606,0.03064523350798125,651,"Now, don't get hiss-terical..."
2810,6165,12,36,202,250,1.24,0.03343758796858151,651,"The tightness in you chest is entirely psychosomatic, I assure you."
5377,6165,10,40,200,250,1.24,0.03246252086705802,651,"So you say you've been feeling confined?"""
1925,6165,11,32,182,225,1.24,0.035366561195480276,651,"I'm going to prescribe oxycodone"""
2707,6165,9,42,199,250,1.24,0.03196383498562011,651,"I understand your reasoning Mr. Monty, but it can still impair your breathing."
312,6165,7,46,197,250,1.24,0.030942361236264797,651,"Not an appropriate costume for a visit to the doctor, sir."
7521,6170,9,41,196,246,1.2398373983739837,0.032292423602644824,651,You seem to have gained a few pounds since your last visit
6671,6170,11,37,198,246,1.2398373983739837,0.03330418341217113,651,"are you going to live? no mr bond, i expect you to die."
4805,6170,14,31,201,246,1.2398373983739837,0.034766660016168606,651,Just relax and take it easy. No pressure.
4635,6170,12,35,199,246,1.2398373983739837,0.03379870763891683,651,My bill isn't the only thing that will squeeze the life out of you!
3150,6170,12,35,199,246,1.2398373983739837,0.03379870763891683,651,"Honestly, ever since, your blood pressure has improved."
7059,6170,13,33,200,246,1.2398373983739837,0.034286099856507685,651,The good news is you've developed a resistance to Bubonic Plague
1056,6170,12,35,199,246,1.2398373983739837,0.03379870763891683,651,"Her name is Ana, Ana Conda, and we’re seriously in love, Doc."
654,6170,13,33,200,246,1.2398373983739837,0.034286099856507685,651,"Just apply three times a day before a meal, it'll help with your diet."
2178,6170,5,49,192,246,1.2398373983739837,0.03016727698840068,651,With a little minor surgery we can free your arms.
3917,6179,8,37,176,221,1.239819004524887,0.0340256614149078,651,So it says here you've been feeling a little tightness in the neck...
4450,6179,9,35,177,221,1.239819004524887,0.03462486057697457,651,"as a  veterinarian, I would suggest you pray"
1949,6181,14,36,217,267,1.2397003745318351,0.03285380116932782,651,"Do you ever smoke, or hiss, or vape?"
5932,6181,7,50,210,267,1.2397003745318351,0.029702697398456192,651,I see you've gained weight.
1147,6183,11,36,195,242,1.2396694214876034,0.033665247407223854,651,I'd like to prescribe a taper to a garter snake for two weeks.
3888,6183,12,34,196,242,1.2396694214876034,0.03417076615755387,651,"Oh dear, my last patient forgot her coat. Sit tight i'll be right back."
5526,6183,11,36,195,242,1.2396694214876034,0.033665247407223854,651,Sometimes anxiety can make your throat feel constricted.
6113,6183,12,34,196,242,1.2396694214876034,0.03417076615755387,651,"Next time, don't touch the snake!"
1409,6187,9,45,209,263,1.2395437262357414,0.030927370847528203,651,"Worms? We can't rule it out yet, but my gut says no...?"
8209,6187,9,45,209,263,1.2395437262357414,0.030927370847528203,651,So the lack of feathers wasn’t apparent until it was “too late”?
5957,6189,12,33,193,238,1.2394957983193278,0.03455429880021522,651,So you think that might be a python rather than a boa constrictor?
3890,6189,6,45,187,238,1.2394957983193278,0.03132500982276593,651,It's the latest all-natural treatment for bulging neck discs.
7480,6189,7,43,188,238,1.2394957983193278,0.031885944572168645,651,I have cautioned you before about pets becoming too clingy.
3037,6189,6,45,187,238,1.2394957983193278,0.03132500982276593,651,"You were wrong, it wasn't crabs..."
864,6189,11,35,192,238,1.2394957983193278,0.0340373668886347,651,It's just trying to keep warm until the vortex moves on
2773,6189,10,37,191,238,1.2394957983193278,0.033512462217039456,651,"Listen to your wife, Adam: eat more apples"
527,6189,11,35,192,238,1.2394957983193278,0.0340373668886347,651,"That might be true, but uou picked the wrong apple."
1318,6196,10,36,188,234,1.2393162393162394,0.033884052637122186,651,Our tests show no cause for chest constrictions.
1573,6196,11,34,189,234,1.2393162393162394,0.03442109038411165,651,"I must say, always looking on the bright side of life works for you, Monty."
8548,6198,10,41,204,255,1.2392156862745098,0.03202010406026956,651,Your blood pressure seems to up a bit
7643,6199,10,35,185,230,1.2391304347826086,0.03426735315227845,651,Some therapies are unusual but we've had very good results with Emma here.
4801,6199,8,39,183,230,1.2391304347826086,0.033140714108059154,651,"Based on your self-diagnosis you did online, I'm writing you a prescription for an asthma inhaler."
3305,6201,6,48,197,251,1.2390438247011952,0.03031241590593918,651,"From what I can see here, there is no good news, only bad."
5798,6201,9,42,200,251,1.2390438247011952,0.03185059007200828,651,OK Mr Snake... I think we'll just try one more enema!!!
7042,6201,12,36,203,251,1.2390438247011952,0.033317827327357205,651,"Two aspirins, a warm meal and a good night's sleep and he should be much better by tomorrow."
7836,6201,6,48,197,251,1.2390438247011952,0.03031241590593918,651,"Monty Python, everything appears normal."
8401,6201,6,48,197,251,1.2390438247011952,0.03031241590593918,651,No health problems outside of a mild case of poor circulation
9083,6201,7,46,198,251,1.2390438247011952,0.030833667767795545,651,"Good news! You don’t have Caduceus syndrome, but you do have a case of Asclepius."
1769,6207,12,30,184,226,1.238938053097345,0.03577965592933642,651,"Well, I can tell you that your discomfort is not due to an intestinal obstruction."
5384,6207,11,32,183,226,1.238938053097345,0.0352257350761727,651,If it bites you it is covered by insurance without a co-pay.
8239,6209,9,41,197,247,1.2388663967611335,0.03217607397634059,651,Do you know if this runs in your family?
8763,6209,10,39,198,247,1.2388663967611335,0.03268355925295035,651,Your insurance requires I assess your mental health.  Tightly wound?
5466,6209,7,45,195,247,1.2388663967611335,0.0311362990528835,651,I see you have been out charming the local Wildlife again.
3881,6209,8,43,196,247,1.2388663967611335,0.03166045526553224,651,Let's try cutting out the apples.
3351,6209,6,47,194,247,1.2388663967611335,0.030603166662952052,651,"Yes, we've been seeing an uptick in cases like this since the deregulation of snake oil."
4763,6214,11,31,180,222,1.2387387387387387,0.0356479551724726,651,Haute couture isn't a condition we generally see around here
6293,6214,6,41,175,222,1.2387387387387387,0.03266424612237543,651,I'm prescribing a pit bull for you - you'll still have protection but with less pressure.
7472,6214,10,33,179,222,1.2387387387387387,0.03507152636158735,651,This is the worst case of lung constriction I've ever seen.
7290,6217,12,34,197,243,1.2386831275720165,0.03404414515525626,651,"Mr. Houdini, this matter is entirely in your hands."
6992,6217,8,42,193,243,1.2386831275720165,0.03198379713653797,651,"Well, i'm going to need to refer you to a specialist."
6035,6217,10,38,195,243,1.2386831275720165,0.03303004010460305,651,"Your heart beat is very, very slow."
326,6217,13,32,198,243,1.2386831275720165,0.03454003408180707,651,So you really think eliminating gluten is gonna help this sudden weight gain and scaly skin... but the shortness of breath?
5725,6217,8,42,193,243,1.2386831275720165,0.03198379713653797,651,Feeling a little constricted?
1381,6217,7,44,192,243,1.2386831275720165,0.0314476254151403,651,You seem to be coping but the snake is a little dehydrated. I'm going to call for a consult with the animal clinic two blocks down.
1510,6217,12,34,197,243,1.2386831275720165,0.03404414515525626,651,Get this filled and come back to see me in a week
2437,6217,10,38,195,243,1.2386831275720165,0.03303004010460305,651,"Well Adam, apparently last week's ""An apple a day"" script didn't work out for you, so let's try something else."
6945,6225,16,31,217,264,1.2386363636363635,0.03393693383797078,651,"When it comes to health, what goes around comes around."
3918,6225,11,41,212,264,1.2386363636363635,0.03174412810107969,651,"OK, now take five deep breaths and then tell me if you feel any discomfort."
3657,6227,11,35,193,239,1.2384937238493723,0.033909461554798466,651,"It's not the snake I'm worried about, it's what's inside."
2625,6227,8,41,190,239,1.2384937238493723,0.032316714866817156,651,"So, you went backpacking for spring break. Good thing you didn't bring back any fruits or vegetables."
4350,6227,10,37,192,239,1.2384937238493723,0.03338698961000563,651,Compression socks may help...
1562,6227,7,43,189,239,1.2384937238493723,0.03176805867637224,651,This is a very constrictive diet.
4185,6231,11,40,209,260,1.2384615384615385,0.032060091849337405,651,Take two of these and call PETA in the morning.
6056,6232,10,31,173,214,1.2383177570093458,0.035930315160768875,651,So your insurance cards are under the snake...
4214,6233,11,34,190,235,1.2382978723404254,0.0342894303352196,651,"I take it you've never heard the phrase ""Don't tread on me."""
8618,6233,9,38,188,235,1.2382978723404254,0.03321181317605928,651,"We'll need more tests, but it looks like a constriction in your esophagus."
7927,6233,13,30,192,235,1.2382978723404254,0.03533419775495534,651,"So, you say you feel like life is being squeezed out of you. 
There's been a lot of that going around lately, but I'm not sure why. Have you been eating enough fiber?"
2307,6233,9,38,188,235,1.2382978723404254,0.03321181317605928,651,"I know, Doc, but she never complains and loves to cuddle."
103,6233,11,34,190,235,1.2382978723404254,0.0342894303352196,651,I believe in hugs
244,6238,10,41,205,256,1.23828125,0.03190846564775361,651,This is the worst tapeworm I've ever seen.
5007,6238,7,47,202,256,1.23828125,0.030434165263532202,651,This should help with your anxiety about all that other stuff.
936,6240,9,37,185,231,1.2380952380952381,0.033578459296923754,651,Do you hear a hissing noise?
3906,6240,10,35,186,231,1.2380952380952381,0.03413438800769029,651,I'm giving you a prescription for charm school.
4105,6240,11,38,203,252,1.2380952380952381,0.03271922586200282,651,"In spite of  your name Mr Monty, I don’t think this is funny."
9139,6243,13,38,218,269,1.237918215613383,0.03220546290602391,651,Reminds me of how I met my first wife.
871,6244,11,37,200,248,1.2379032258064515,0.033063241963491724,651,I think that wraps it up for this session. Any questions?
6205,6244,11,37,200,248,1.2379032258064515,0.033063241963491724,651,I am afraid your insurance declined  the coverage for the second snake.
7242,6244,8,43,197,248,1.2379032258064515,0.03154724045815533,651,"You have to give her credit. ""No"" means ""no."""
7420,6244,7,45,196,248,1.2379032258064515,0.031025449515745884,651,"Reptilitis, third case I’ve seen this week!"
2250,6248,9,36,182,227,1.2378854625550662,0.03395670873834698,651,"Unfortunately,your condition isn't covered by medical insurance."
4051,6248,12,30,185,227,1.2378854625550662,0.03563723576595978,651,Weren’t you in here last week with a ladder?
2651,6250,7,44,193,244,1.2377049180327868,0.03133374961347725,651,I have to apologize - I forgot my glasses at home. What seems to be the problem today?
2368,6250,9,40,195,244,1.2377049180327868,0.03239238477919624,651,I see you have been taking the snake oil instead of my prescription.
2219,6250,12,34,198,244,1.2377049180327868,0.033918441620284276,651,'How about your medical hiss-tory?'
3203,6250,9,40,195,244,1.2377049180327868,0.03239238477919624,651,"It is a more organic blood pressure monitoring procedure . Unfortunately , we do not yet have it quite perfected ."
4562,6250,6,46,192,244,1.2377049180327868,0.030790785982471702,651,When did you notice that your skin was dry and scaly?
1640,6250,11,36,197,244,1.2377049180327868,0.03341750018369003,651,"You have tightness in your upper torso 
so I'm referring you to a Cardiologist."
8351,6250,7,44,193,244,1.2377049180327868,0.03133374961347725,651,"""On a scale of zero to ten, death occurs quite often."""
2047,6257,14,25,184,223,1.2376681614349776,0.03717153714653765,651,It appears like you have a very bad case of ringworm.
6732,6257,11,31,181,223,1.2376681614349776,0.03550388349493555,651,The patient gown? It's a partnership with the vet's office next door.
15,6257,8,37,178,223,1.2376681614349776,0.03375393773484045,651,You appear to be feeling some pressure.
8837,6260,8,56,239,303,1.2376237623762376,0.02783370618860429,651,"...and so, how are the toes today?"
283,6261,14,34,213,261,1.2375478927203065,0.033305034550756285,651,I'm putting you on a constrictive diet.
2113,6261,15,32,214,261,1.2375478927203065,0.03374459615542341,651,"The diagnosis may be a lot to wrap your head around, but you're about half way there."
5515,6263,13,31,196,240,1.2375,0.03479931005744507,651,The devil's in the entrails
7812,6263,12,33,195,240,1.2375,0.034294671262274076,651,I wouldn't worry about those constructions. Come back and see me if you hear a rattle in there.
7534,6263,12,33,195,240,1.2375,0.034294671262274076,651,"Yes... you’re cholesterol is quite normal, actually. Are you sure there’s nothing else you’d like to discuss today?"
7194,6263,12,33,195,240,1.2375,0.034294671262274076,651,I found a constriction and I'm going to recommend statins.
336,6263,10,37,193,240,1.2375,0.0332624333146862,651,You should’ve just eaten that apple Adam
4880,6263,10,37,193,240,1.2375,0.0332624333146862,651,I have a cat ... gonna recommend you get one too.
3625,6263,11,35,194,240,1.2375,0.03378249507512281,651,...These genie jokes all end the same.. ”Careful what you wish for ”
3091,6263,9,39,192,240,1.2375,0.03273411013800736,651,"Ok Mr. Klemptster, you mentioned she was charming, and you just woke up like this?"
1196,6263,10,37,193,240,1.2375,0.0332624333146862,651,And where did you say you went on this vacation?
2768,6272,9,34,176,219,1.2374429223744292,0.03475045784205272,651,"Well, Mr Smith, this really isn't a medical problem... May I suggest a warm bath and a drink of hot milk - that always helps me unwind."
2870,6272,6,40,173,219,1.2374429223744292,0.03289253432601952,651,And what about the choking feeling you get?
6363,6272,11,30,178,219,1.2374429223744292,0.035935748090096725,651,Are you the only person alive that doesn't know that wearing snakeskin is illegal?
7258,6272,10,32,177,219,1.2374429223744292,0.035348071453950455,651,You’re an icon in my profession.
2009,6276,11,44,223,278,1.2374100719424461,0.030647831963781434,651,"So, any family history of reptilian constrictivitis?"
6979,6277,14,33,210,257,1.2373540856031129,0.0336553383112961,651,You’re feeling constricted? Breathing is laboured? That’s your reptilian brain screwing with you.
7246,6278,9,38,189,236,1.2372881355932204,0.03308619707965858,651,Constipated?
8412,6278,8,40,188,236,1.2372881355932204,0.03253666255945911,651,How long have you been bound up?
2852,6278,9,38,189,236,1.2372881355932204,0.03308619707965858,651,So he thinks you are a mouse?
2555,6278,10,36,190,236,1.2372881355932204,0.03362675220534846,651,Any problems with co-workers at the office?
3577,6278,12,32,192,236,1.2372881355932204,0.03468259674897062,651,"Well, we have to run some tests, but taking your blood pressure will not be one of them."
1021,6278,14,28,194,236,1.2372881355932204,0.035707234149728075,651,Where is the apple?
5791,6284,14,37,223,274,1.2372262773722629,0.03220468828735857,651,Now rank your pain on a scale of 1 to 10
3297,6285,14,32,207,253,1.2371541501976284,0.03401586907913101,651,I’m thinking the pressure you’re feeling is not a heart attack
2020,6285,14,32,207,253,1.2371541501976284,0.03401586907913101,651,"I'm writing you a prescription for a laxative, but I don't think you'll need it."
707,6287,8,39,185,232,1.2370689655172413,0.03288658118872006,651,Yeah so I'll let you know when your tests come back.
1230,6287,12,31,189,232,1.2370689655172413,0.035082805384222815,651,You have a serious case of serpentitis.
7229,6287,5,45,182,232,1.2370689655172413,0.03113792243829931,651,I can't remember...was the trip to Burma last week or this week?
8120,6287,10,35,187,232,1.2370689655172413,0.03400242973604629,651,Try not to get so wrapped up in your problems.
4922,6291,9,41,199,249,1.2369477911646587,0.0319458142579311,651,"He may provide emotional support, but lumbar-wise, he's worse than useless."
8199,6291,12,35,202,249,1.2369477911646587,0.03343198907529035,651,I suggest that you get an Irish setter as your next pet.
575,6293,9,36,183,228,1.236842105263158,0.03382354384626747,651,"I get it, but you'll still have to roll over on your side"
4732,6293,9,36,183,228,1.236842105263158,0.03382354384626747,651,How long have you been experiencing this shortness of breath?
2911,6295,8,42,195,245,1.236734693877551,0.03175195237583327,651,You're definitely stressed. I'm going to prescribe something so you won't be wrapped so tightly...
9154,6295,9,40,196,245,1.236734693877551,0.03227448659591884,651,It's a rare patient who's not afraid of scales.
1591,6295,12,34,199,245,1.236734693877551,0.0337936458685509,651,I can’t turn my head but I’ll cough for you
644,6298,9,44,209,262,1.2366412213740459,0.030908618483202366,651,The arterial constriction is worse than I thought.
115,6298,13,36,213,262,1.2366412213740459,0.03274648908922258,651,"Unfortunately, your insurance carrier refuses to provide coverage, since they have no medical code which relates to this situation."
1266,6300,9,35,180,224,1.2366071428571428,0.03420993913630526,651,I am afraid your options are constricted.
5860,6300,12,29,183,224,1.2366071428571428,0.035922628612171194,651,"A perfect match if I may say so: she got a crush on you and she's your main squeeze!"""
1719,6300,9,35,180,224,1.2366071428571428,0.03420993913630526,651,I'm going to refer you to the best  aspman in the city.
2950,6303,11,35,195,241,1.2365145228215768,0.03365645742709218,651,How long have you had this feeling of tightness in you upper body?
154,6303,11,35,195,241,1.2365145228215768,0.03365645742709218,651,Its a new tactic being used by divorce lawyers.  I suggest you settle quickly!
5419,6303,9,39,193,241,1.2365145228215768,0.032612893666753726,651,"All the celebrities are doing it, it’s the new liposuction"
8392,6303,14,29,198,241,1.2365145228215768,0.03516378202605194,651,So she’s still mad at you for betting on the Rams.
4425,6307,12,37,209,258,1.2364341085271318,0.032625470264575365,651,Have you considered giving up these boa tie events?
3672,6307,8,45,205,258,1.2364341085271318,0.030720816699894016,651,On the upside your figure is going to be incredible.
1679,6307,12,37,209,258,1.2364341085271318,0.032625470264575365,651,Your snake needs to cough up his co-pay.
8995,6310,6,40,174,220,1.2363636363636363,0.03276046469597335,651,You need to shed a few pounds.
6094,6310,9,34,177,220,1.2363636363636363,0.03460897352337174,651,"Yes sir, I will write you a work excuse. I don’t think your coworkers would want you coming to work in your current condition."
1334,6312,11,34,192,237,1.2362869198312236,0.03402905137011023,651,I'll prescribe some snake oil that might help reduce your blood pressure
5527,6312,10,36,191,237,1.2362869198312236,0.03349953180813135,651,"We've narrowed the squeezing pain down to angina, indigestion..."
3762,6312,9,38,190,237,1.2362869198312236,0.03296150672494216,651,"Take these muscle relaxers for a week and refrain from reading The New Yorker or watching MSNBC and CNN, that should loosen the grip and  have you feeling better."
6698,6312,13,30,194,237,1.2362869198312236,0.03506410912487004,651,"Sir, I need to check your other snake..."
6916,6312,10,36,191,237,1.2362869198312236,0.03349953180813135,651,"Sorry, Mr Brown, your insurance doesn't cover boa restrictors"
3160,6312,15,26,196,237,1.2362869198312236,0.036069476850822055,651,"So I’d like to  take some x-rays, draw some blood. Don’t worry, we’re going to figure out what’s bothering you soon enough.  Hey Doc, maybe you should just stop writing and look at me."
1041,6318,10,40,204,254,1.236220472440945,0.03200546632665592,651,What is your pet’s name?
7515,6319,12,40,219,271,1.2361623616236161,0.031561262366483885,651,You may have an esophageal constriction.   I'm sending you to a GI specialist.
462,6319,7,50,214,271,1.2361623616236161,0.029316296642294907,651,I notice some problems when you try to Aspirate!
6530,6319,14,36,221,271,1.2361623616236161,0.03241574456193829,651,Do you have a history of chest pains?
4300,6322,8,35,173,216,1.2361111111111112,0.034400968644762914,651,Have  you noticed any different symptoms since your last visit
1533,6323,11,33,189,233,1.2360515021459229,0.03441329630633875,651,A few tests and we’ll know the cause of your crushing chest pain.
1650,6323,10,35,188,233,1.2360515021459229,0.03387146726405453,651,"Well, she obviously likes warm-bodied creatures."
766,6323,10,35,188,233,1.2360515021459229,0.03387146726405453,651,Do you have any of the following risk factors?
2912,6326,10,39,201,250,1.236,0.03233260877753984,651,"So, ""Snake got your tongue?"""
584,6326,8,43,199,250,1.236,0.031323163349971476,651,There are safer ways to trim down.
880,6326,11,37,202,250,1.236,0.03282569274848089,651,The constipation should subside if you constrict less.
5273,6326,12,35,203,250,1.236,0.033311478779452224,651,Looks like you've gone as far as you can on the Amazon diet. Let's switch to the Mediterranean. The
7151,6326,11,37,202,250,1.236,0.03282569274848089,651,Nutrisystem would have been safer.
4291,6331,11,41,215,267,1.2359550561797752,0.03142464859077555,651,So you say you took the snake oil three times a day?
8879,6331,11,41,215,267,1.2359550561797752,0.03142464859077555,651,I made an appointment for you for next monday to see if you are still having chest pain!
2863,6333,10,34,185,229,1.2358078602620088,0.03425515442339762,651,Your cholesterol is a bit high.  I'm going to put you on a statin.
3774,6333,10,34,185,229,1.2358078602620088,0.03425515442339762,651,So you did try laxatives first and it didn't work ...
7700,6333,8,38,183,229,1.2358078602620088,0.03311804438285802,651,"So, how would you describe your chest pain?"
2223,6336,6,46,194,246,1.2357723577235773,0.03057037654143944,651,"In his eyes, unoriginal sin is still a sin"
195,6336,12,34,200,246,1.2357723577235773,0.03366974834687714,651,How long ago were you glamping in the Everglades?
1741,6336,13,32,201,246,1.2357723577235773,0.03415898065006444,651,Bad news: it's Montgomery Python disease. Good news: you'll laugh yourself to death.
2063,6339,9,44,210,263,1.2357414448669202,0.030804014849222922,651,"Rest assured, we've left no stone left unturned in determining your diagnosis.  Your labs, CT scan, MRI, treadmill, lung function tests were all normal, so I'm referring you to psychiatry to help you with your sensation of being strangulated."
476,6340,6,41,178,225,1.2355555555555555,0.03227964232518656,651,"You are to uptight, try to relax and unwind."
6451,6341,14,29,199,242,1.2355371900826446,0.03503181135900903,651,"I'm sorry, but not I can't you clearance to take your emotional support python on the plane."
7761,6341,8,41,193,242,1.2355371900826446,0.031960499781220196,651,"Okay, let's get you on the scale and check your weight."
5569,6343,10,41,208,259,1.2355212355212355,0.03157807233758277,651,It looks as if you're in a relationship that could threaten your very being.
7154,6344,17,34,238,289,1.2352941176470589,0.032144306491676475,651,"I’m feeling pretty rattled, Doctor."
9219,6344,18,28,226,272,1.2352941176470589,0.033946111898191036,651,"Get over it, she doesn’t want the apple anymore!"
8386,6344,10,36,192,238,1.2352941176470589,0.03337325094853604,651,I don’t know where the apple is.
7707,6344,11,30,180,221,1.2352941176470589,0.03564205299412785,651,"I am scheduling you for tests on Tuesday, don't worry."
5505,6344,13,34,208,255,1.2352941176470589,0.033313801504999,651,I'm fairly certain you have Python Attachment Disorder...but it is curable.
5071,6344,7,46,202,255,1.2352941176470589,0.030406223243560883,651,You are getting a little thick in the middle.
2888,6344,7,42,189,238,1.2352941176470589,0.03173960012799272,651,So how long have your arms felt numb?
3424,6344,12,32,194,238,1.2352941176470589,0.03441930157048541,651,His post-op recovery is going so well that I think it’s time we reintroduce solids into his diet.
520,6344,7,42,189,238,1.2352941176470589,0.03173960012799272,651,You should have taken a baby Aspirin at the onset of the chest pain.
2648,6344,10,40,205,255,1.2352941176470589,0.03189316370832263,651,Besides the pain around your neck; what other symptoms do you have?
3329,6354,12,31,191,234,1.235042735042735,0.03481167915548355,651,Hmmm.  I guess it's no use listening to your lungs.
5259,6354,11,33,190,234,1.235042735042735,0.03428076086536603,651,So your chief complaint is constriction?
3212,6356,6,39,172,217,1.2350230414746544,0.032990371113539994,651,Looks to me like you are entangled in a relationship.  Let me refer you to a psychologist.
6031,6356,8,35,174,217,1.2350230414746544,0.0342593546527851,651,"Mowgli, you're grown up now - time to unwind."
600,6356,9,33,175,217,1.2350230414746544,0.034876536220407775,651,I’m going to have to refer you to someone that sells snake oil.
7798,6359,9,44,211,264,1.2348484848484849,0.030700100456522706,651,Fifteen minutes of this boa therapy works wonders on your belly fat.
2252,6360,10,38,199,247,1.2348178137651822,0.03255077759506986,651,"Your skin is cold and scaly, your pulse is 40, your body temperature is 72... Hey, are you by any chance wearing a boa constrictor?"
2351,6360,7,44,196,247,1.2348178137651822,0.03099689009099428,651,Would you say the two of you have bonded?
2404,6360,13,32,202,247,1.2348178137651822,0.03403379274741833,651,"Mr. Harrison, I don't care what you read in the checkout aisle, a Constriction Diet is not really a thing..."
7858,6360,12,34,201,247,1.2348178137651822,0.03354673963090974,651,"Bob,  how can I discuss dietary constrictions with Wiggles if you won’t wait outside ?"
4097,6360,8,42,197,247,1.2348178137651822,0.03152336441789413,651,I think you both need some separation time.
5836,6360,7,44,196,247,1.2348178137651822,0.03099689009099428,651,When did you first notice you were congested?
909,6360,10,38,199,247,1.2348178137651822,0.03255077759506986,651,I am thinking that tightness and constriction you describe is nothing more than normal work stress.
4932,6360,12,34,201,247,1.2348178137651822,0.03354673963090974,651,"I would love to help, but it looks like your HMO doesn’t cover ophiology."
529,6368,9,36,185,230,1.2347826086956522,0.03356025701863614,651,How long have you had that cough?
6473,6368,9,36,185,230,1.2347826086956522,0.03356025701863614,651,Second opinion? Go to your vet!
1300,6368,4,46,180,230,1.2347826086956522,0.030601134782549735,651,"The good news is, it' snot contagious."""
2530,6371,11,43,223,277,1.2346570397111913,0.030634326210628067,651,You have a tendency to get wrapped up in the wrong stuff!
3846,6372,6,49,205,260,1.2346153846153847,0.029521594221360727,651,"Relax, it’s not a heart attack, but you do look a little thick around the middle."
5379,6372,7,47,206,260,1.2346153846153847,0.03002040231360514,651,"I'm going to refer you to a veterinary specialist. However, you are still responsible for our reptile co-payment."
3141,6372,11,39,210,260,1.2346153846153847,0.03193782512743827,651,Honestly? I like the ensemble better with the cape.
1444,6375,13,31,199,243,1.2345679012345678,0.03441012282100088,651,It must be something going around—my wife has also been feeling suffocated.
1665,6375,7,43,193,243,1.2345679012345678,0.03130488368345983,651,Give two mice twice a day and I’ll see you back in a week.
4296,6375,5,47,191,243,1.2345679012345678,0.030198931643263094,651,"Next Fall, don't be so cheap. Just buy a coat. And, not to worry,  he'll go away in the Spring"
5132,6378,9,35,182,226,1.2345132743362832,0.033938690879975746,651,And how long ago did you start feeling the snake?
878,6378,12,29,185,226,1.2345132743362832,0.03563465783393372,651,"There's nothing we can do for you here, but I'm writing you a referral to a snake-oil salesman I know."
2641,6378,9,35,182,226,1.2345132743362832,0.033938690879975746,651,How would you rate your shortness of breath on a scale of  1 to 10?
3952,6381,5,39,165,209,1.2344497607655502,0.033059529668425375,651,"Yeah, you could probably shed a few pounds."
8243,6382,12,36,208,256,1.234375,0.03273142996193324,651,"This is just temporary, the (spine) surgery is scheduled in two weeks."
1365,6382,10,40,206,256,1.234375,0.03178162987559039,651,It wasn't easy; all your tests were off the scale.
3188,6382,13,34,209,256,1.234375,0.03319614077351315,651,You do realize the serious potential  consequences of not signing the privacy consent form ?
6204,6385,9,38,192,239,1.2343096234309623,0.03271486384676753,651,I see my assistant squeezed you into my schedule.
2398,6385,9,38,192,239,1.2343096234309623,0.03271486384676753,651,I'm going to prescribe something to take your mind off the constriction.
4828,6385,10,36,193,239,1.2343096234309623,0.03324789954614078,651,"Yes that's true, I did tell you to  apply snake oil to the affected area."
6183,6388,9,34,179,222,1.2342342342342343,0.034329362840984264,651,"Sorry to say, you're not covered. I thought​ you meant​ you had a Corba Plan from your job at the vivarium."
7823,6389,13,37,219,269,1.2342007434944238,0.032091580144513215,651,Shortness of breath? Maybe you’re allergic to snakeskin.
5158,6390,13,33,206,252,1.2341269841269842,0.0335476198742007,651,And you say you use it as your vindshield viper
8258,6390,10,39,203,252,1.2341269841269842,0.0321027123251004,651,"I was forced to diversify; herpetology alone, wasn't going to pay off my student loan."
651,6390,12,35,205,252,1.2341269841269842,0.03307299874054304,651,...and 20 milligrams Robaxin for the snake.
7446,6390,10,39,203,252,1.2341269841269842,0.0321027123251004,651,"OK, so you say everything was OK  until after you took your clothes off, then what happened?"
8567,6390,8,43,201,252,1.2341269841269842,0.031102170849706696,651,"Your tests all look good. I'm writing you a prescription for some nutria, which should encourage your serpent to disengage."
8220,6395,10,35,190,235,1.2340425531914894,0.033612486199125734,651,That's not the rattling I'm talking about.
7651,6395,10,35,190,235,1.2340425531914894,0.033612486199125734,651,"Well, your blood pressure looks normal. Do you feel any mild compression on your chest?"
8887,6395,16,23,196,235,1.2340425531914894,0.03671540171785755,651,You seem tense. Is anything causing you stress?
7331,6395,9,37,189,235,1.2340425531914894,0.03306703765610417,651,I'd say its probably just stress.
6247,6395,8,39,188,235,1.2340425531914894,0.032512439622612216,651,Chest constrictions huh? Have you considered changing your diet?
5931,6395,9,37,189,235,1.2340425531914894,0.03306703765610417,651,Samuel L. Jackson called. He wants his co-star back.
519,6395,7,41,187,235,1.2340425531914894,0.03194821561649098,651,We can do the extraction in the Garden.
60,6395,13,29,193,235,1.2340425531914894,0.03519815301823432,651,It's a tribal cure I learned in the Amazon.
2423,6395,8,39,188,235,1.2340425531914894,0.032512439622612216,651,I see here your wife is allergic to snakes
1467,6404,11,40,214,265,1.2339622641509433,0.03151735879499196,651,"The hospital administrators are always looking for new approaches to medicine. This is how we take blood pressure now, and actually your seems pretty high."
1803,6404,7,48,210,265,1.2339622641509433,0.02964781353936531,651,"You know, in Florida, sustaining a boa constrictor related injury is considered a rite of passage."
6172,6404,12,38,215,265,1.2339622641509433,0.0319676660056545,651,I thought my last patient was uptight.
7301,6407,12,34,202,248,1.2338709677419355,0.033424610423074555,651,Your EKG was fine.  I have no idea why you still feel tightness in your chest.
4747,6407,11,36,201,248,1.2338709677419355,0.03293257838468966,651,...and what do you think is causing this 'tightening' sensation?
2026,6407,7,44,197,248,1.2338709677419355,0.030886166281709756,651,"So, you say your outfit is a bit constricting when you put it on.  Any bloating?"
118,6407,10,38,200,248,1.2338709677419355,0.03243308274267422,651,There’s still some constriction in your arteries.
463,6407,11,36,201,248,1.2338709677419355,0.03293257838468966,651,.....but the good news is I promise you won't feel a thing when I take your blood pressure....
6962,6412,6,35,160,201,1.2338308457711442,0.03455831838171594,651,"It says here that you suffer from Ophidiophobia, can you tell me more about that?"
8762,6413,8,38,185,231,1.2337662337662338,0.03286227194381011,651,Your breathing appears constricted but we'll have to perform some tests.
5839,6413,8,38,185,231,1.2337662337662338,0.03286227194381011,651,When did you first noice your weight gain?
9114,6413,15,24,192,231,1.2337662337662338,0.036652878858824,651,"So, you're saying this happened when you rolled doubles while on a ladder?"
2143,6413,13,28,190,231,1.2337662337662338,0.035611044590560054,651,"You call it separation anxiety, Mr. Wallace; the medical community calls it a highly-effective feeding instinct mechanism."
1876,6417,11,39,211,261,1.2337164750957854,0.0318279190518234,651,The bad news is your insurance just expired.  But the good news is that snake season opens today.
8556,6417,10,41,210,261,1.2337164750957854,0.031361504873074514,651,Were you in the sideshow or at the sideshow?
903,6417,11,39,211,261,1.2337164750957854,0.0318279190518234,651,This is the most natural form of touch therapy on the market today.
4928,6417,8,45,208,261,1.2337164750957854,0.03040722120439129,651,I'm referring you to a snake charmer.
6103,6417,9,43,209,261,1.2337164750957854,0.030888048572843347,651,Can you be more specific about this Chest Constriction you are experiencing....?
3096,6422,10,37,197,244,1.2336065573770492,0.03277317901463474,651,I looked at the results of all the tests we administered and found absolutely nothing unusual.
598,6422,10,37,197,244,1.2336065573770492,0.03277317901463474,651,"Luckily, I’m a renowned snake oil salesman"
5697,6424,11,42,221,274,1.2335766423357664,0.0308197266458817,651,"According to your intake form, you work for the zoo. Can you tell me more?"
4286,6425,8,37,182,227,1.2334801762114538,0.03322301719883874,651,How long have you been feeling lightheaded?
3904,6425,7,39,181,227,1.2334801762114538,0.03263102874405143,651,It states here that you have some heaviness in your chest.
490,6425,9,35,183,227,1.2334801762114538,0.03380464031303334,651,"For your high blood pressure, I'm going to prescribe Prazosin for you and mice for him."
5336,6425,8,37,182,227,1.2334801762114538,0.03322301719883874,651,"Yes, you are making a hissing sound."
2735,6429,10,40,207,257,1.2334630350194553,0.03167085719085546,651,Not to worry.    It's possessive because it cares about you.
3339,6429,7,46,204,257,1.2334630350194553,0.030196799452079127,651,"If you could just remove your scarf for me here, I can begin the exam"
8463,6429,12,36,209,257,1.2334630350194553,0.03261657340330542,651,"My tests show your blood vessels are constricted, but I don't know the cause."
4027,6432,12,43,232,287,1.2334494773519165,0.03030004455764364,651,The tests don’t show Aspbergers
5306,6432,12,43,232,287,1.2334494773519165,0.03030004455764364,651,I want you to cut down on pizza and rats.
10,6434,8,47,215,270,1.2333333333333334,0.02975414426466478,651,"Let me guess, you got it from a snake coil salesman?"
2362,6434,9,38,193,240,1.2333333333333334,0.03259289195867192,651,Leeches are so old school
5243,6434,8,40,192,240,1.2333333333333334,0.03205353494925186,651,We've found this works wonderfully for constipation
5779,6434,9,45,216,270,1.2333333333333334,0.030213340289238,651,"I  have some bad news Mister Witten, It's ...poisonous."
7091,6434,11,34,195,240,1.2333333333333334,0.03364567748170872,651,"I know it's awkward, but you should keep that bandage on for another week."
7929,6434,9,38,193,240,1.2333333333333334,0.03259289195867192,651,Any changes to your diet?
5942,6440,14,31,208,253,1.233201581027668,0.033893538996179556,651,As your vet I am going to recommend some jaw unhinging exercises.
6598,6440,13,33,207,253,1.233201581027668,0.0334275692968926,651,Whoa! I've never seen one shed all its feathers before.
2261,6440,11,37,205,253,1.233201581027668,0.032475578454041136,651,"At this point your best bet is surgical removal, starting with the legs."
7824,6440,13,33,207,253,1.233201581027668,0.0334275692968926,651,Bugspray and shots aren't foolproof for such vacations.
102,6440,7,45,201,253,1.233201581027668,0.030482532860256695,651,Try these meds for a week.  Then call me if you’re still short of breath.
1526,6440,7,45,201,253,1.233201581027668,0.030482532860256695,651,You're lucky my sub-specialty is herpetology.
8320,6446,6,40,177,223,1.2331838565022422,0.03237037940604082,651,"Don't worry, Your EKG and enzymes are all normal; its just musculosceletal pain"
8824,6447,10,42,214,266,1.2330827067669172,0.030956032636563546,651,It's just a little diaphragm constriction.......
2604,6448,7,41,188,236,1.2330508474576272,0.03182800746132811,651,Your blood pressure is a bit high.
7740,6448,11,33,192,236,1.2330508474576272,0.034018673779293,651,No it's not a turtle neck. It's a boa neck.
2988,6450,9,40,200,249,1.2329317269076305,0.03181116752922536,651,"OK, OK, I tread on him, now what’s our next move?"
7016,6450,7,44,198,249,1.2329317269076305,0.03077621077423885,651,"So, you're asking me as a veterinarian if it's ethical to wear a boa constrictor?""  I'd say wrangle at your own risk."
7544,6452,7,37,175,219,1.2328767123287672,0.033357398105402336,651,I think snake oil is just what you need.
1993,6452,5,41,173,219,1.2328767123287672,0.032076975197167394,651,"I am writing you a prescription for a mate to entice this one away, however, it's  probably tier one and not covered by Medicare!"
2112,6452,12,27,180,219,1.2328767123287672,0.03636172692225739,651,Nope. No. I'm not doing this again Craig. you come in here every fucking week. Fuck. Come on man.
4378,6455,10,41,211,262,1.2328244274809161,0.031254307982704704,651,Your tests are negative for ringworm.
8089,6455,10,41,211,262,1.2328244274809161,0.031254307982704704,651,You may experience some chest tightness during the treatment.
2774,6457,10,34,188,232,1.2327586206896552,0.03385664595094651,651,I can offer you the name of a colleague if you want a second opinion.
3481,6457,10,34,188,232,1.2327586206896552,0.03385664595094651,651,More than just your bowls are constricted.
8965,6457,8,38,186,232,1.2327586206896552,0.03273582852739875,651,Do you want the good news or the bad news first?
5953,6460,11,35,199,245,1.2326530612244897,0.033161399437949546,651,It's the latest method for monitoring blood pressure.
1734,6460,8,41,196,245,1.2326530612244897,0.03161187113450195,651,Take an aspirin and some antivenom and call me in the morning.
2302,6460,13,31,201,245,1.2326530612244897,0.034155386447662424,651,"Doc, can I have a hearing test? I keep hearing a low hiss"
2575,6460,11,35,199,245,1.2326530612244897,0.033161399437949546,651,"For health reasons, I recommend that you pick up a different hobby."
8713,6460,8,41,196,245,1.2326530612244897,0.03161187113450195,651,I see you have a history of breathing problems.
6467,6465,8,44,206,258,1.2325581395348837,0.03059019674272246,651,...and two weeks in Maui to unwind.
7207,6465,12,36,210,258,1.2325581395348837,0.03250250556548944,651,Give him two aspirin and see how he feels in the morning.
4949,6465,7,46,205,258,1.2325581395348837,0.030093137987578112,651,This med is expensive so you may feel a little squeezed this month.
2049,6465,6,38,171,215,1.2325581395348837,0.03308787540588501,651,"Don't worry, they're not poisonous."
165,6465,11,38,209,258,1.2325581395348837,0.03203513204617114,651,I said: 'Undress'!
9081,6470,11,31,186,228,1.2324561403508771,0.034800343764709626,651,"‘A comfort animal isn’t supposed to inspire intense discomfort in others, can we agree on that?’"
7867,6470,9,35,184,228,1.2324561403508771,0.03367162307961159,651,"My hands are tied too Mr. Jones, I can't help you with this preexisting condition."
6384,6472,7,42,192,241,1.2323651452282158,0.03138888277309473,651,Five more minutes and then we'll check your breathing.
6146,6472,11,34,196,241,1.2323651452282158,0.033519763546129754,651,It seems to have spread quickly from the lymph nodes to the groin.
2751,6472,11,34,196,241,1.2323651452282158,0.033519763546129754,651,"Now listen-COBRA, not Boa, COBRA!"
55,6472,6,44,191,241,1.2323651452282158,0.03083316096561851,651,"The python will be OK, but I'm not sure about you."
3734,6472,16,24,201,241,1.2323651452282158,0.036006461659612674,651,"Sorry, but neither of your insurance cards showed up on our computer."
2959,6477,7,32,159,198,1.2323232323232323,0.03555621978282577,651,I warned you where this fixation with John Cleese would lead.
5313,6478,9,41,204,254,1.2322834645669292,0.031384016877505916,651,"I wrote ""turtle neck"", not ""python"""
749,6478,9,41,204,254,1.2322834645669292,0.031384016877505916,651,Its test results show it loves garlic--so you're going to have to give that up.
9103,6478,12,35,207,254,1.2322834645669292,0.032837848453209195,651,There are lots better ways to get a hug.
7854,6481,9,34,181,224,1.2321428571428572,0.03405414403429193,651,And when did this sensation of increased pressure start?
160,6482,13,29,195,237,1.2320675105485233,0.03492830565301509,651,"You’re only supposed to take one, and it should not last more than four hours."
253,6482,5,45,187,237,1.2320675105485233,0.030560184709940347,651,How many tiers would you like removed?
6067,6482,14,27,196,237,1.2320675105485233,0.035436481788914134,651,"The latest research suggests that if you have a small butt, you're fairly safe."
4776,6482,7,41,189,237,1.2320675105485233,0.03170867863971732,651,It seems digestive.
1982,6486,10,38,202,250,1.232,0.03220017710545223,651,"Mr. Murphy, of course the medication is strong.  As I always say, what doesn't kill you makes you stronger!"
6328,6486,10,38,202,250,1.232,0.03220017710545223,651,Have you eaten any apples recently?
5214,6486,11,36,203,250,1.232,0.032695258366905657,651,I’m recommending a month-long fast.
2445,6486,13,32,205,250,1.232,0.0336635848921526,651,It’s a common case of Boa Constriction
3713,6490,9,46,221,276,1.2318840579710144,0.029746274506796032,651,So I understand the alligator was not a successful companion animal choice.
3063,6491,14,23,183,220,1.231818181818182,0.037340298579870625,651,I suggest Catholicism.
4598,6491,7,37,176,220,1.231818181818182,0.033222295151420805,651,"Well, your blood pressure is slightly elevated."
1034,6493,7,40,186,233,1.2317596566523605,0.03203802664551679,651,"Mr. Jones, I'm sorry to say it was more than just a snake bite."
5915,6493,11,32,190,233,1.2317596566523605,0.034269955114219874,651,"Take an apple and call me in the morning, Mr. Adam."
6587,6493,6,42,185,233,1.2317596566523605,0.03145530930210182,651,So you say you’ve had trouble swallowing lately?
7884,6493,9,36,188,233,1.2317596566523605,0.033172767256210996,651,"You are Adam, or Eve?"
1170,6497,13,31,202,246,1.2317073170731707,0.034029404643660936,651,"In all my years as a Gastro Internest, I have never seen a patient as constricted as you"
5355,6497,5,47,194,246,1.2317073170731707,0.02987521276788645,651,More fiber might loosen you up down there
5767,6497,8,41,197,246,1.2317073170731707,0.03149730708893711,651,"So, you have a family history of chest pain, right?"
1449,6500,11,38,210,259,1.2316602316602316,0.03192383460320894,651,"Okay, so, let's add rest, ice and elevation and see if that helps."
2005,6500,11,38,210,259,1.2316602316602316,0.03192383460320894,651,"Actually, this form of a tight hug is not a true sign of affection."
7973,6500,10,40,209,259,1.2316602316602316,0.03145156519610174,651,The good news is that the cat has let go of your toungue.
2709,6503,12,39,221,272,1.2316176470588236,0.03134183667249232,651,We don’t really do ‘sliding scales’.
5690,6504,7,33,163,203,1.2315270935960592,0.03496021896019181,651,"This time, apple juice, Adam"
1571,6505,9,35,185,229,1.2314410480349345,0.033539627609815464,651,When was it you began  feeling chest pain?
8987,6506,11,34,197,242,1.2314049586776858,0.03339477154185359,651,"No, I am not ruling out herpes just because you are a herpetologist."
7667,6506,11,34,197,242,1.2314049586776858,0.03339477154185359,651,This new anti-snake venom should work.
2624,6506,12,32,198,242,1.2314049586776858,0.03390432336940572,651,So you said you first felt a tickle in your throat?
5223,6506,6,44,192,242,1.2314049586776858,0.030720496127331878,651,Your oxytocin levels will drop when the hugging ends.
1321,6506,7,42,193,242,1.2314049586776858,0.03127365119575981,651,What have you been feeding him?
756,6511,12,35,208,255,1.231372549019608,0.03272150077166994,651,Just don't do a colonoscopy this week.
5546,6511,7,45,203,255,1.231372549019608,0.030270516135386918,651,Diet pills should help it fall right off.
7381,6511,9,41,205,255,1.231372549019608,0.03127396894162604,651,"When you said yor job was ""killing you"", I didn't think you meant literally!"
7714,6514,14,34,220,268,1.2313432835820894,0.03251626966225497,651,I'm just feeling a little constricted at work lately.
1072,6515,6,40,179,225,1.231111111111111,0.032115312516928195,651,"You could stand to lose what, about 30 pounds?"
4775,6516,8,39,191,238,1.23109243697479,0.032146527219184616,651,You say you feel pressure in your chest..?...
1534,6516,10,35,193,238,1.23109243697479,0.033231215054220255,651,"If you're tempted to try that  'Apple a Day' diet again, come to me first"
1680,6516,9,37,192,238,1.23109243697479,0.03269336986480296,651,"So, you say you've been feeling the need for more touch and intimacy."
2483,6516,10,35,193,238,1.23109243697479,0.033231215054220255,651,Leaving aside my obvious medical concerns I must insist that it is a terrible fashion statement.
3082,6516,6,43,189,238,1.23109243697479,0.031023938668836355,651,Snake oil twice a day and you should be fine.
3134,6516,4,47,187,238,1.23109243697479,0.029859174951790985,651,We can't rule out excessive stress in your life for that feeling of constriction in your chest and abdomen.
8154,6522,7,44,200,251,1.2310756972111554,0.030558574037399887,651,"Constipated, but you feel better when you unwind?"
4642,6522,13,32,206,251,1.2310756972111554,0.03354193654159233,651,Well at least you didn’t drown
2357,6522,8,42,201,251,1.2310756972111554,0.03107569721115537,651,"You're left handed, Doctor. That's weird."
597,6525,10,41,213,264,1.231060606060606,0.03104205280545662,651,Some mediation should help you feel less constricted
6018,6526,11,42,224,277,1.2310469314079422,0.030520047436568977,651,Can you please put your python aside for the physical?
7375,6527,10,31,180,221,1.2307692307692308,0.03490327742203962,651,"So, other than the tightness in your chest did you experience any arm pain or indigestion?"
8310,6527,10,43,220,273,1.2307692307692308,0.030363899942266577,651,It looks like your health is in a downward spiral.
7078,6527,8,35,178,221,1.2307692307692308,0.033704125923896856,651,"Well, looks like a common asp sprain, you should be up on your feet in no time"
6355,6527,8,35,178,221,1.2307692307692308,0.033704125923896856,651,Your blood pressure is high. I'll write you a prescription.
5656,6527,5,41,175,221,1.2307692307692308,0.03182078092277041,651,It’s not your intestine...
4651,6527,8,38,188,234,1.2307692307692308,0.032485775115783995,651,I'm guessing Pharaoh denied your Exodus demand.
7373,6527,11,35,201,247,1.2307692307692308,0.032919192687496185,651,"Don't worry, it's just a virus."
2699,6527,9,39,199,247,1.2307692307692308,0.031903646020104884,651,Lupus.
68,6527,9,36,189,234,1.2307692307692308,0.03304554470710397,651,"Believe me, this addiction always starts with deceptively harmless feather boa."
4526,6527,9,39,199,247,1.2307692307692308,0.031903646020104884,651,The good news is that you only have to feed him once a day.
3358,6537,12,38,219,269,1.2304832713754648,0.03153889235167746,651,This is a love story for the ages.
8069,6538,4,48,191,243,1.2304526748971194,0.02947656655980876,651,"Next winter, try Arizona"
6221,6538,10,36,197,243,1.2304526748971194,0.0327555916795324,651,I'm glad to see that you finally got a grip on yourself
3923,6538,11,34,198,243,1.2304526748971194,0.03327069162636221,651,"Your circulation IS low, but your blood work came back clear. I'm afraid we'll have to run some more tests."
6546,6538,12,32,199,243,1.2304526748971194,0.033777937419515784,651,"Since your  chest  tightness is continuous and not exertional, we can exclude heart causes."
950,6538,7,42,194,243,1.2304526748971194,0.031159242308110513,651,"Well, your test results are all normal. It's hard to say what's really going on with you. Let's just keep an eye on it and let me know if your symptoms get any worse."
1627,6543,9,35,186,230,1.2304347826086957,0.03340864249884607,651,Did they tell you how to get the snake oil?
4977,6543,7,39,184,230,1.2304347826086957,0.032252020605612414,651,"...however, the good news is, you're all set for Paris fashion week."
1868,6545,6,38,173,217,1.2304147465437787,0.03281706663385937,651,"Your new diet plan seems to be working, at least until she gets hungry."
6385,6545,12,26,179,217,1.2304147465437787,0.03650994724044132,651,Let's try an inhaler.  You get treatment for your shortness of breath and I get a free trip to Tahiti.
1724,6547,7,47,211,265,1.230188679245283,0.029518358429340745,651,I advise you to continue to constrict your calorie intake
7413,6548,9,40,203,252,1.2301587301587302,0.031472131510731444,651,Tell Snakey it's okay for the doctor to look.
5376,6548,12,34,206,252,1.2301587301587302,0.03294470704717963,651,What exactly possessed you to use Tinder?
6572,6548,8,42,202,252,1.2301587301587302,0.03096571504578686,651,"I can't recommend it, not for weight loss."
7447,6548,8,42,202,252,1.2301587301587302,0.03096571504578686,651,"I'm thinking 4 Asp-rin should do the trick... haha, sorry, I couldn't resist!"
4854,6552,8,39,192,239,1.2301255230125523,0.032026339826951744,651,What really concerns me is your sense of fashion.
866,6552,11,33,195,239,1.2301255230125523,0.03363284058572202,651,You’re lucky he didn’t decide to crawl up your ass.
3340,6552,8,39,192,239,1.2301255230125523,0.032026339826951744,651,She only asked me to pet it.
5271,6552,9,37,193,239,1.2301255230125523,0.03257064553288938,651,You need to make an appointment with a  herpetologist.
5334,6556,9,31,173,213,1.2300469483568075,0.035129973774088635,651,I recommend you stop impersonating the AMA symbol.
2967,6557,10,40,211,261,1.2298850574712643,0.03123522852812678,651,Shall we start by your taking a deep breath.
8356,6557,8,44,209,261,1.2298850574712643,0.03027696508359468,651,Your snake pressure is rather high.
3304,6559,8,41,199,248,1.2298387096774193,0.03127059685561602,651,Come to me again in five weeks if the snake does not come off.
510,6560,5,44,186,235,1.2297872340425533,0.030630012417505306,651,Certainly one of the most unusual cases of serpentine ornamentation I have come across.
842,6560,8,38,189,235,1.2297872340425533,0.03236214467715558,651,Have you tried playing a wind instrument?
272,6562,8,43,206,257,1.2295719844357977,0.0305627874306863,651,Feeling life’s pressures?
564,6562,14,31,212,257,1.2295719844357977,0.033413724300686176,651,"Looks like your insurance will cover the snake removal, but it won’t cover the fact that you’re a putz."
3396,6564,10,36,198,244,1.2295081967213115,0.03263474110595432,651,So your feeling constricted in the chest? Any history of heart disease?
5711,6565,10,33,188,231,1.2294372294372293,0.03383951085096444,651,So if you can’t afford the co-pay might I suggest the fire department?
2268,6565,10,33,188,231,1.2294372294372293,0.03383951085096444,651,"Blood Pressure looks good, LDL is a bit high - no more french fries - and your PSA is in the normal range.  Now, about the snake..."
1137,6565,8,37,186,231,1.2294372294372293,0.03270818648020354,651,"I'm writing a prescription for support hose for you, and a tranquilizer for the snake. Anything thing else I can do for you?"
958,6565,12,29,190,231,1.2294372294372293,0.03493421712936059,651,I regret to tell you that this will not help you find your Eve.
2029,6565,7,39,185,231,1.2294372294372293,0.03212758856371551,651,Take this prescription to Pets and More - have them put the two of you in their rodent cage.  That should do the trick..
512,6570,10,41,215,266,1.2293233082706767,0.030832603331922875,651,"Say, 'aaaaaahhhhhhhhhhhh!"""
5519,6571,7,44,202,253,1.2292490118577075,0.030343919581248054,651,"On the plus side, you won't have to eat again for a year."
8297,6571,13,32,208,253,1.2292490118577075,0.03330121672064215,651,I'm ordering an extensive battery of tests to figure out your breathing problem.
3245,6571,8,42,203,253,1.2292490118577075,0.030856491248037857,651,I’m sorry but unless you have the Rod of Asclepius he’s just going to stay there.
426,6571,9,40,204,253,1.2292490118577075,0.031360686356124684,651,Most curious. We are still reviewing your chest x-ray.
202,6571,10,38,205,253,1.2292490118577075,0.031856902632148854,651,This can’t keep happening Mr Copperfield.
2876,6571,10,38,205,253,1.2292490118577075,0.031856902632148854,651,You might want to just keep it on until the polar vortex goes away.
2197,6577,8,39,193,240,1.2291666666666667,0.03190702839784435,651,Maybe try acupuncture for your back instead?
5343,6577,7,41,192,240,1.2291666666666667,0.03135587596757736,651,This is a prescription to go home and get a life.
4570,6577,11,33,196,240,1.2291666666666667,0.03350613334362974,651,Call me if you experience any side effects such as light-headedness or fainting
4176,6577,11,33,196,240,1.2291666666666667,0.03350613334362974,651,I’m not sure if I should refer you to a chest specialist or a vet.
1127,6577,12,31,197,240,1.2291666666666667,0.034022470150296955,651,Just relax and take a deep breath.
4529,6577,8,39,193,240,1.2291666666666667,0.03190702839784435,651,You may want to reconsider your fashion choices in the future.
5970,6583,10,43,222,275,1.229090909090909,0.030165936291992733,651,"You're much smaller in person, Mr. Roberts."
6477,6583,14,35,226,275,1.229090909090909,0.03187718484173714,651,"This might sound pithy, but I want you to take two asp and call me tomorrow."
940,6585,9,34,184,227,1.2290748898678414,0.03364933291590484,651,It appears you have a case of the slithers
8842,6586,11,27,176,214,1.2289719626168225,0.036214510960171926,651,"Now, how many years ago was it that you said you stopped smoking?"
4947,6587,8,41,200,249,1.2289156626506024,0.031158434248590553,651,So.....this all started with wanting a snakeskin coat
2532,6587,9,39,201,249,1.2289156626506024,0.03167389524197765,651,"Yes, I understand. It’s like when The New Yorker app won’t automatically keep you logged in."
6439,6587,10,37,202,249,1.2289156626506024,0.03218110089440396,651,I'm sorry Mr Jones. We found nothing that could account for the tightness in your chest.
8336,6590,7,40,189,236,1.228813559322034,0.031675210005565634,651,I’ve confirmed that it is indeed a snake and you’re not just excited to see me.
7862,6590,7,40,189,236,1.228813559322034,0.031675210005565634,651,Give him two Xanax and call me in the morning.
7421,6590,12,30,194,236,1.228813559322034,0.03440391056734952,651,I see that your cloning didn’t exactly work out as anticipated.
6352,6590,9,36,191,236,1.228813559322034,0.032793947341978893,651,You're just wrapped too tight.  I'm prescribing meditation.
5388,6590,10,34,192,236,1.228813559322034,0.03333924127742538,651,You said you were uncomfortable with the old way...so please turn your head and cough.
3856,6590,8,38,190,236,1.228813559322034,0.032239431688269336,651,PETA approved snake skin jacket
3330,6590,7,40,189,236,1.228813559322034,0.031675210005565634,651,What made you think that Python could solve your IT needs?
5228,6590,11,32,193,236,1.228813559322034,0.033875758820139865,651,So you say you’ve been bound up lately?
8314,6598,7,37,179,223,1.2286995515695067,0.03282332831555023,651,"Well, I wouldn't say in your case that any love is good love."
298,6599,12,35,211,258,1.2286821705426356,0.032377268484591756,651,Without a doubt the worse case of hemmorroids I've ever seen.
8451,6599,9,41,208,258,1.2286821705426356,0.030948311198935968,651,I'm afraid it's caught on to your mousy personality.
2181,6601,9,38,198,245,1.2285714285714286,0.031996152328062855,651,"And after you said, 'Don't worry, they're not poisonous'"""
5619,6601,6,44,195,245,1.2285714285714286,0.030387262919547714,651,So you’re feeling extremely wound up?
6894,6601,9,38,198,245,1.2285714285714286,0.031996152328062855,651,"This will take care of the congestion, but for the contractions you will have to see an obstetrician."
8722,6601,12,32,201,245,1.2285714285714286,0.033527925373626755,651,This should help you over come your fear of gophers and rodents.
8862,6601,8,40,197,245,1.2285714285714286,0.03146899678171583,651,I'm sorry there is just no shortcut to diet and exercise.
9212,6606,8,45,214,267,1.2284644194756553,0.029798415594850105,651,"Yeah, they still don't cover python therapy. Tell me the insurance industry isn't controlled by big pharma!"
7632,6606,11,39,217,267,1.2284644194756553,0.031183752773639422,651,We can squeeze Fred in for anger management therapy at 1:15 on Tuesday if that works for you?
657,6606,12,37,218,267,1.2284644194756553,0.031632052184593036,651,So when did your chest pain and shortness of breath first start?
4489,6609,9,35,188,232,1.228448275862069,0.033149658543243414,651,"If you’re home alone, no one will see you naked when you remove your snake."
5079,6609,6,41,185,232,1.228448275862069,0.03141564662751506,651,I’m ordering  some routine tests to look into you unexplained weight gain. Is there anything else I can help you with today?
8090,6609,7,39,186,232,1.228448275862069,0.03200409123629575,651,Thought you could take the lab and skip the safety class ?
8096,6609,11,31,190,232,1.228448275862069,0.03425693896433421,651,"I think I need some muscle relaxers, doc."
8771,6609,8,37,187,232,1.228448275862069,0.03258190999154879,651,"With the recent crackdown on service animals and the poor ratings at the box office, odds aren't good you're going to make your flight."
2429,6614,6,46,202,254,1.2283464566929134,0.02971860431245405,651,A few more questions will wrap things up.
8116,6614,10,38,206,254,1.2283464566929134,0.031744067317185785,651,"Says here, this is the longest you've ever experienced this problem--about 20 feet."
6523,6616,9,32,178,219,1.2283105022831051,0.034426933507044115,651,I’m afraid being too charming is not an ailment.”
6253,6616,9,32,178,219,1.2283105022831051,0.034426933507044115,651,It seems like you have a staph infection
2157,6618,9,45,222,276,1.2282608695652173,0.029626476874266373,651,Perhaps next time try a pet rabbit
4721,6619,10,35,196,241,1.2282157676348548,0.03285833753306943,651,It says here you’ve been feeling some pressure from in midsection?
5403,6619,10,35,196,241,1.2282157676348548,0.03285833753306943,651,Ok You really seemed to be wrapped up in this relationship.
5430,6619,12,31,198,241,1.2282157676348548,0.03389434523131849,651,"Don’t worry sir, the male coil is 100% effective."
5813,6619,10,35,196,241,1.2282157676348548,0.03285833753306943,651,"Well, you definitely have an obstructed person."
7992,6619,5,45,191,241,1.2282157676348548,0.03011278154505842,651,This will help you relax. He should just walk away in a couple days.
1497,6624,13,34,216,263,1.2281368821292775,0.0323948540307783,651,It says here you''re worried that you lost your right big toenail?
2755,6624,15,30,218,263,1.2281368821292775,0.03327877198619783,651,It does not seem to combat the frog in your throat.
2931,6624,10,40,213,263,1.2281368821292775,0.031021789468445617,651,This should help with the bloating.
4100,6627,8,41,201,250,1.228,0.031047055878373715,651,Any idea why your weight has increased so much?
616,6627,11,35,204,250,1.228,0.03256232824727886,651,...So when did you start having problems exhaling?
1065,6627,7,43,200,250,1.228,0.030525254538801717,651,I am writing you a referral to a herpetologist. This is beyond my specialty.
6659,6627,5,47,198,250,1.228,0.029453932446214803,651,Huggy is an excellent therapy snake for anxiety.
5039,6627,11,35,204,250,1.228,0.03256232824727886,651,Affection? It’s a gift . . . And a curse.
1669,6632,11,27,177,215,1.2279069767441861,0.036061407134729634,651,I've been a little constricted.
2089,6633,11,32,194,237,1.2278481012658229,0.033746333651126954,651,So...has the emotional support been positive?
3159,6633,11,32,194,237,1.2278481012658229,0.033746333651126954,651,"I am quite satisfied with your weight loss, Stuart."
4691,6633,7,40,190,237,1.2278481012658229,0.03155604873476393,651,"Yeah, some of my other patients have told me that their home scales don't match the ones in our office."
4961,6633,8,38,191,237,1.2278481012658229,0.032117626274934974,651,"So you just need to sign this and you are off to go"""
5801,6633,8,38,191,237,1.2278481012658229,0.032117626274934974,651,"Oh, I thought you meant feather boa..."
8301,6633,6,42,189,237,1.2278481012658229,0.030984294504881014,651,Is that a snake or are you just excited to see me?
5013,6639,9,41,209,259,1.2277992277992278,0.030841229396122254,651,When did you last go to Florida?
3388,6639,9,41,209,259,1.2277992277992278,0.030841229396122254,651,I’m glad you’ve to to a real doctor instead of one of those snake oil salesmen
1536,6639,14,31,214,259,1.2277992277992278,0.033178799603153904,651,Makes you long for those gowns with the opening showing your butt.
2094,6642,8,40,198,246,1.2276422764227641,0.031354583092026864,651,Try shallow breathing and call me Thursday
3392,6642,7,42,197,246,1.2276422764227641,0.030820867534275796,651,"Your blood is a bit cold, but everyting else looks fine!"
7681,6642,7,42,197,246,1.2276422764227641,0.030820867534275796,651,I'm giving you something for that tight feeling in your chest.
8370,6642,9,38,199,246,1.2276422764227641,0.03187936458250474,651,"Besides your bowels, does anything else feel constricted?"
8985,6642,10,36,200,246,1.2276422764227641,0.03239564618114135,651,"I see the problem. Your chart should say ""herpetology""."
4029,6647,12,37,219,268,1.2276119402985075,0.03152532919798454,651,Hmn. .looks like your pressure's up.  Does it run in the family?
4084,6648,10,33,190,233,1.2274678111587982,0.03357718308284277,651,"So, he said to eat an apple a day..."
1278,6648,9,35,189,233,1.2274678111587982,0.03302163769001762,651,"Not to appear politically incorrect, but I think you’d be better off sticking with fur."
6782,6648,8,37,188,233,1.2274678111587982,0.03245658465832229,651,Now tell me again about this choking feeling you're getting.
5961,6648,11,31,191,233,1.2274678111587982,0.03412368520290112,651,W'll get the chest x-ray next time.
8234,6652,12,34,209,255,1.227450980392157,0.03259357690996699,651,"Sir, I don't know what you've heard but we don't sell snake oil at this clinic."
6070,6652,13,32,210,255,1.227450980392157,0.03306387377358359,651,"it says it was 13 inches long when you bought it.
when was that?"""
7222,6652,11,36,208,255,1.227450980392157,0.03211639398588201,651,"Oh, it's B-O-A. Thank God. I thought... well, never mind."
6788,6652,6,46,203,255,1.227450980392157,0.02961537264679818,651,It’s almost always self-limiting.
1824,6652,6,46,203,255,1.227450980392157,0.02961537264679818,651,"Again, If you're not in any pain..."
9234,6657,11,33,198,242,1.2272727272727273,0.033255513106092975,651,This be a classic case of leg envy.
8910,6657,7,41,194,242,1.2272727272727273,0.031124903931273047,651,Take this to a snake oil salesman. It should  relieve your constriction.
7726,6657,6,43,193,242,1.2272727272727273,0.0305690573607748,651,I think that you're too wrapped up in your work. You have to learn how to unwind.
6365,6657,9,32,179,220,1.2272727272727273,0.034285799643725766,651,"I agree, it's surprising that the snake tracked you down after the President tweeted that you are a ""rat"". I didn't know reptiles had Twitter accounts."
6266,6657,15,30,219,264,1.2272727272727273,0.03316373702994407,651,"Interesting approach to the cold wave, but you might do better with a warm-blooded animal."
6771,6657,6,38,176,220,1.2272727272727273,0.03241886882610767,651,"Young man, I perscribe soft rythmic music twice a day."
1555,6657,11,33,198,242,1.2272727272727273,0.033255513106092975,651,A crushing chest pain is most likely to be a heart attack
337,6657,4,42,174,220,1.2272727272727273,0.031112072498214512,651,I'm recommending something to lower your pressure.
4534,6657,8,39,195,242,1.2272727272727273,0.03167099653524676,651,"I think you’re just fat, but I’ll run some
tests."
1140,6666,9,39,203,251,1.2270916334661355,0.03144736369784765,651,"I know, but you can only use a paper gown once."
1383,6666,7,43,201,251,1.2270916334661355,0.030416963418861964,651,"The Python squeeze is our newest Cellulite treatment"""
3748,6666,10,37,204,251,1.2270916334661355,0.03195010474951319,651,Perhaps you should have been more specific about the kind of boa you wanted for your wife.
4938,6666,11,35,205,251,1.2270916334661355,0.03244505668765312,651,"Obviously, your difficult breathing is caused by your
sudden weight gain."
5425,6670,9,34,186,229,1.2270742358078603,0.033384663153796006,651,"I know, I'm no stylist, but I think we can agree--it's not as slimming as you hoped and more ridiculous-looking than the feather version."
856,6670,6,40,183,229,1.2270742358078603,0.03161676173572539,651,I'm a bit concerned about your recent weight gain.
5925,6670,8,36,185,229,1.2270742358078603,0.03280595012310256,651,Do you have asthma? Hypertension?
1508,6670,6,40,183,229,1.2270742358078603,0.03161676173572539,651,"Come back in a week. We'll remove the snake. You will look like a new man."""
5478,6674,9,29,169,207,1.2270531400966183,0.03569398887468977,651,Payment for treatment will have to be made 'out of pocket'.
3510,6674,5,37,165,207,1.2270531400966183,0.032961377104800696,651,Open wide and say Kaa.
495,6676,7,45,208,260,1.226923076923077,0.029752852491586046,651,"If you're not better by tomorrow, this'll get you in to see a specialist."
3387,6676,8,43,209,260,1.226923076923077,0.03024784721407637,651,”She seems to nave a real crush on you.
1752,6678,10,34,194,238,1.226890756302521,0.03308631815669605,651,Did Monty ever bathe with you before Mr. Jones?
8322,6678,9,36,193,238,1.226890756302521,0.03254607853955812,651,I'm the herpetology resident. What can I do for you?
6357,6678,10,34,194,238,1.226890756302521,0.03308631815669605,651,Go jump in a lake.
3252,6681,10,29,177,216,1.2268518518518519,0.035304830801663564,651,Your health is pretty good except for all the anxiety you are carrying
7678,6682,13,35,221,269,1.2267657992565055,0.03185773803216609,651,We should probably scale back your hypertension treatment
2128,6683,9,38,200,247,1.2267206477732793,0.03176340953453863,651,And stay off planes with snakes.
3814,6683,8,40,199,247,1.2267206477732793,0.03124098072001974,651,I’ll need to run some expensive tests to pinpoint the cause of your scaly skin.
3580,6683,12,32,203,247,1.2267206477732793,0.03328152808975786,651,‘No need to use a condom’
3710,6683,8,40,199,247,1.2267206477732793,0.03124098072001974,651,"Karma Mr. DeVito, Karma."
6623,6687,9,33,183,225,1.2266666666666666,0.033759184523364,651,I think we better get a CT Scan to be sure
9110,6687,5,41,179,225,1.2266666666666666,0.031320159337914946,651,"So, how long have you been noticed this squeezing feeling in your chest?"
6201,6687,10,31,184,225,1.2266666666666666,0.034341885204005315,651,"Remember I warned you alcohol is a vasoconstrictor?
The problem has worsened."
1024,6690,9,40,207,256,1.2265625,0.03103094177472657,651,And just how long have you had this squeezing sensation in your chest?
1476,6690,9,40,207,256,1.2265625,0.03103094177472657,651,We will start you off with a low dose and increase that if the pain gets worse.
3588,6690,5,48,203,256,1.2265625,0.028989141550218894,651,"Sorry the snake was not very charming, but I'm giving you this prescription to relieve the tension."
4187,6690,10,38,208,256,1.2265625,0.031520732896435505,651,Everyone needs a hug but this is not healthy.
7453,6690,7,44,205,256,1.2265625,0.03002740144638808,651,The lab tests indicate you are suffering from a rare disease known as petaboa.
3039,6695,9,35,190,234,1.2264957264957266,0.03289458317317972,651,I'm writing you a prescription in case he bites you before we can get him safely released back into the wild.
840,6695,11,31,192,234,1.2264957264957266,0.03399144719439099,651,The blood pressure machine is tight today
5647,6695,7,39,188,234,1.2264957264957266,0.031759860231200726,651,So you thought it was a feather boa?
7996,6695,9,35,190,234,1.2264957264957266,0.03289458317317972,651,Gyre and gimbling in the wabe again?
4083,6699,11,33,199,243,1.2263374485596708,0.033131580111333485,651,"No, I'm not singing the form, and honestly, don't you find the term 'comfort snake' to be a tad ironic?"
3492,6699,6,43,194,243,1.2263374485596708,0.030457362419824347,651,"Yes,life can be constricting but you don’t have to worry."
2469,6699,12,31,200,243,1.2263374485596708,0.03364092352617485,651,I can't decide if you or the snake needs surgery.
3673,6699,11,33,199,243,1.2263374485596708,0.033131580111333485,651,"First, I'm going to refill your prescription for Oxycontin."
3727,6703,6,50,218,274,1.2262773722627738,0.028314788813926038,651,I don't want you to worry.  Many of out patients with this live well into their 80's.
5939,6703,10,42,222,274,1.2262773722627738,0.030144257788768527,651,"I am hard-pressed for time today, so I’ll write you a referral for the herpetologist."
7529,6705,7,36,178,221,1.2262443438914028,0.03291906445691976,651,I've just been feeling a little choked up.
3522,6705,9,32,180,221,1.2262443438914028,0.03414579732887786,651,A constricted throat is not an uncommon allergic reaction.
3616,6705,9,32,180,221,1.2262443438914028,0.03414579732887786,651,"Well, I'm prescribing some difficult exercises - you're really going to have to work your asp off!"
2188,6708,7,43,202,252,1.2261904761904763,0.030309420269591335,651,I've not had this finding with other Emotional Support animals.
8822,6708,12,33,207,252,1.2261904761904763,0.03281400196163575,651,"To be honest I have never heard of this ""Just squeezed Diet"""
5463,6710,11,42,230,283,1.226148409893993,0.029937513084879748,651,Do you have any choking symptoms?
54,6711,6,40,184,230,1.2260869565217392,0.03149447568221478,651,These weight loss fads are out of control
1677,6712,12,35,214,261,1.2260536398467432,0.03204008395427922,651,"Unless one of you has a blood disorder, I think you have the wrong doctor."
7671,6712,12,35,214,261,1.2260536398467432,0.03204008395427922,651,How long have you had this constricting chest pain?
6664,6714,7,40,192,239,1.2259414225941423,0.03132033610635751,651,Says here you're experiencing sleep paralysis?
4904,6714,8,38,193,239,1.2259414225941423,0.03187669935129629,651,I'm writing you a prescription for that elevated pressure.
3219,6714,8,38,193,239,1.2259414225941423,0.03187669935129629,651,I'll write you a prescription
1171,6714,7,40,192,239,1.2259414225941423,0.03132033610635751,651,So how long has this pet therapy been working?
321,6718,7,47,216,270,1.2259259259259259,0.029032429872189635,651,Your cough seems a bit constricted.
1691,6719,12,34,211,257,1.2256809338521402,0.03236355154454405,651,You have worms
1574,6720,6,39,181,226,1.2256637168141593,0.03182151255993841,651,"‘Alright, turn left and cough’"
1732,6720,7,37,182,226,1.2256637168141593,0.032433624964954395,651,I have a theory about that tightness in your chest.
5237,6720,10,31,185,226,1.2256637168141593,0.034204299856338216,651,"My assistant, Mr. Non-Blinky, is now checking your vitals."""
3355,6723,10,40,216,266,1.2255639097744362,0.030706941155363168,651,Take everything off but your underwear. The doctor will be here in a minute.
3092,6724,10,35,199,244,1.2254098360655739,0.03249358626078877,651,Any wheezing?
9047,6724,12,31,201,244,1.2254098360655739,0.03351560643835555,651,"Now on a scale of 1 to 10, what is your pain level?"
4249,6724,9,37,198,244,1.2254098360655739,0.03197032662744644,651,Now don't tell me you just fell on it.
7224,6724,6,43,195,244,1.2254098360655739,0.030346460986422828,651,Your insurance requires this as a first treatment.
7788,6728,6,36,171,213,1.2253521126760563,0.033002756185465845,651,I should have the cause of your labored breathing wrapped up very soon.
1432,6729,5,47,201,253,1.225296442687747,0.02914547851478081,651,"Look at it this way, you have a beautiful snake skin coat that’s PITA approved."
271,6729,9,39,205,253,1.225296442687747,0.031223986039637882,651,We’ll need to run some tests to figure out why your basal body temperature is so low.
4431,6729,11,35,207,253,1.225296442687747,0.032212986470947974,651,And how long have you been feeling this constriction in your chest?
7084,6732,9,32,181,222,1.2252252252252251,0.03400691333950098,651,"So, can you think of any reasons why you don't feel comfortable in enclosed or tight spaces?"
2071,6732,6,38,178,222,1.2252252252252251,0.03215860561248001,651,"So you say you’re having trouble breathing, let’s if we can’t figure it out."
5843,6734,10,39,213,262,1.2251908396946565,0.030999678856009735,651,When did you start feeling these chest pains?
171,6735,6,40,185,231,1.225108225108225,0.03137310978507756,651,"Yessss, doctor, it hurts when I squeeze him."
2939,6736,11,39,221,271,1.2250922509225093,0.030768342394792824,651,"It may be able to help with the stiffness in your neck, but it's only a short term solution."
4292,6737,8,38,194,240,1.225,0.03175755875936081,651,"With a few doses of muscle relaxant, I'm sure we can get that pesky mammal out of you, Ms. Conda."
4996,6737,10,34,196,240,1.225,0.0328371366797983,651,"George, I'm just saying that your imagined snake is a metaphor for healthcare costs.  Besides, you could stand to loose a few pounds."
6621,6737,9,36,195,240,1.225,0.0323018581793835,651,Your snake needs to go on a low protein diet. Is there anything else I can help you with?
1798,6737,10,34,196,240,1.225,0.0328371366797983,651,"So, you're saying his jealousy has gotten worse since you've been so wrapped up in your new girlfriend?"
1219,6737,12,30,198,240,1.225,0.0338823339264174,651,I'm afraid you're going to need a snake oil remedy
3771,6737,6,42,192,240,1.225,0.030639966243139916,651,I'm going to recommend the boas at Oscar de la Renta.  I'll think you'll find them less constrictive.
1110,6737,8,38,194,240,1.225,0.03175755875936081,651,"This prescription is for an injection, in case you have trouble swallowing."
6063,6744,12,32,205,249,1.2248995983935742,0.03303866937714549,651,Any family history of asthma or exposure to Tuberculosis?
1364,6745,10,27,172,209,1.2248803827751196,0.03602903317267078,651,It might be a parasite
3054,6746,10,38,210,258,1.2248062015503876,0.03130046139935622,651,"When do you find it difficult breathing? Before feeding, during feeding or after feeding?"
7902,6746,15,28,215,258,1.2248062015503876,0.033623426326117395,651,So what happened after you swiped right?
8544,6746,6,46,206,258,1.2248062015503876,0.029309830305485986,651,We expect this study will render the digital rectal exam obsolete.
7170,6749,8,35,184,227,1.224669603524229,0.032903570177371666,651,"When it comes to snakeskin, you're supposed to stop with the belt."
1260,6749,8,35,184,227,1.224669603524229,0.032903570177371666,651,I cannot get rid of this constricted feeling. . .
6885,6751,8,46,222,276,1.2246376811594204,0.029054594870878546,651,Your next class in exotic dancing will need to be postponed.
8689,6752,7,39,190,236,1.2245762711864407,0.03151924798654296,651,You certainly overcame your fear of snakes!
4156,6752,7,39,190,236,1.2245762711864407,0.03151924798654296,651,"I hate to put the squeeze on you, but Medicare doesn't quite cover your bill."
4766,6754,9,37,199,245,1.2244897959183674,0.03185285812136796,651,"Well Mr. Crumples, you seem very constricted. What’s got you so wound up?"
8273,6754,7,41,197,245,1.2244897959183674,0.030784615634990072,651,Have you recently visited South America?
3440,6754,6,43,196,245,1.2244897959183674,0.030236344925290065,651,What I said was 'Boy...a colon stricture'
1866,6754,10,35,200,245,1.2244897959183674,0.03237376369613144,651,"And should I expect any restrictions, Doc?"
5648,6754,4,47,194,245,1.2244897959183674,0.02910883961505839,651,So you have shortness of breath and feel like the world is constricting around you...anti-depressants will fix you. Next in line.
7918,6759,5,49,209,263,1.2243346007604563,0.028447849792658027,651,"You may have a warm feeling, but it isn't fuzzy."
4620,6760,9,30,175,214,1.2242990654205608,0.03481009136809453,651,"Hmm...W59.13XA is the ICD-10 for non-venomous snake crush injury, initial encounter.... So what seems to be the problem?"
8235,6760,7,34,173,214,1.2242990654205608,0.03352593806438715,651,Your blood pressure's a bit high; let's recheck it after you lose some weight.
540,6762,9,43,220,272,1.224264705882353,0.029768263528933078,651,Did you think it would regurgitate you at your original weight?
3803,6763,7,36,180,223,1.2242152466367713,0.03265455550015907,651,"Here's a prescription for two mongoose, to be applied daily.
Call my office if there is no improvement within a week."
1203,6763,9,32,182,223,1.2242152466367713,0.03386913465073005,651,"I think that you misunderstood. I did not say python. 
I asked you to put your clothes on."
2353,6763,10,30,183,223,1.2242152466367713,0.03446037471542409,651,Your bowel movements- how have they been lately?
7193,6763,12,26,185,223,1.2242152466367713,0.035613420400233305,651,"So, you’re saying this happened when you played a pan flute?"
6265,6767,9,34,189,232,1.2241379310344827,0.03299523288423523,651,Please don’t bring pets into the exam room.
4929,6767,8,36,188,232,1.2241379310344827,0.03242478049653804,651,It’s most likely just a phase.
5834,6767,7,38,187,232,1.2241379310344827,0.03184411071787732,651,So these results tell me that you are not currently breathing.
6690,6770,11,32,198,241,1.2240663900414939,0.03323821532696518,651,"Breathing problem could be the service snake, but we'll run tests"
5121,6770,9,36,196,241,1.2240663900414939,0.03218109172944603,651,Don't breathe deeply for me!
5926,6770,9,36,196,241,1.2240663900414939,0.03218109172944603,651,Your blood vessels are constricted.
7628,6770,6,42,193,241,1.2240663900414939,0.0305268443351912,651,"and, let me guess... you do not feel any tightness in your legs."
7356,6774,7,42,201,250,1.224,0.03038071677573176,651,I’m prescribing you clothes. He abhors your naturism.
5484,6774,9,38,203,250,1.224,0.03142045480128636,651,Actually I recommended you restrict your diet. But this does seem to be working.
8869,6774,7,42,201,250,1.224,0.03038071677573176,651,"Unfortunately, it looks like you have high blood pressure."
4583,6774,7,42,201,250,1.224,0.03038071677573176,651,"Our treatment options are pretty constrictive, but I can at least give you something for the scales."
3558,6774,9,38,203,250,1.224,0.03142045480128636,651,"If you start squeezing today, it should be dead by morning."
2196,6774,9,38,203,250,1.224,0.03142045480128636,651,So you feel like you're being strangled from the neck to the waist?
4482,6774,14,28,208,250,1.224,0.033880489226113655,651,Now that's some healthy gut flora.
5908,6781,8,42,209,259,1.223938223938224,0.030216656783714584,651,So the nurse tells me you've been experiencing a tight feeling in your chest lately. We think we might know why.
4369,6781,8,42,209,259,1.223938223938224,0.030216656783714584,651,Says here you may have a pet allergy.
3693,6783,11,38,219,268,1.2238805970149254,0.030955303499303265,651,When they told me that you were having a problem removing a boa this is not what I expected
3250,6783,7,46,215,268,1.2238805970149254,0.02909347464486311,651,I’m recommending some additional salt in your diet for the low blood pressure and I’ll prescribe a bat and a mouse for your pet so that he leaves you alone.
6081,6785,10,42,225,277,1.2238267148014441,0.0298505020596976,651,It's a preventive measure. Spread of STIs has dropped drastically since we implemented this method of male birth control.
556,6786,6,39,183,228,1.2236842105263157,0.03157266727877912,651,And how much gluten would you say you eat?
131,6787,10,33,194,237,1.2236286919831223,0.03306433672986348,651,"So,What DO YOU RATE YOUR PAIN, BETWEEN 1 AND 10?"
797,6787,7,39,191,237,1.2236286919831223,0.03140027461709545,651,I'm sorry but we had to tighten our billing policy.
5349,6787,7,39,191,237,1.2236286919831223,0.03140027461709545,651,"Unfortunately, you're health insurance plan doesn't cover boa constriction..."
7369,6787,8,37,192,237,1.2236286919831223,0.03196458902934004,651,You should start to feel less squeezed in a day or two.
4881,6791,9,37,200,246,1.2235772357723578,0.031736233533198925,651,"Tight chest, huh? Well, you're not alone."
2345,6791,10,35,201,246,1.2235772357723578,0.032254806218348,651,"You should go to the zoo, we deal with constriction here not constrictors​"
8605,6791,5,45,196,246,1.2235772357723578,0.029571142988325236,651,Can we just start with the snake oil?
9123,6791,11,33,202,246,1.2235772357723578,0.03276517250820788,651,We see a lot of these cases during polar vortex season... these suckers latch onto anything warm.
1642,6791,8,39,199,246,1.2235772357723578,0.031209045380535098,651,Take two aspirin and an apple twice a day.
3615,6796,11,35,209,255,1.223529411764706,0.03198415722763406,651,"Given your co-dependency, we should be thankful pre-existing conditions are no longer relevant..."""
1887,6796,8,41,206,255,1.223529411764706,0.030501652974444023,651,To think I was most worried about mosquitoes.
7221,6796,11,35,209,255,1.223529411764706,0.03198415722763406,651,It appears that you have the case of the coils
2605,6796,12,33,210,255,1.223529411764706,0.03246328397885142,651,Sorry... you're only covered for snake bits.
7967,6800,4,42,178,224,1.2232142857142858,0.030621657250102376,651,"At any time recently, have you felt more stress than usual?"
1725,6801,11,30,192,233,1.2231759656652361,0.03397444874543236,651,I see we get around the fact that you brought your own scales.
4914,6801,7,38,188,233,1.2231759656652361,0.03172173537756422,651,"Just because the hugs are free, doesn't mean their good."
3701,6803,5,44,193,242,1.2231404958677685,0.029845461509285597,651,"Your vital signs are good, but I'm concerned about your exposure to an animal rights activist."
8787,6803,10,34,198,242,1.2231404958677685,0.03259161635644096,651,"According to your chart, Mr. Smythe-Fisk, there is no apparent reason for this tight feeling in your torso."
6997,6803,8,38,196,242,1.2231404958677685,0.03152187657986366,651,Looks like you have a history of holding on to things.
3578,6803,8,38,196,242,1.2231404958677685,0.03152187657986366,651,And how is your stool?  Well formed?
3903,6803,8,38,196,242,1.2231404958677685,0.03152187657986366,651,Problem? Heavens No! Boa is my support serpent!
4368,6808,12,32,207,251,1.2231075697211156,0.03279927510996127,651,"I'm sorry, Mr. Barrett, but your lung capacity seems to have declined since your last appointment."
1994,6808,8,40,203,251,1.2231075697211156,0.030794519121075548,651,I’d recommend cutting back on the kundalini yoga.
1556,6808,9,38,204,251,1.2231075697211156,0.031307745333358755,651,"Runny nose, persistent cough and tightness in the chest?  Probably just a seasonal cold."
5449,6808,9,38,204,251,1.2231075697211156,0.031307745333358755,651,So--how long have you been feeling pressure in your chest?
5565,6808,7,42,202,251,1.2231075697211156,0.0302725931815913,651,"We're trying out a new, natural, compression treatment."
5913,6813,10,38,212,260,1.2230769230769232,0.03108319179747567,651,Whatever happened to pretending you have a headache?
328,6813,11,36,213,260,1.2230769230769232,0.03155732628120907,651,Whatever's wrong... We'll try to squeeze it out of you.
6870,6815,7,46,216,269,1.2230483271375465,0.028997064993276707,651,"While this technique will shave pounds off your stomach it does have serious side effects including naseousness and dry, scaly skin."
6061,6816,15,19,186,220,1.2227272727272727,0.03759210734431112,651,"Before we rule out a heart attack as the cause of the pressure you feel on your chest, my accountant recommends an expensive battery of tests."
374,6817,10,31,188,229,1.222707423580786,0.033797972507723054,651,It's time you had a colonoscopy so we can diagnose that bowel constriction.
5706,6817,8,35,186,229,1.222707423580786,0.03264494148879638,651,You need anti-lock snakes. They're now a generic.
6104,6817,5,41,183,229,1.222707423580786,0.030834657344749977,651,I feel reasonably certain that your present attire is the root cause of the high blood pressure
6071,6817,7,37,185,229,1.222707423580786,0.03205287560257281,651,So just when did this feeling of abdominal pressure begin?
9008,6817,7,37,185,229,1.222707423580786,0.03205287560257281,651,"It's true, your skin does seem quite scaly."
1456,6822,12,29,197,238,1.2226890756302522,0.03399795149944861,651,"So, how was your Ayahuasca Ceremony?"
1981,6822,12,29,197,238,1.2226890756302522,0.03399795149944861,651,"Yes, I'm afraid choking is one of the side effects of that specific drug."
2233,6822,10,33,195,238,1.2226890756302522,0.03293852249923792,651,I’ve seen this before with teenagers. Try giving him his iPhone back.
4062,6822,12,29,197,238,1.2226890756302522,0.03399795149944861,651,Get two baboons and call me in the morning.
9113,6822,8,37,193,238,1.2226890756302522,0.03184386632786202,651,"No, I don't think your python has an attachment disorder."
2138,6822,10,33,195,238,1.2226890756302522,0.03293852249923792,651,"When did you notice the first time chest tightness?"""
2198,6828,8,39,200,247,1.222672064777328,0.031095613386317854,651,I think you can still shed a few pounds
2380,6828,10,35,202,247,1.222672064777328,0.032136704711150745,651,You can get dressed now.  It's a wrap.
3614,6828,12,31,204,247,1.222672064777328,0.033145111366716606,651,"I'm writing you a scrip for snake oil, so you can slither right out of there."
4989,6828,6,43,198,247,1.222672064777328,0.03001843690219399,651,It says here you've been too wrapped up to focus on your health.
2933,6832,7,43,206,256,1.22265625,0.029886579343357676,651,Your blood tests are fine. But I'm waiting to see the snake's report on your pulmonary and cardiac function.
5992,6833,10,41,223,274,1.2226277372262773,0.030021807005481908,651,You're constricted emotionally and physically. Your blood pressure is up and so is your weight!
3542,6834,11,36,214,261,1.2222222222222223,0.03144780131193613,651,All vital signs are normal. But move? You're dead.
2955,6834,7,40,196,243,1.2222222222222223,0.030859095588928215,651,"I was standing at the Tree of Knowledge  of Good and Evil, just minding my own business, then this happens."
2835,6834,5,42,187,234,1.2222222222222223,0.030417308497909634,651,A weighted blanket would be easier to use.
2449,6834,11,34,207,252,1.2222222222222223,0.03219345739589493,651,"No, shortness of breath is not a symptom of herpes."
1837,6834,10,34,199,243,1.2222222222222223,0.03247020458246786,651,"If symptoms persist in 48 hours, we'll run some tests."
1353,6834,10,36,206,252,1.2222222222222223,0.031698566932424524,651,How long have you had this tight feeling around your chest?
760,6834,7,42,203,252,1.2222222222222223,0.03016521978991178,651,"As the nurse explained, Mr. Silverstein, it’s a new experimental blood pressure device."
671,6834,9,34,191,234,1.2222222222222223,0.03274053171102558,651,Have you tried using a moisturizer?
8515,6834,8,40,204,252,1.2222222222222223,0.030684850309323483,651,"Yeah, got it: shortness of breath, weight gain, tingling toes..  Let's try life without potato chips and see you back here in six months."
4401,6834,12,28,194,234,1.2222222222222223,0.0343800776187085,651,"Besides looser clothing, I would suggest another change."
4513,6834,12,36,222,270,1.2222222222222223,0.031192435162742428,651,You say you're feeling a bit woumd-up?
5701,6834,9,38,205,252,1.2222222222222223,0.031195826516338586,651,I'm afraid the x-rays don't shed much light on your shortness of breath.
8912,6834,9,30,177,216,1.2222222222222223,0.03451813406165632,651,Hmm-you seemed to have gained some weight since your last visit.
8533,6834,10,26,171,207,1.2222222222222223,0.03616694460205838,651,"You've caught homo-non-sapiens. In a few weeks you'll be as good as new, Ms Snake."
7784,6834,8,38,197,243,1.2222222222222223,0.03140531667706672,651,‘And the pain started when?’
205,6834,9,38,205,252,1.2222222222222223,0.031195826516338586,651,"So how is the new ""Constrictor Diet"" going?"
4414,6834,11,24,172,207,1.2222222222222223,0.036809645436132084,651,No Mr Bartholemew I really wouldn’t  classify this as a severe case of “worms”
3198,6851,10,39,217,266,1.2218045112781954,0.03057901857943927,651,"Your date of birth, please."
6652,6852,8,41,208,257,1.2217898832684826,0.03028871104463086,651,"I'm sorry, sir. Marriage counseling isn't my field."
363,6853,4,47,197,248,1.221774193548387,0.02879836823006624,651,You'll have to take off your scarf for me to examine you.
5800,6853,7,41,200,248,1.221774193548387,0.030451528719035052,651,At least you can get a hug.
1153,6853,8,39,201,248,1.221774193548387,0.03098298668942025,651,This should ease your stiff neck.
8341,6853,10,35,203,248,1.221774193548387,0.03201945018169338,651,"OK...so that's 20 minutes, 3 times a day."
7554,6853,9,37,202,248,1.221774193548387,0.031505480905191216,651,This is a first for me.  Has it happened before?
9053,6853,8,39,201,248,1.221774193548387,0.03098298668942025,651,"Sorry, I only have a snake bite kit."
6809,6853,7,41,200,248,1.221774193548387,0.030451528719035052,651,I'm going to recommend a few yoga studios that allow you to bring pets.
2114,6853,10,35,203,248,1.221774193548387,0.03201945018169338,651,I'm going to prescribe a course of ladders.
3634,6853,12,31,205,248,1.221774193548387,0.03302339951729828,651,You should find another job and resign from that snake pit
6643,6862,13,27,199,239,1.2217573221757323,0.034383381216047885,651,You're a syltherin aren't ya
8652,6862,6,41,192,239,1.2217573221757323,0.030595642660744268,651,"Alright, we're going to start compressions."
6096,6862,6,41,192,239,1.2217573221757323,0.030595642660744268,651,So you ordered a feather boa and instead were sent a boa constrictor?
2451,6865,9,33,188,230,1.2217391304347827,0.033095848499796965,651,You are practically dead.
1248,6866,7,33,172,212,1.221698113207547,0.033626453396720095,651,If you’re cold I can turn up the heat
2262,6867,10,25,168,203,1.2216748768472907,0.03663151360047726,651,Your test results show that it is time to add the second snake. Follow-up tests will show if we need to add the winged hat.
1150,6868,12,36,223,271,1.2214022140221403,0.03108793735680024,651,"It looks like a textbook case of MCS: Mortal Coils Syndrome."""
877,6869,16,26,220,262,1.2213740458015268,0.03359124260003402,651,Please disrobe . . . that includes the boa.
1425,6869,9,40,213,262,1.2213740458015268,0.030391435305627063,651,Boy is your face red
3504,6869,7,44,211,262,1.2213740458015268,0.029413337355201772,651,"Uh Doctor , Is this a new way to take blood pressure?"
5242,6869,8,42,212,262,1.2213740458015268,0.029906385223786434,651,So Brittany needs her snake back by the nine o'clock show.
5539,6873,10,36,207,253,1.2213438735177866,0.03158524284798869,651,"Of course it's not fun being terminated, but at least they came through with your COBRA insurance!"
1781,6873,12,32,209,253,1.2213438735177866,0.032563273160731196,651,"So despite all the PSAs and my recommendations, you just went out and caught a case of Herpetology.."
6820,6873,14,28,211,253,1.2213438735177866,0.03351277296963611,651,That's supposed to be worn open in the back.
1520,6876,8,38,198,244,1.221311475409836,0.03128959889461427,651,"I know you like a boa as a fashion accessory, but let me explain something."
8919,6876,9,36,199,244,1.221311475409836,0.03182405320520245,651,so you say your chest feels constricted and you're having trouble breathing.
9055,6876,14,26,204,244,1.221311475409836,0.03437189519820087,651,I'm gonna recommend that you consider a gluten free diet.
8465,6876,13,28,203,244,1.221311475409836,0.03387765954274874,651,"Actually, I'm so lonely I envy you."
8628,6880,12,28,195,235,1.221276595744681,0.03424652477813568,651,There is a less intrusive way to check your blood pressure
8801,6880,6,40,189,235,1.221276595744681,0.03089664973038698,651,And how's the new weight-loss supplement working for you
6944,6880,9,34,192,235,1.221276595744681,0.032614624204041376,651,"That's a very creative tourniquet, but where's the cut?"
6118,6880,11,30,194,235,1.221276595744681,0.033711336524131684,651,And when did you last see the snake oil salesman?
1854,6880,8,36,191,235,1.221276595744681,0.03205219903274399,651,Have you noticed anything unusual beside the apple-craving?
3990,6885,6,38,182,226,1.2212389380530972,0.03165014414395671,651,Just a mild sedative to ease the tension.
5975,6886,13,33,221,267,1.2209737827715357,0.031831478677320446,651,I see you've changed your health insurance.
2656,6887,10,35,204,249,1.2208835341365463,0.031903033758591756,651,"Don't worry, we have a drug for everything."
2339,6887,7,41,201,249,1.2208835341365463,0.030342061862598357,651,I'm prescribing a special oil.
6069,6887,9,37,203,249,1.2208835341365463,0.03139133555658013,651,I believe we've figured out your tightening of the chest problem.
8242,6890,7,39,194,240,1.2208333333333334,0.031048572121377554,651,I’ve never treated a boa constrictor for mandigestion.
3598,6890,11,31,198,240,1.2208333333333334,0.03321872731944114,651,you said you needed a hug?
1856,6892,8,35,188,231,1.2207792207792207,0.0323902713329716,651,"So, you ate the apple, realized you were naked, and grabbed a really fancy coat. Problem?"
3500,6892,10,31,190,231,1.2207792207792207,0.033532323343787154,651,"Sorry,  you’re gonna have to cancel the act."
9097,6894,7,33,173,213,1.2206572769953052,0.03348439108585893,651,I know you wanted to be in Slytherin
7338,6895,8,44,220,272,1.2205882352941178,0.029180226026891517,651,Don't worry the bite is not poisonous.
6730,6895,6,33,165,204,1.2205882352941178,0.03371516411657275,651,"Yes, the symptoms clearly indicate that one or both of you is experiencing a heart attack."
5364,6897,10,38,215,263,1.220532319391635,0.03076278626188926,651,"So I have always wanted to say this to a patient, but it's 
usually inappropriate....Your snake is showing!"
6810,6898,10,36,208,254,1.220472440944882,0.03147271239235706,651,I suggest you buy insurance that will cover a back brace which doesn't require feeding.
5758,6899,10,34,201,245,1.220408163265306,0.0322300299011413,651,How long have you been feeling this way?
541,6899,8,38,199,245,1.220408163265306,0.031174714380769245,651,"I know exactly whay you need but, unfortunately, the FDA doesn't let us use snake oil anymore."
8969,6899,8,38,199,245,1.220408163265306,0.031174714380769245,651,Maybe your wallet wasn’t dead.
7822,6899,8,38,199,245,1.220408163265306,0.031174714380769245,651,"You'll find that this boutique has a more suitable selection of boas."""
1913,6903,16,20,200,236,1.2203389830508475,0.03616645536063735,651,Here's a prescription for an addictive amount of opiates.
511,6903,8,36,192,236,1.2203389830508475,0.031929865014838014,651,"So I see in your chart that your anaconda does, in fact, want some."
1002,6903,5,42,189,236,1.2203389830508475,0.030188246053854752,651,And what did you say this weight loss approach is called?
5102,6903,10,32,194,236,1.2203389830508475,0.0330399808298609,651,A good laxative should relieve you of feeling constricted and bound up.
6110,6903,9,34,193,236,1.2203389830508475,0.03248966461125255,651,"The backless gowns were terrible but, believe it or not, we’ve gotten a fair number of complaints about the anacondas too. Guess there’s no pleasing some people..."
3052,6903,6,40,190,236,1.2203389830508475,0.03077973727136047,651,"Sorry Pal, 'Emotional Support Person' won't hack it."
5534,6903,10,32,194,236,1.2203389830508475,0.0330399808298609,651,Well I can see you’re all wrapped up in this snake business
1921,6910,6,38,183,227,1.2202643171806167,0.03152547669566684,651,We’re going to have to send you to a specialist.
5673,6910,9,32,186,227,1.2202643171806167,0.03332881914479878,651,I’m going to have to refer you to a pulmonologist.
5404,6910,5,40,182,227,1.2202643171806167,0.03090098454725689,651,"Normally when someone reports those symptoms I would do an EKG, but as a practical matter..."
8004,6910,9,32,186,227,1.2202643171806167,0.03332881914479878,651,Looks like you’re up to your neck in his anxiety.
3484,6914,7,34,177,218,1.2201834862385321,0.03297275108150708,651,We’re gonna have to constrict your diet.
1731,6915,11,37,220,268,1.2201492537313432,0.03082954903702816,651,"Your iron levels are fine--that rules out anemia.  X-rays negative for pneumonia, emphysema, asthma and lung cancer.  Allergy tests all negative.  Stress test shows heart function is normal.  So what could be causing your shortness of breath?"
2684,6916,10,37,212,259,1.22007722007722,0.031057792746934727,651,"Well, at least you'll lose some weight when it sheds its skin."
5840,6917,9,37,204,250,1.22,0.03127799950463661,651,"I'll go ahead and write you a prescription for your anxiety, but we'll need to refer you to a specialist for the tension in your neck."
8295,6917,7,41,202,250,1.22,0.03023336277855307,651,"So, you were reading your daughter The Jungle Book and then what did you say happened again?"
5684,6917,6,43,201,250,1.22,0.02969726773363794,651,I find myself with something of a Sophie's choice.
1178,6917,12,31,207,250,1.22,0.03278259896928129,651,"I think you have an unusual
 
case of 'full Monty."""
1904,6917,10,35,205,250,1.22,0.03178744668997925,651,This diet may feel a little constricting....
4490,6917,8,39,203,250,1.22,0.03076011604262609,651,"Heh, heh, I can see how it would be hard to change your shirt!"
3951,6923,13,27,201,241,1.2199170124481329,0.03412216639709238,651,"Well there is medicaid and Obamacare, then there is Frappaccinocare and Elon Musk Mars Care but the most expensive is the republican program of I don’t care. However I have determined that this is a preexisting condition so its not covered."
2116,6923,7,39,195,241,1.2199170124481329,0.030933046406114138,651,Despite your predicament we still need to check your prostate. Please roll to your side and cough to constrict.
3594,6923,8,37,196,241,1.2199170124481329,0.03148700536053171,651,For your legs I'd suggest rattlers.
2078,6923,8,37,196,241,1.2199170124481329,0.03148700536053171,651,This script for a tank should help with the constriction.
7851,6923,10,33,198,241,1.2199170124481329,0.03256666700472794,651,"Not to worry, what you have is simply a variation on the constricted bowel syndrome."
129,6928,7,37,188,232,1.2198275862068966,0.0316807837843837,651,I'm not optimistic about your prospects if you're going to stick with not endangering its life in order to save yours.
4001,6928,10,31,191,232,1.2198275862068966,0.033401033961564755,651,"...""and the next thing you know he's tweeting that he's responsible for the economic growth. Like, open your eyes, man!"""
5922,6928,9,33,190,232,1.2198275862068966,0.03283763187054386,651,I said  prescription  not  constriction !
6368,6928,11,29,192,232,1.2198275862068966,0.033955089052126575,651,"I'm pretty sure it's a tapeworm, but we'll need  more tests."
6812,6928,5,41,186,232,1.2198275862068966,0.030480059965826527,651,I think we are all feeling a bit suffocated and squeezed... It's Normal!
8767,6928,9,33,190,232,1.2198275862068966,0.03283763187054386,651,Thank you for not putting on your gown.
7008,6934,10,29,184,223,1.2197309417040358,0.03429701702264149,651,And how long have you had this condition?
1926,6934,9,31,183,223,1.2197309417040358,0.03370291134476669,651,It's called the Garden of Eden Curse
5680,6934,8,33,182,223,1.2197309417040358,0.03309814329498025,651,"Is it ""bow tie"" or ""boa tie""?"
2904,6937,9,40,215,264,1.2196969696969697,0.03018397513706769,651,Does anything make the pain better or worse?
4675,6938,5,37,172,214,1.219626168224299,0.03200054917501381,651,Breathing medications are apparently ineffective. Let's try a slippery body lotion.
5746,6939,14,28,213,255,1.219607843137255,0.03327197396798572,651,"If you're having trouble with your asp, you need to consult a proctologist."
2420,6939,6,44,205,255,1.219607843137255,0.02932569362675054,651,You have seriously elevated blood pressure.
405,6939,8,40,207,255,1.219607843137255,0.03036039019757664,651,"Before we remove the snake, you'll need to spend some time in the decompression chamber."
3400,6939,7,42,206,255,1.219607843137255,0.029847525857591154,651,So... you feel squeezed?
8823,6939,12,32,211,255,1.219607843137255,0.03233059333614601,651,Sorry - it's 'Board Certified' not 'boa certified'
6663,6939,15,26,214,255,1.219607843137255,0.033732814066660004,651,I got tied up.
5015,6939,4,48,203,255,1.219607843137255,0.02825312939182077,651,"Mr. Harper, once you remove the external  burden, your blood pressure should return to normal."
3683,6946,9,36,201,246,1.2195121951219512,0.0315903190429077,651,"I am sorry to tell you this, but the test results show you are significantly overweight."
4743,6946,8,38,200,246,1.2195121951219512,0.03106065440268855,651,"So I’m going to prescribe that the snake 
start taking Viagra right away."
7569,6948,13,35,230,278,1.2194244604316546,0.030918697767985635,651,It says you have pythonitis but to me it looks more like strangulosis.
5483,6949,10,32,195,237,1.219409282700422,0.032913409444606176,651,"Yeah, but how many drinks per week do you have?"
5919,6949,7,38,192,237,1.219409282700422,0.031241309254118985,651,I'm pretty sure that your insurance company will consider this a preexisting condition.
6175,6949,11,30,196,237,1.219409282700422,0.03345220810430737,651,I'm going to recommend relationship counseling
5554,6952,7,36,185,228,1.219298245614035,0.03201115126851198,651,It is cold in here but that’s the wrong kind of boa
4345,6953,9,39,212,260,1.2192307692307693,0.030466096625062736,651,I know I look young- but let’s take off the snake pool float and get started.
6654,6953,8,41,211,260,1.2192307692307693,0.029974706234884595,651,Slither down to the pharmacy and give them this.
8850,6955,8,32,179,219,1.2191780821917808,0.03346903342205919,651,"So, Mr. Warrer, I understand you have shortness of breath."
907,6955,5,38,176,219,1.2191780821917808,0.031535705039890956,651,This is my therapy animal
8859,6955,8,32,179,219,1.2191780821917808,0.03346903342205919,651,Are you ready to produce a stool sample for your last test?
4545,6958,9,37,205,251,1.2191235059760956,0.031165464380637622,651,just back from Miami I assume
6048,6958,10,35,206,251,1.2191235059760956,0.031672680341596475,651,So you say you first started feeling chest constrictions during a jungle visit?
6177,6958,6,43,202,251,1.2191235059760956,0.029591698839037853,651,It appears to be some kind of a sssssssssssss-cyst.
1134,6961,13,27,202,242,1.21900826446281,0.033993022294045876,651,Uhmmm...nothing a little exercise and dieting couldn’t cure.
4441,6961,10,33,199,242,1.21900826446281,0.0324445439830735,651,I'm going to prescribe some Oxycontin for the pain and put you on statins.
8651,6961,8,37,197,242,1.21900826446281,0.031369789298946814,651,I prescribe feeding it a lot of mice
3270,6961,9,35,198,242,1.21900826446281,0.03191169154816075,651,"No, my plan doesn’t cover snakes."
1907,6961,6,41,195,242,1.21900826446281,0.030256882308840834,651,"I’m prescribing an anti-anxiety medication, not for you, but for your serpentine friend."
369,6966,7,37,189,233,1.2188841201716738,0.031558627640104996,651,This seems to be going around here in New York
436,6966,7,37,189,233,1.2188841201716738,0.031558627640104996,651,"I know it's cold in here, but I do need you to remove all your clothes."
2202,6968,5,48,212,265,1.2188679245283018,0.028116411496586398,651,She really is attached to you!
5616,6969,10,36,210,256,1.21875,0.03125,651,"Most people submitting a caption for this cartoon are saying ""You shouldn't get so wrapped up in your work as a snake charmer."""
7762,6969,12,25,187,224,1.21875,0.035310366028563175,651,When I suggested you get a cuddly pet I was thinking more of a Bichon Frise.
7635,6969,12,32,212,256,1.21875,0.03221547779878364,651,I'll refer you to hospice.
7520,6969,8,33,183,224,1.21875,0.03296465078646237,651,I think we'll check your PSA and his PSI today.
5659,6969,8,40,208,256,1.21875,0.03025372688109811,651,"So we’ve done a full exam. Cut out the apples, try not to breathe, and
come back in a week."
7427,6974,10,34,203,247,1.2186234817813766,0.03199332469210481,651,Looks like you took quite a fall.
3427,6974,10,34,203,247,1.2186234817813766,0.03199332469210481,651,"Your surgery is scheduled for Tuesday. In the meantime, this should help relieve the constriction."
4560,6974,6,42,199,247,1.2186234817813766,0.02986488890342214,651,All we know is it's not an elephant. I'll just double the potency of your inhaler.
6823,6977,9,29,177,215,1.2186046511627906,0.03448808462023708,651,OK. I’ll give you the needle in your asp.
3754,6978,5,42,191,238,1.218487394957983,0.0299625265200509,651,"It’s not a benefit under your bronze plan, but there is wraparound coverage available"
7716,6979,9,39,213,261,1.2183908045977012,0.03036076531328963,651,I'm afraid the constriction you're feeling is psychosomatic.
8192,6979,10,37,214,261,1.2183908045977012,0.030842316931031587,651,"Congratulations,no asthma! We're still working on what's constriction your chest,though."
4475,6981,6,38,185,229,1.2183406113537119,0.03127900306833069,651,"Sigh...."" More and more people are turning into what they really are."""
444,6981,9,32,188,229,1.2183406113537119,0.03306496853449942,651,Extra fiber and prune juice should help unbind you.
1304,6981,7,36,186,229,1.2183406113537119,0.031885441871825654,651,"No, that Boa doesn't make your butt look bigger."
1474,6981,8,34,187,229,1.2183406113537119,0.032480559936283494,651,You're just feeling the deductible.
1880,6981,9,32,188,229,1.2183406113537119,0.03306496853449942,651,"I see, so you're feeling constricted. Is it possible the problem has emotional roots?"
3085,6981,9,32,188,229,1.2183406113537119,0.03306496853449942,651,You just get too wrapped up in her.
2559,6987,6,43,203,252,1.2182539682539681,0.029486861225263953,651,Where do I send the snake's bill?
3090,6987,6,43,203,252,1.2182539682539681,0.029486861225263953,651,"Ok, let’s wrap this up."
4627,6987,9,37,206,252,1.2182539682539681,0.031053721926907366,651,"Look, a lot of people feel up-tight, you just have to relax."
5671,6987,8,39,205,252,1.2182539682539681,0.030540368235857655,651,"Long story short.... Mamba Italiano, Am I right?"
8276,6987,7,41,204,252,1.2182539682539681,0.03001823676450499,651,I’m writing a prescription to fix that sense of constriction.
7228,6987,6,43,203,252,1.2182539682539681,0.029486861225263953,651,It appears you put on some weight since your last visit.
3079,6993,5,50,220,275,1.2181818181818183,0.027482054447285097,651,We’ve had a problem with patients taking medical supplies-
3575,6994,6,41,196,243,1.2181069958847737,0.030145586843132482,651,Side effects may include . . . .
3334,6994,6,41,196,243,1.2181069958847737,0.030145586843132482,651,"Tell me, are you warm or cold now?"
846,6994,5,43,195,243,1.2181069958847737,0.02957610980329574,651,"No, a laxative won't help that constricted feeling..."
2098,6994,10,33,200,243,1.2181069958847737,0.03232331892299716,651,"Oh this?  This is nothing.  Last week, I had a guy who was attacked from behind by a gerbil."
9018,6994,9,35,199,243,1.2181069958847737,0.031792873591066764,651,"So Bob, where are you actually feeling the tightness?"
2928,6999,9,40,217,266,1.218045112781955,0.029979276773671775,651,"I regret to inform you, Sir-your insurance does not cover poor fashion choices."
8115,7000,11,29,194,234,1.2179487179487178,0.033690345040847225,651,"So, you think you might have a touch of ringworm?"
5572,7000,9,33,192,234,1.2179487179487178,0.03258334649386871,651,And when did these feelings constriction begin?
1399,7002,11,34,212,257,1.2178988326848248,0.031624138095955136,651,"Sorry, hard to diagnose the problem if we can't get your blood pressure."
7890,7002,7,42,208,257,1.2178988326848248,0.029639345127258482,651,"My diagnosis is ""acute acid recoil""."
1259,7002,7,42,208,257,1.2178988326848248,0.029639345127258482,651,the good news it's not a sore throat...
5023,7005,8,45,227,280,1.2178571428571427,0.028557824462216583,651,So you've got two more weeks of boa and then we'll advance you to the gecko stage.
9057,7006,8,33,184,225,1.2177777777777778,0.03283221199707403,651,I’m prescribing something to lower your blood pressure.
9220,7006,9,31,185,225,1.2177777777777778,0.033431073633722136,651,I'm thinking we should switch you back to C++.
1233,7008,11,32,205,248,1.217741935483871,0.032384335596772514,651,Your BMI is a bit high. Those extra rolls are constricting your heart and lungs.
3874,7008,10,34,204,248,1.217741935483871,0.031876250237030876,651,"Well, according to the snake oil salesman in the White House ... """
4836,7008,8,38,202,248,1.217741935483871,0.030834973705723495,651,He needs regular feedings and a vitamin supplement. This will keep him relaxed and you warm.
9117,7008,9,36,203,248,1.217741935483871,0.031359934092775696,651,"Sir, I'm afraid we won't be able to cure your lisp problem."
601,7012,11,37,223,271,1.2177121771217712,0.030519841564487785,651,"Ok, let’s have you slither down the table and we’ll see if we can find that mouse."
6617,7013,5,37,174,216,1.2175925925925926,0.031736000578736996,651,I recommend we give it a heavy dose of muscle relaxers.
978,7014,12,28,199,239,1.217573221757322,0.033722391444880866,651,My diagnosis is that you’re all choked up.
5566,7014,10,32,197,239,1.217573221757322,0.032663108690483084,651,She says she has separation anxiety.
1033,7014,10,32,197,239,1.217573221757322,0.032663108690483084,651,"It's related to a CAT Scan, but this replaces a standard colonoscopy. Now we can get started if you would just open your mouth."
1373,7014,6,40,193,239,1.217573221757322,0.030434136072104722,651,"As a herpetologist, it seems you are all wrapped up in your work."
4162,7014,10,32,197,239,1.217573221757322,0.032663108690483084,651,And this hyperthermia began just after you adopted the boa?
2247,7019,13,31,218,262,1.217557251908397,0.03213135965178214,651,Crikey!
7519,7019,6,45,211,262,1.217557251908397,0.028769637355968672,651,"Yes, it's a bit cold in here. Why?"
2850,7021,5,40,185,230,1.2173913043478262,0.0305417307765428,651,Mind if I get a second opinion?
5782,7021,7,36,187,230,1.2173913043478262,0.031760697084567864,651,Some of these drugs do constrict your movement.
7724,7021,10,35,208,253,1.2173913043478262,0.031445575845291965,651,I prefer you leave your pets at home next time.
8076,7021,9,32,189,230,1.2173913043478262,0.03293457817808714,651,"For such a large meal, I'd like him to take two of these to prevent any digestive problems."
2615,7025,8,37,199,244,1.2172131147540983,0.031137908302181765,651,I'm going to prescribe you an inhaler.
4687,7025,4,45,195,244,1.2172131147540983,0.028890203871697443,651,"I can recommend a specialist, but it will take a few weeks to get you in."
7594,7027,9,38,211,258,1.2170542635658914,0.030540472101202032,651,"Ironically, I've found snake oil to do wonders for shortness of breath."
8688,7028,12,27,196,235,1.2170212765957447,0.034097064920866775,651,"So, when did you first notice this feeling of chest constriction?"
7807,7028,5,41,189,235,1.2170212765957447,0.030133338551583656,651,What you’ve got there is a real snake in the ass.
2658,7028,11,29,195,235,1.2170212765957447,0.033559493248283674,651,Please remember that this weight loss technique is not FDA approved not do we do unwrapping
6975,7031,6,34,172,212,1.2169811320754718,0.03276399118553479,651,"Mr. Miller, I see from your chart that you have high blood pressure and an almost incapacitating fear of snakes. I wonder if there is any connection."
1975,7031,6,34,172,212,1.2169811320754718,0.03276399118553479,651,My educated guess is that your lifestyle choices have become a bit too confining.
7344,7031,10,26,176,212,1.2169811320754718,0.03538816193206409,651,It's more common to find one in a boot.
8904,7034,12,35,225,272,1.2169117647058822,0.030860736178434597,651,So what's with the Boa...
7021,7035,9,36,204,249,1.216867469879518,0.031245975677269514,651,"So, I think if you would let your snake straighten out and stretch a little, he'll be just fine."
7438,7035,9,36,204,249,1.216867469879518,0.031245975677269514,651,I'm referring you to a specialist. Check with your insurance to see if they cover Herpetology.
1782,7035,5,44,200,249,1.216867469879518,0.02909915009274988,651,Just be sure to call your primary if that shortness of breath doesn’t improve over the next couple days
2081,7035,8,38,203,249,1.216867469879518,0.030723336098940898,651,The reptile expert at the zoo said it takes about five minutes.
4824,7035,4,46,199,249,1.216867469879518,0.028537219926691393,651,"Yes, we can do the snakescan right in the office, now."
8173,7035,8,38,203,249,1.216867469879518,0.030723336098940898,651,Be careful what you wish for.
1108,7041,7,35,184,226,1.2168141592920354,0.032093798797164015,651,"Do we have you on statins, yet?"
6692,7041,7,35,184,226,1.2168141592920354,0.032093798797164015,651,You’re suffering from “Keep your enemies close and your friends closer syndrome.”
4283,7043,9,34,197,240,1.2166666666666666,0.03199909924348239,651,I warned you more than once that Snake Oil was dangerous.
8540,7043,7,38,195,240,1.2166666666666666,0.030890246768530916,651,"There’s nothing physically wrong with you, Harvey. You just seem to be too wrapped up in your problems."
4295,7043,7,38,195,240,1.2166666666666666,0.030890246768530916,651,"I'm know you're uncomfortable,  however your condition is no covered under your current plan."
4065,7043,5,42,193,240,1.2166666666666666,0.02974007966443994,651,"First, I'd suggest watching what you eat."
1329,7043,11,30,199,240,1.2166666666666666,0.03307079314694064,651,"It appears that by finally purging the ""snakes in your head""  you have triggered a new physical symptom."
6611,7048,10,35,209,254,1.2165354330708662,0.03133322100016265,651,I don't think an OTC decongestant will help your breathing
3237,7048,10,35,209,254,1.2165354330708662,0.03133322100016265,651,"I’m Giving you A Month’s Supply of Muscle Relaxers if that Doesn’t Work,Acupuncture!"
3016,7048,8,39,207,254,1.2165354330708662,0.030323679764601926,651,I suspect you have a mild case of ectoconstrictorsis.
8630,7048,9,37,208,254,1.2165354330708662,0.030832582544373103,651,"I have just the oil for this, and all your other ailments."
7781,7052,11,28,192,231,1.2164502164502164,0.033933285921372125,651,Yours is a rare case caused by the Polar Vortex.  I’ve prescribed the steam room to help you both unwind.
9050,7052,9,32,190,231,1.2164502164502164,0.03280519564966533,651,About how long have you been feeling cold-blooded?
2106,7052,6,38,187,231,1.2164502164502164,0.031036274162657872,651,This is awfully extreme for weight loss. I prefer you watch your diet and exercise.
2467,7052,8,34,189,231,1.2164502164502164,0.032226345522079224,651,"It sounds like acid reflux, but we may need to run a few more tests."
6602,7052,9,32,190,231,1.2164502164502164,0.03280519564966533,651,"I don't handle a lot of these, so I'm going to refer you to a herpetologist for another opinion."
3086,7057,9,35,201,245,1.2163265306122448,0.03155782816556166,651,"Sir, I don’t think our first priority here should be posting a photo of you tagged #pythonwrapchallenge."
1825,7057,11,31,203,245,1.2163265306122448,0.03260074430489338,651,"Men are often eager to shed unwanted pounds at your age, Mr.Klipstein. How long have the scales felt like your enemy?"
8085,7059,5,46,208,259,1.2162162162162162,0.028398930176336823,651,Restrain from showering and rigorous movements for the next two days.
6847,7059,6,36,180,222,1.2162162162162162,0.0318026165088947,651,"Jeez... I said ""when's the triathalon"" not ""then try a python!"""
6041,7059,6,44,209,259,1.2162162162162162,0.02892109087930219,651,Your chart says you’ve been experiencing some tightness in your chest but can’t seem to wrap your head around what might be causing it.
3544,7059,12,32,215,259,1.2162162162162162,0.03187492858939873,651,"You’ve got coils, mr. smith. It’s very similar to boils..."
2080,7059,6,36,180,222,1.2162162162162162,0.0318026165088947,651,Have you seen ‘Bohemian Rhapsody’ yet?
2266,7064,10,39,224,273,1.216117216117216,0.029869239432005097,651,"Let’s look on the bright side, he hasn’t spotted Eve yet."
8286,7064,8,43,222,273,1.216117216117216,0.028953475841769393,651,"Yes I am sure, Mr. Smith, it’s in your head."
3379,7066,8,35,193,236,1.2161016949152543,0.03177034362751902,651,"Quite an interesting case, this pythonitis"
1924,7066,5,41,190,236,1.2161016949152543,0.03001947125038913,651,I'm writing you a prescription for high blood pressure.
7326,7066,12,27,197,236,1.2161016949152543,0.033964729366715664,651,125 over 85 is a tad too high - probably just caused by the drive over here. We'll test your pressure again in a few minutes with our new eco-friendly sphygmomanometer and see if drops some.
6603,7069,11,32,207,250,1.216,0.032148250965809054,651,You should have known that's not the kind of boa for a drag ball.
6299,7069,9,36,205,250,1.216,0.031132828526303113,651,So this says you’ve been feeling constructed and have been having difficulty breathing...
3694,7071,7,35,185,227,1.2158590308370043,0.03196637603322789,651,"Perhaps not, however, and don't quote me, I have seen impressive outcomes from a shaman."
6008,7071,9,31,187,227,1.2158590308370043,0.0331635171008169,651,"Mr. Smith, I strongly advise, that until you get a firmer grasp
of haute couture accoutrements, you avoid boas and any other items you're unfamiliar with when cross dressing for play or otherwise."
2019,7073,5,42,194,241,1.2157676348547717,0.02963006205258152,651,It’s recommended you refrain from vigorous activity as long as you’re feeling this ‘tightness around your chest’ and ‘breathing discomfort’ you describe.
3356,7073,8,36,197,241,1.2157676348547717,0.03133169349195566,651,"I'm sorry to break it to you so baldly, but you have Acquired Python Vortex Syndrome."
3365,7075,10,35,210,255,1.2156862745098038,0.031221653477257683,651,"Now,it says here that you were trying to correct your posture?"
2025,7075,10,35,210,255,1.2156862745098038,0.031221653477257683,651,You thought it was just a very affectionate reptile until today.
3274,7075,4,36,164,204,1.2156862745098038,0.03203918412000902,651,I recommend losing some snake
7051,7078,14,30,225,269,1.2156133828996283,0.031928878014855826,651,He needs an immediate diet change.  Let's stop the white mice and try some pound puppies.
4793,7079,6,35,177,218,1.2155963302752293,0.03214027608118404,651,"Yes, this will keep you warn, but a fur might be less constricting."
5131,7079,11,25,182,218,1.2155963302752293,0.03527587025578488,651,I am going to give you a referral to a great snake oil salesman that I know.
6145,7079,8,31,179,218,1.2155963302752293,0.03342982525928046,651,You are keeping her adequately warm for delivering her eggs in about two days
7559,7079,8,31,179,218,1.2155963302752293,0.03342982525928046,651,"I see, so what seems to be ailing your Main Squeeze today?"
6479,7083,10,30,192,232,1.2155172413793103,0.03324293738091141,651,"Excellent news, Mr. Smith. 123 over 65. How did you do it?"
4602,7084,8,37,201,246,1.2154471544715446,0.03090936906427703,651,Just get yourself another pet!
555,7084,6,41,199,246,1.2154471544715446,0.029816456619336983,651,"Sure, we could give you pills but let's see how you do on the 24/7 hugs first."
2514,7084,12,29,205,246,1.2154471544715446,0.032986741536402915,651,"You seem pretty wrapped up in your newest companion animal, Mr. Jefferson."
6052,7087,3,50,207,260,1.2153846153846153,0.027232093115165588,651,Please stop hissing - I only started here last week.
1827,7088,8,29,172,209,1.215311004784689,0.03435583031409476,651,"Your right, it is cold in here."
2493,7089,8,32,183,223,1.2152466367713004,0.03292527719883799,651,Next time I suggest you take your wife shopping with you.
2133,7090,10,31,196,237,1.2151898734177216,0.03275948416497219,651,So you’ve been feeling tightness throughout your torso?
2079,7090,9,33,195,237,1.2151898734177216,0.032209099598862846,651,Took the wrong python class?
4104,7090,10,31,196,237,1.2151898734177216,0.03275948416497219,651,How long have you been ashamed of your body?
5862,7093,7,43,215,265,1.2150943396226415,0.02897614963364897,651,We'll run some tests to determine why you're having high blood pressure.
1335,7094,6,34,174,214,1.2149532710280373,0.03248857716612808,651,"You've been so wrapped up in your work, that what...?"
1898,7095,11,27,190,228,1.2149122807017543,0.03418118479111966,651,"Well, you’re under constriction, but you should be finished soon."
3665,7095,8,33,187,228,1.2149122807017543,0.032441097480431696,651,"So, when did this choking sensation begin?"
5783,7097,10,32,200,242,1.2148760330578512,0.03229460802947404,651,Are you exercising regularly?
6801,7097,8,36,198,242,1.2148760330578512,0.03121469131944278,651,There are easier ways to keep warm.
7880,7097,8,36,198,242,1.2148760330578512,0.03121469131944278,651,the good news is i can prescribe something for the tapeworm
6563,7100,5,45,206,256,1.21484375,0.02854294412215634,651,She must REALLY love you.
3812,7100,11,33,212,256,1.21484375,0.031599417535332894,651,"I agree it's more of a manly approach, but you should have stuck with a girdle."
7471,7100,9,37,210,256,1.21484375,0.030614517451176368,651,"Alright so no cough, no sore throat, and you are sure that you haven't cheated on your wife?"
7556,7100,6,43,207,256,1.21484375,0.02907467822801312,651,"I see you've got Medicare, and for Ana?"
7766,7100,9,37,210,256,1.21484375,0.030614517451176368,651,I'd say this snake has rendered you armless!
4729,7100,10,35,211,256,1.21484375,0.031110865202857073,651,Wow....that is an extremely long penis.
607,7106,11,39,234,284,1.2147887323943662,0.02949033030495492,651,I see this keeps popping up in your medical hisssstory.
8486,7107,7,33,179,219,1.2146118721461188,0.032656156754000666,651,So you've had this gripping chest pain for a day?
3468,7108,10,30,193,233,1.2145922746781115,0.03311287775573892,651,As your veterinarian my advice is that you switch to a diet with a higher fiber content.
6613,7108,12,26,195,233,1.2145922746781115,0.034211986340497824,651,"A restriction of the throat you say. Hmmm, any other symtoms?"
6083,7108,12,26,195,233,1.2145922746781115,0.034211986340497824,651,The test results indicate that your chest is very constricted.
6292,7111,7,39,201,247,1.214574898785425,0.030257208610952623,651,"Well, technically, it is keto friendly. . ."
3690,7111,13,27,207,247,1.214574898785425,0.033361512651373444,651,"Mr. Richards, we went over prevention methods last time you grew the human head and legs."
1095,7111,9,35,203,247,1.214574898785425,0.031326175807893535,651,Here's a prescription for the boa's sore throat.
5342,7111,6,41,200,247,1.214574898785425,0.029708304630465393,651,You seem to be all wrapped up in something.
5730,7111,8,37,202,247,1.214574898785425,0.030796330655402434,651,Just to thorough I'm ordering a cardiac workup.
5753,7116,12,32,217,261,1.21455938697318,0.03165181240547621,651,I’m afraid your insurance doesn’t cover Constrictivitis.
5339,7117,8,29,173,210,1.2142857142857142,0.03420720867040078,651,How long has your skin been feeling this way?
7962,7117,5,41,192,238,1.2142857142857142,0.029794241908332814,651,"Let me guess, you slipped, fell and just LANDED on the snake?"
8905,7117,7,40,205,252,1.2142857142857142,0.029868430114542266,651,So exactly how long have you felt so rattled?
7613,7117,8,38,206,252,1.2142857142857142,0.030393135261752767,651,Glad that you came in today.  We have a narrow treatment window.
5893,7117,7,37,194,238,1.2142857142857142,0.030961448490313126,651,I'm afraid this is the only treatment for impaction that your plan will cover.
7837,7117,13,22,189,224,1.2142857142857142,0.03571428571428572,651,And I see you prefer snakes over ladders...
5305,7117,5,44,203,252,1.2142857142857142,0.028790345785410204,651,"For constrictions like yours, I generally recommend 
Ex-Lax."
7462,7117,9,36,207,252,1.2142857142857142,0.030908934381034616,651,The good news is that we have a treatment for constrictoritis.
3957,7117,6,36,182,224,1.2142857142857142,0.03154744277727862,651,This problem is hard to unwind.
3608,7117,8,35,195,238,1.2142857142857142,0.0315288520799813,651,I’ll refer you to a cardiologist for that squeezing feeling around your heart.
2456,7117,7,37,194,238,1.2142857142857142,0.030961448490313126,651,I suspect your pain is caused by a conscription.
486,7117,6,36,182,224,1.2142857142857142,0.03154744277727862,651,"If you’re feeling contractions, I’m going to recommend you get transferred to our OB.”"
5066,7117,9,27,174,210,1.2142857142857142,0.03486691256250603,651,A possible side effect is you might feel a little tightness around the middle.
5984,7130,10,38,223,271,1.2140221402214022,0.029939284345576904,651,"I know PeTA gets in a snit over fur coats, but you should have known they’d disapprove of this as well."
7300,7131,8,36,199,243,1.213991769547325,0.031098544617464124,651,I think you would sleep better if you wore clothes rather than pets.
3446,7131,5,42,196,243,1.213991769547325,0.02941239657463667,651,"Luckily, the Bronx Zoo has one of the best herpetology departments in the nation."
273,7131,8,36,199,243,1.213991769547325,0.031098544617464124,651,So the good news is sleeveless shirts go on sale this week...
3433,7131,9,34,200,243,1.213991769547325,0.031640632300013266,651,"Our Python-Squeeze diet appears to be a success. However, there is a note here that your python may be getting hungry..."
6227,7131,5,42,196,243,1.213991769547325,0.02941239657463667,651,Congratulations on making it to your penultimate session of exposure therapy.
9145,7131,7,38,198,243,1.213991769547325,0.030546838499330348,651,I’ve never seen a more severe case of Aspergers.
6085,7137,3,43,183,229,1.2139737991266375,0.029199096190079713,651,"Well, it is a way to lose weight."
1867,7137,9,31,189,229,1.2139737991266375,0.03290014347681662,651,So you say you are having trouble taking your meds?
350,7137,7,35,187,229,1.2139737991266375,0.03171448722538732,651,You have a bad case of boa constricivitis.
8507,7137,9,31,189,229,1.2139737991266375,0.03290014347681662,651,"Natural constriction may be preferential to dieting or surgery, but it too has drawbacks."
8617,7141,6,44,212,262,1.213740458015267,0.02862473552824993,651,"Metamucil is fine, but I still think it's more important to focus on your ""Boa"" constriction."
2564,7142,6,41,201,248,1.2137096774193548,0.029600918300865416,651,It appears your airway is constricted.
5332,7142,7,39,202,248,1.2137096774193548,0.030147375128277504,651,"Yeah, so I’m just going to write you a prescription for Xanax."
4953,7142,12,29,207,248,1.2137096774193548,0.032743144953989445,651,Thisssss is a classic case of the middle classssssss being squeezed by health care costsssssss.
6404,7142,7,39,202,248,1.2137096774193548,0.030147375128277504,651,I have written a prescription that should help with your sore throat.
7910,7142,9,35,204,248,1.2137096774193548,0.031211599652472746,651,We feel it eliminates the uncertainty of which side of the exam gown goes where.
3225,7147,8,34,192,234,1.2136752136752136,0.0318522733580796,651,"Well Mr Jones, I'd say we need a bit longer with the anaconda, but if you are still doing well, maybe week we can taper off a bit and see how you do with a python."
9106,7147,6,38,190,234,1.2136752136752136,0.030679022765498817,651,"You're going to need a specialist. Unfortunately,he or she doesn't exist."
5676,7147,12,26,196,234,1.2136752136752136,0.03407780918048421,651,No worries. It is a boa restrictor
2272,7147,8,34,192,234,1.2136752136752136,0.0318522733580796,651,"Lose some weight, get more exercise, and I’ll see you again in six weeks."
1367,7147,11,28,195,234,1.2136752136752136,0.03353527453929037,651,Did you try asking him for a little bit of space?
1943,7147,6,38,190,234,1.2136752136752136,0.030679022765498817,651,So you're saying the discomfort started during the plane ride?
2458,7153,8,31,181,220,1.2136363636363636,0.033154070977114716,651,I think your getting too wrapped up in the ant-fur movement “
2799,7154,10,24,172,206,1.2135922330097086,0.03595783232624025,651,We need  some tests to get behind the obvious symptoms to the true cause.
7083,7155,8,41,218,267,1.2134831460674158,0.029266290113597965,651,"Please try to speak up, Mr. Smathers. Now, what were the dates of your last five polio shots?"
1762,7156,6,42,205,253,1.2134387351778657,0.029230438550752236,651,"Okay. Are you allergic to any drugs, pollen, or South American reptiles?”"
614,7156,11,32,210,253,1.2134387351778657,0.031800416991043405,651,I’m going to start you on antibiotics; but if you don’t feel better by the end of next week I want you to call my office.
6148,7156,4,46,203,253,1.2134387351778657,0.028136796987136378,651,When you said you were having problems with your constrictor I just assumed you had trouble swallowing.
8261,7156,9,36,208,253,1.2134387351778657,0.030798170848773895,651,Anyone you would like to invite to the unwinding?
8710,7156,7,40,206,253,1.2134387351778657,0.029762193038421925,651,I have an essiental oil for this.
4510,7161,7,37,195,239,1.213389121338912,0.030844664363703075,651,"I said, 'Take off your underwear,'  sir."
751,7161,8,35,196,239,1.213389121338912,0.03140945442740491,651,"When did you start to feel the constricting chest pain?"""
3283,7161,8,35,196,239,1.213389121338912,0.03140945442740491,651,"Hi Doctor, 
I’m still having issues digesting my food."
1836,7161,7,37,195,239,1.213389121338912,0.030844664363703075,651,It’s a side effect of Global Warming.
393,7161,9,33,197,239,1.213389121338912,0.031964266535382244,651,Breathing problems are common in this season
43,7161,7,37,195,239,1.213389121338912,0.030844664363703075,651,I would say you have a fifty percent chance of being alive tomorrow.
2415,7167,10,28,187,225,1.2133333333333334,0.033853090642240416,651,"In a few minutes, the snake will go retrieve the gerbil"
8133,7168,7,47,232,286,1.2132867132867133,0.027577421490161347,651,"""There's lots we can do, OK?
I do not think couple's counselling would  be our first intervention."""
1747,7169,14,27,217,258,1.2131782945736433,0.03278632871339768,651,Do you remember when I told you this could be one of the side effects of flirting with Democratic Socialism?
4250,7169,10,35,213,258,1.2131782945736433,0.030891594637162404,651,"Unfortunately, your insurance won't cover the treatment for your chest constriction."
3280,7171,9,34,201,244,1.2131147540983607,0.03152289307809979,651,I drive a Viper too!
3744,7171,9,34,201,244,1.2131147540983607,0.03152289307809979,651,"So, Mr.Snake, did you say you have indigestion?"
1875,7173,8,30,178,216,1.212962962962963,0.033527761037688425,651,I am referring you to a speech pathologist for your strident lisp.
4391,7173,4,38,174,216,1.212962962962963,0.03085199299325701,651,"Okay, try this. If you don't feel better in a week, call me."
3420,7175,7,29,166,202,1.2128712871287128,0.034328239462094505,651,"Sorry, I'm just the physician's assistant, the doctor will be in a just a few more minutes..."
5165,7176,9,35,205,249,1.21285140562249,0.031097845154935532,651,"That nurse doesn't even know how to spell constriction.... oh, wait."
4246,7176,11,31,207,249,1.21285140562249,0.03212244080440361,651,"Just taking a look at your medical hissstory, what brings you in today?"
8467,7176,8,37,204,249,1.21285140562249,0.030572673391516064,651,"On a scale from 1 to 10, how cozy is it?"
2236,7176,8,37,204,249,1.21285140562249,0.030572673391516064,651,Have you thought about Florida?
8264,7180,12,26,197,235,1.2127659574468086,0.03394466741682034,651,"I see that Charlotte passed ""Human Training 101"" with flying colors."
5129,7180,6,38,191,235,1.2127659574468086,0.030561723629751396,651,I see a severe sore throat and a large constriction in your chest. I suggest a smaller scarf.
4360,7180,8,34,193,235,1.2127659574468086,0.0317294728839563,651,I believe the constriction you feel may be snakosomatic.
5652,7180,7,36,192,235,1.2127659574468086,0.031151070613343476,651,I would suggest telling the snake some jokes.
1610,7184,11,35,222,268,1.212686567164179,0.03057137185904818,651,"Hey, don't worry, its head is still visible!"
4362,7185,7,40,207,254,1.2125984251968505,0.029656694785500894,651,Getting too wrapped up in your work may be bad for your health.
6593,7185,7,40,207,254,1.2125984251968505,0.029656694785500894,651,"It says here that he's filling in for your ""Main Squeeze"" who left you for another man."
7778,7185,8,38,208,254,1.2125984251968505,0.03017684770630969,651,so what is your pets name?  CUDDLES
6985,7188,6,32,169,207,1.21256038647343,0.03307460550722402,651,"Now, as for care and feeding..."
5755,7189,9,33,198,240,1.2125,0.031843218835005654,651,I'm afraid there is a lot of this going around. It is nature's way of weening you off info wars.
81,7189,7,37,196,240,1.2125,0.030728741900711756,651,"Well, it's a python so..."
4639,7191,8,42,223,273,1.2124542124542124,0.028820277192859838,651,This is the greatest amount of tension I've seen in someone!
1722,7192,8,32,186,226,1.2123893805309736,0.032528728618502,651,I see that you are all wrapped up in your pet.
5181,7193,8,39,212,259,1.2123552123552124,0.02979494116553254,651,"Ok Timmy, looks like you're in a bit of a knot here."
6457,7193,5,45,209,259,1.2123552123552124,0.028247968627714445,651,"OK...Occupation... ""circus snake man.""  So, what brings you in today,            Mr. Jones?"
9090,7193,10,35,214,259,1.2123552123552124,0.030783096725871324,651,I'd like to see how you do on a restrictive diet.
7665,7196,4,44,197,245,1.2122448979591838,0.02861918295636752,651,"Well, your allergy symptoms have cleared up..."
341,7196,5,42,198,245,1.2122448979591838,0.02919783619453671,651,"Mr. Finkle, being constricted by a Boa in generally not considered a good diet plan."
665,7196,8,36,201,245,1.2122448979591838,0.030868781227996037,651,Come back when you are not squeezed for time.
1914,7196,8,36,201,245,1.2122448979591838,0.030868781227996037,651,"Let's start with the basics: are you taking any medications, or do you have any allergies I need to be made aware of?"
4440,7196,11,30,204,245,1.2122448979591838,0.03245380825975225,651,Have you been in contact with any reptiles lately?
6496,7196,7,38,200,245,1.2122448979591838,0.030322032404654538,651,feeling tied up in knots is a sign of anxiety
6875,7196,10,32,203,245,1.2122448979591838,0.03193420838548847,651,The scaly skin is getting worse.
7183,7203,12,35,231,278,1.2122302158273381,0.030252814802894955,651,Why do you think you have separation anxiety?
5264,7204,4,41,186,231,1.2121212121212122,0.029617697274307096,651,You’re supposed to moisturize after you get out of the shower while your skin is still damp.
8730,7204,4,41,186,231,1.2121212121212122,0.029617697274307096,651,"prescribing you some painkillers, your medical insurance does not cover Rod of Asclepius removals"
2479,7204,9,31,191,231,1.2121212121212122,0.0326408573930653,651,I see your ex-wife still doesn't want to let you go.
1950,7207,10,33,207,250,1.212,0.031499091591414785,651,"You have a choice...pay your bill or I'll have my bill collector
really put the squeeze on you!"
5829,7207,9,35,206,250,1.212,0.03098490369564044,651,...and have you had any pressure in your chest?
1688,7209,8,34,194,236,1.2118644067796611,0.0316076000885496,651,CDC issued a warning this was going around among folks visiting the Everglades.
1945,7209,7,36,193,236,1.2118644067796611,0.031031892573154172,651,"And for the tightening in the chest, 
I recommend a good decongestant."
3399,7209,6,38,192,236,1.2118644067796611,0.030445300622360113,651,And when did your s-s-symptoms first start?
6651,7209,8,34,194,236,1.2118644067796611,0.0316076000885496,651,"Hey Doc, this boa is really constricting."
9072,7209,13,24,199,236,1.2118644067796611,0.03434167317978522,651,"You have not digested this person, since wnen?"
2053,7214,10,34,211,255,1.2117647058823529,0.031079767057843523,651,"No, you’re not the first tourist to be strangled by a snake."
1165,7214,10,34,211,255,1.2117647058823529,0.031079767057843523,651,"Okay, Mr. Stevens.. it seems you have an unsightly growth!"
5590,7214,10,34,211,255,1.2117647058823529,0.031079767057843523,651,"An accident, right.  And I suppose the snake ate your pants first?  You see my concern..."
1984,7217,7,33,182,222,1.2117117117117118,0.032256952381122,651,"Yes, weighted blankets are the new thing for anxiety, but this squeeze approach just might cause it."
3176,7217,4,39,179,222,1.2117117117117118,0.030302091297081685,651,"But it does keep you warm, is that right?"
7916,7219,7,44,223,274,1.2116788321167884,0.028256141000749697,651,Have you ever tried inhalers?
4592,7220,8,35,198,241,1.2116182572614107,0.031173306686759942,651,I can see you’re already keeping your weight constricted.
1800,7220,9,33,199,241,1.2116182572614107,0.03172307041252681,651,"Yes it’s the Serpentes diet
Just keep it on for 6 weeks  
It’s the latest craze"
6005,7220,9,33,199,241,1.2116182572614107,0.03172307041252681,651,"So, you think you have high blood pressure."
577,7220,8,35,198,241,1.2116182572614107,0.031173306686759942,651,HOW LONG HAVE YOU BEEN EXPERIENCENG CHEST PRESSURE?
8057,7220,7,37,197,241,1.2116182572614107,0.03061367183425488,651,I think you have a parasite...
1394,7220,9,33,199,241,1.2116182572614107,0.03172307041252681,651,Don't worry. This won't hurt a bit.
9049,7220,6,39,196,241,1.2116182572614107,0.03004361423937055,651,It seems to be an external restriction of some sort...
4543,7227,10,35,215,260,1.2115384615384615,0.030675346819805712,651,I will skip auscultation today
3058,7227,8,28,172,208,1.2115384615384615,0.034312644515960056,651,I'm sorry.  I can't examine you until you're fully unclothed.
2313,7229,6,36,185,227,1.2114537444933922,0.03117212381836025,651,So at what point did you realize the snake oil wasn’t working?
2463,7229,8,32,187,227,1.2114537444933922,0.03239862609966094,651,That's not a Turtleneck...
5458,7229,7,34,186,227,1.2114537444933922,0.03179129028910917,651,Let me just write you this referral to a specialist.
6020,7229,7,34,186,227,1.2114537444933922,0.03179129028910917,651,"Based on the battery of tests I ran, you’re in a tight squeeze"
2565,7233,9,34,203,246,1.2113821138211383,0.0312899832367969,651,This unique condition is beyond my abilities as your physician so I'm writing you a referral to see a Snake Charmer
2893,7233,10,32,204,246,1.2113821138211383,0.031815830277842384,651,I can't believe that salesman talked you into fresh. Here's a prescription for bottled.
3301,7233,8,36,202,246,1.2113821138211383,0.030755146653033378,651,Any history of crushed vertebrae syndrome in your family?
4504,7233,10,32,204,246,1.2113821138211383,0.031815830277842384,651,I'd recommend a wraparound approach.
6190,7233,12,28,206,246,1.2113821138211383,0.032842275604582485,651,My ex-wife is really squeezing me for all I'm worth
4091,7238,10,36,219,265,1.211320754716981,0.03028500925900983,651,I'm writing you a prescription to help regulate you boa's
1613,7239,6,37,189,232,1.2112068965517242,0.030742801313559075,651,How long have you had this condition?
4269,7239,9,31,192,232,1.2112068965517242,0.03251271814403868,651,Looks like we're going to need to aspirate.
8864,7241,7,39,205,251,1.2111553784860558,0.029822520151908366,651,"You say ""constantly being held tight"" like it's a bad thing..."
8900,7241,8,37,206,251,1.2111553784860558,0.030352186382057222,651,He's a real charmer.
7767,7241,9,35,207,251,1.2111553784860558,0.03087276677156259,651,"Well yes, that probably would help more, but I have a lot of other patients waiting, so here's a prescription for Zoloft."
615,7241,9,35,207,251,1.2111553784860558,0.03087276677156259,651,"Mr. Shapiro, I have to say that I have some concern about your weight."
7518,7241,4,45,202,251,1.2111553784860558,0.02817383854448134,651,Take a deep breath and hold it when you hear a continuous hissing sound.
7291,7246,5,36,177,218,1.2110091743119267,0.03128255814002614,651,"As far as Staff of Asclepius cosplay goes, not the worst I've seen"
505,7247,11,28,198,237,1.2109704641350212,0.03314637104769861,651,The weighted blankets are on backorder.
4077,7247,12,26,199,237,1.2109704641350212,0.03368144325021286,651,You’ll have to unwrap it yourself to sign this emotional support animal application.
4664,7249,10,34,212,256,1.2109375,0.030969173230225657,651,"I can remove him, but I can’t promise you it won’t damage some scales."
8435,7249,6,42,208,256,1.2109375,0.028923012826396255,651,"The good news: we have found the cause of your obesity.
The bad news: you'll have to consult a vet for the cure."
474,7249,9,36,211,256,1.2109375,0.030470517482671093,651,When was the first time you felt that you're being suffocated by the boa constrictor?
6447,7252,4,39,180,223,1.210762331838565,0.03018083715595576,651,"Yes, many of our patients are thrilled with natural alternatives to staunch bleeding."
8968,7252,7,33,183,223,1.210762331838565,0.032126007564725355,651,"I would watch ""Anaconda"" or consult with Lord Voldemort."
1333,7254,10,31,201,242,1.2107438016528926,0.032141768421304465,651,When did you start to wear a boa?
2721,7254,7,37,198,242,1.2107438016528926,0.030499445025030467,651,Try to get some fresh air.
4905,7254,9,33,200,242,1.2107438016528926,0.03160381148602378,651,"Well, Mr. Johnson, I have good news, and I have boa news..."
1643,7257,11,33,217,261,1.210727969348659,0.031046669586181262,651,"In my opinion, as your Vet, there is nothing wrong with your diet."
2956,7257,10,35,216,261,1.210727969348659,0.0305683373628329,651,A tight feeling in your chest?  Tell me more.
3107,7257,10,35,216,261,1.210727969348659,0.0305683373628329,651,"This is our rattlesnake conversion therapy procedure, required for you to learn how to handle your fear of our President."
2375,7260,8,40,218,266,1.2105263157894737,0.02922620703574068,651,"Well frankly sir, I don't appreciate your tone."
1838,7260,9,30,189,228,1.2105263157894737,0.03286284101678424,651,So you're having trouble breathing...
735,7260,8,32,188,228,1.2105263157894737,0.032269543799551464,651,"It’s pretty clear what’s causing the tightness in your chest; however, it should pass when you are swallowed whole."
259,7260,6,36,186,228,1.2105263157894737,0.03104895701476361,651,"You seem a little agitated today, oh I'm sorry I interrupted your dinner, I'll come back"
1142,7264,8,37,207,252,1.2103174603174602,0.030243111210287832,651,We'll be trying a new form of compression therapy on you.
4447,7264,6,41,205,252,1.2103174603174602,0.029178873669386714,651,You’re imagining that sense of chest constriction.
4549,7264,11,31,210,252,1.2103174603174602,0.03177269954337449,651,It’s the latest treatment - we squeeze out the wheeze.
6408,7264,11,31,210,252,1.2103174603174602,0.03177269954337449,651,"Snakeskin wraps are so last year, but I ‘ll admit  you anyway to  our reptile clinic."
8555,7264,10,33,209,252,1.2103174603174602,0.03127115096605249,651,"So tell me, when did the rattling and hissing begin?"
4518,7269,7,35,191,233,1.2103004291845494,0.031222228734537654,651,"If you feel any pain or tightness in your chest, you should take an aspirin and call 911 immediately."
5503,7269,6,37,190,233,1.2103004291845494,0.030623992213684982,651,And for how long have you had the feeling that your throat is constricted?
700,7271,11,32,214,257,1.2101167315175096,0.03134802148700783,651,"""There doesn't appear to be anything physically wrong with you. Have you considered speaking to a therapist about anxiety?"""
6402,7271,6,42,209,257,1.2101167315175096,0.02882194108185255,651,Have you tried a long soak in a hot tub?
3282,7273,10,30,198,238,1.2100840336134453,0.032477343344481074,651,"It says here your fraternity brothers dared you"""
8285,7274,10,26,183,219,1.2100456621004567,0.03435184134632282,651,Studies have shown this is better than snake oil.
4147,7275,10,35,217,262,1.2099236641221374,0.03046206089751045,651,In Aryuvedic medicine we consider this a kundalini emergency.
8178,7276,7,37,199,243,1.2098765432098766,0.03038605245944082,651,"I don't have a twin, and, if I did, he certainly wouldn't waltz in here wearing a boa."
4829,7276,9,33,201,243,1.2098765432098766,0.03148543241101131,651,She just doesn't like other people seeing me naked.
3980,7276,11,29,203,243,1.2098765432098766,0.032547699214365886,651,"It seems like your throat is constricting, I have never seen anything like it."
375,7276,12,27,204,243,1.2098765432098766,0.03306603785108021,651,"Call us back if he bites. Unfortunately, constriction has to be treated by a vet. Do you happen to have pet insurance?"
887,7280,5,37,182,224,1.2098214285714286,0.030719273819142814,651,I see you took the compression recommendation to heart.
1435,7280,10,27,187,224,1.2098214285714286,0.03382108762994754,651,"And when she told you that you needed to get over your fear of suffocating love, what did you say?"
7388,7280,4,39,181,224,1.2098214285714286,0.03006052805717241,651,though the stats aren't out yet I think this diet plan shows great promise
2281,7283,6,40,202,248,1.2096774193548387,0.029441487702639036,651,Is anything tying you down today?
1468,7283,7,38,203,248,1.2096774193548387,0.029990849621429894,651,This prescription should relax you because you seem wrapped a little too tight.
3780,7283,10,32,206,248,1.2096774193548387,0.03158165052094253,651,"But first, we’ll need your blood pressure."
5174,7283,9,34,205,248,1.2096774193548387,0.031060437645924654,651,"Yes, they are new gowns.  They help us check lung strength."
7956,7287,10,28,191,229,1.2096069868995634,0.03331193232845931,651,OK.  I'm ready to take your history.
5453,7287,8,32,189,229,1.2096069868995634,0.03214147001351974,651,Give the snake two aspirin and call me in the morning.
3745,7287,6,36,187,229,1.2096069868995634,0.03092674172628156,651,Life's pressures are often manifold.
3785,7287,4,40,185,229,1.2096069868995634,0.029662309636612268,651,No need to fret; it's completely natural.
736,7291,4,45,204,253,1.209486166007905,0.02797548995406921,651,Your first drag show then?
952,7292,7,35,192,234,1.2094017094017093,0.031101501649463008,651,I see that you have put on some weight since your last visit. So let's talk about the snake in the room.
3465,7292,10,29,195,234,1.2094017094017093,0.032823021268605056,651,Your Insurance will cover you but not the snake!
1419,7292,10,29,195,234,1.2094017094017093,0.032823021268605056,651,You told the nurse you needed your Seeing Eye Snake with you?
1503,7295,9,36,213,258,1.2093023255813953,0.030255867614229902,651,And this is your new boa?
1276,7295,8,38,212,258,1.2093023255813953,0.029753224065145523,651,Good news we have a specialist coming in from Hogwarts. Dr. Potter should hopefully be able to talk the snake off you!
1780,7297,7,36,196,239,1.209205020920502,0.030679673696941738,651,"Well  we know wha it is, the problem is how do we get it to unconstrict"
8280,7297,8,34,197,239,1.209205020920502,0.031247446069535834,651,It will take a long time for this mystery to uncurl.
4394,7299,11,33,219,263,1.209125475285171,0.03083087335537102,651,Your new meds may have a side effect - a constricting sensation.
4436,7299,1,53,209,263,1.209125475285171,0.025696152740933075,651,I suggest you find another way to keep warm.
5603,7299,9,37,217,263,1.209125475285171,0.0298746155560371,651,You must quit following every fad diet you hear about!
6741,7299,6,43,214,263,1.209125475285171,0.02837987858977104,651,"Yes, you should be on statins."
8955,7299,9,37,217,263,1.209125475285171,0.0298746155560371,651,"Based on preliminary tests, I am ruling out attachment syndrome."
5808,7304,9,28,183,220,1.209090909090909,0.03359645574402076,651,"Personally, I prefer Alpaca."
3574,7305,6,39,199,244,1.209016393442623,0.029711151872857305,651,Have you tried reducing your stress?
3007,7305,7,37,200,244,1.209016393442623,0.030273485247551225,651,We have several new treatment strategies for anxious pets.
5187,7305,7,37,200,244,1.209016393442623,0.030273485247551225,651,How do you spell your scarf's name?
8536,7305,11,29,204,244,1.209016393442623,0.03242544313838347,651,Have you been feeling any constriction  lately?
7817,7309,10,36,222,268,1.208955223880597,0.02997625801886661,651,Blood pressure 600/300.  Perfect!
2698,7310,13,26,210,249,1.2088353413654618,0.03297364613896126,651,Good news -- it's not Hyperactive Colon Syndrome!
8834,7310,10,32,207,249,1.2088353413654618,0.03146583059080652,651,"Yes, yes I can clearly see that Sammy reduces your anxiety."
1228,7310,6,40,203,249,1.2088353413654618,0.029335099025999598,651,"On the upside, you could sweat off a few pounds before bathing suit season."
1726,7310,5,42,202,249,1.2088353413654618,0.02877777649314084,651,I see you're a little wrapped up right now; I'll come back later.
6084,7310,8,36,205,249,1.2088353413654618,0.030419126628114572,651,I warned you what would happen if you kept using that snake oil.
7110,7310,10,32,207,249,1.2088353413654618,0.03146583059080652,651,"And when you have shuffled off this mortal coil, we’ll see what dreams may come."
6604,7316,10,28,192,230,1.208695652173913,0.03317929976787091,651,Sit tight Mr. Whitaker. I have an emergency cephalectomy down the hall.
4074,7317,8,37,209,254,1.2086614173228347,0.03002725746091641,651,"Sure, I can save you - but I can't make any promises about the snake."
8712,7317,8,37,209,254,1.2086614173228347,0.03002725746091641,651,He needs to be seen by an exotic companions specialist. Please slither across the hall.
3537,7317,9,35,210,254,1.2086614173228347,0.03054109989037089,651,Now let's see........you say you feel tied up and crushed............
3582,7320,5,34,172,211,1.2085308056872037,0.031805889967827045,651,I just asked her for a little squeeze...
4256,7320,6,32,173,211,1.2085308056872037,0.032507709465187704,651,"As your doctor, I simply can't recommend this weight reduction program!"
3735,7322,9,31,195,235,1.2085106382978723,0.03213418026701576,651,"That's pretty ingenious, Mr. Conroy, as you're right: there aren't any compression socks for the body."
828,7322,6,37,192,235,1.2085106382978723,0.030389057142735532,651,When were you in the Florida Everglades last?
6922,7322,12,25,198,235,1.2085106382978723,0.03378929251762583,651,His name is Julius Squeezer?
9244,7325,10,34,215,259,1.2084942084942085,0.03064199699117547,651,Sir I realize an apple a day didn’t work
2370,7325,7,40,212,259,1.2084942084942085,0.029140027318827283,651,...and so Friday isn’t good for a follow-up.
2978,7325,10,34,215,259,1.2084942084942085,0.03064199699117547,651,Inhale deeply and hold it. For the next 48 hours.
9132,7328,7,36,197,240,1.2083333333333333,0.03056400711483775,651,"Says here you are having trouble breathing, get unwrapped and I'll take a look."
8078,7328,8,29,179,216,1.2083333333333333,0.033341407290901987,651,Tongue-tied?
6497,7328,8,39,217,264,1.2083333333333333,0.02928401737498311,651,"Adam, you know what they say about an apple a day? In your case, it's not true."
3376,7328,10,35,219,264,1.2083333333333333,0.030251677596264515,651,Your blood pressure seems a little high; what have you been eating?
4559,7328,8,29,179,216,1.2083333333333333,0.033341407290901987,651,I think you should have stuck with the raccoon coat.
925,7328,11,33,220,264,1.2083333333333333,0.030724081097297965,651,"Yes, I'm afraid it's terminal, but you qualify to be buried at Eden Memorial Park."
7503,7334,5,41,199,245,1.2081632653061225,0.02903133177528779,651,"Sir, same advice as last year: stop going to Cardi B shows!"
5627,7334,8,35,202,245,1.2081632653061225,0.03071133733176914,651,"Okay, let him go and I'll give you a scrip for the damn opiods."
1158,7334,8,35,202,245,1.2081632653061225,0.03071133733176914,651,Recommend you see a specialist for more tests about that tightness in your chest.
7329,7334,6,39,200,245,1.2081632653061225,0.029601929497919476,651,"Clinically speaking,it is not yet up to your neck."
3692,7334,7,37,201,245,1.2081632653061225,0.030161734621084974,651,He'll hopefully become unravelled if  we  feed him well
7061,7334,8,35,202,245,1.2081632653061225,0.03071133733176914,651,"I know the choking feeling is uncomfortable, but not to worry, it's due to molt soon!"
3587,7340,8,30,183,221,1.2081447963800904,0.03283697542856986,651,It says here that you have pre-existing ophidiophobia. Tough luck.
7821,7340,5,36,180,221,1.2081447963800904,0.030900824415176265,651,The bad news is there's no record of a therapy python on these premises.
4863,7342,7,38,205,250,1.208,0.029773981256112823,651,"For now, I'm going to prescribe sssomething that's going to help you sssleep"
5150,7342,8,36,206,250,1.208,0.030308719436749267,651,That's what happens when you don't take your entire worms medication.
6185,7342,9,34,207,250,1.208,0.03083418537843683,651,I’m feeling a bit constricted.
3180,7345,8,31,187,226,1.2079646017699115,0.03235303773184451,651,So you think it stems from being wrapped up in those Monty Python episodes?
5649,7345,11,25,190,226,1.2079646017699115,0.03412789402780576,651,"Your vital signs are normal,except for the sudden weight gain."
4085,7345,7,33,186,226,1.2079646017699115,0.03173937119278136,651,"While we await your abdominal x-rays, do you have a theory as to why your gerbil-loving python is so interested in you this evening?"
4019,7348,8,37,210,255,1.2078431372549019,0.029920463173164345,651,If we extract him with the jaws of life it's about 50/50 that he lives if that's important to you.
8698,7348,7,39,209,255,1.2078431372549019,0.02939992556737429,651,I assume you are still under your parents policy?
4319,7348,6,41,208,255,1.2078431372549019,0.028870003987488697,651,I think it’s  a heart attack   I feel a tightness in my chest
2601,7351,6,36,189,231,1.2077922077922079,0.030685123014900305,651,"You know that's not what they mean when they say ""Trouser Snake"" right?"
1966,7351,6,36,189,231,1.2077922077922079,0.030685123014900305,651,So you’re saying the snake is warning you not to touch the tree?
479,7353,6,42,212,260,1.2076923076923076,0.028522839129614896,651,Take two ASPrins daily and see me in a month.
2884,7353,6,42,212,260,1.2076923076923076,0.028522839129614896,651,"Well, the good news is that you don't have VASOconstriction syndrome..."
5337,7353,11,32,217,260,1.2076923076923076,0.031016971169249247,651,"I warned you not to believe that snake oil salesman!  Take two Democrats, and call me in the morning."
7674,7353,9,36,215,260,1.2076923076923076,0.030044174828308727,651,Nothing unusual but I noticed some weight gain after your vacation
8016,7353,10,34,216,260,1.2076923076923076,0.030534447281947145,651,Get me a prescription for an emotional support animal
5092,7358,3,43,190,236,1.2076271186440677,0.028429968235603106,651,"Of course, I see it. But I must ask. How soon after your return from the honeymoon did it appear?"
5645,7358,6,37,193,236,1.2076271186440677,0.030272911553649754,651,As I said while snakes can become closely attached to their owners this is carrying it too far!
8171,7358,8,33,195,236,1.2076271186440677,0.03144158436381507,651,"Nah, this has nothing to do with your missing the vaccination appointment."
8886,7358,4,41,191,236,1.2076271186440677,0.02905727310955557,651,You may want to consider to change your pet choice to say a cat or dog.
3320,7362,10,30,201,241,1.2074688796680497,0.03210744303017046,651,I'm afraid  insurance doesn't cover everything. You'll have to pay for the snake out-of-pocket
3514,7362,10,30,201,241,1.2074688796680497,0.03210744303017046,651,So last time we discussed your feather allergy.
2802,7362,4,42,195,241,1.2074688796680497,0.02869527867555205,651,"Were you in South America or binge-shopping on the internet?"""
8660,7362,13,24,204,241,1.2074688796680497,0.033684155589381586,651,This is an advancement over using leaches.
3826,7366,6,33,178,217,1.207373271889401,0.03189022963444961,651,"Well, Mr. Snake, you seem to have grown some human parts."
429,7367,8,41,226,275,1.2072727272727273,0.028495905838816775,651,Are you currently on any prescription medications?
211,7368,6,34,182,222,1.2072072072072073,0.031430915016032006,651,Can you tell me how long you’ve been experiencing this chest tightness?
2866,7369,8,36,207,251,1.207171314741036,0.030199098066652608,651,How would you say the homeopathic venom treatment is going?
4988,7369,8,36,207,251,1.207171314741036,0.030199098066652608,651,"The reason they aren't dying is because you aren't constricting hard enough, which explains why you aren't eating and hence... The weight loss"
8102,7369,11,30,210,251,1.207171314741036,0.031742763804051145,651,Does the snake have insurance ?
92,7372,8,31,188,227,1.2070484581497798,0.03222322416105381,651,This ought to help but you really do need to find a less stressful hobby.
178,7372,9,29,189,227,1.2070484581497798,0.03282256861113624,651,"So, your constricted bowels, how long have you had them, and any idea what the cause might be?"
4507,7372,6,35,186,227,1.2070484581497798,0.030989780662906825,651,Looks like an apple allergy.
6571,7372,5,37,185,227,1.2070484581497798,0.030354269397167996,651,I'm going to suggest that you try coding in Java.
3998,7376,5,43,208,256,1.20703125,0.028230966971932493,651,I feel suffocated in this relationship.
4593,7377,5,38,189,232,1.206896551724138,0.029949005496620894,651,Your inability to take a deep breath indicates a chest infection.
1453,7377,7,40,214,261,1.206896551724138,0.028938277509215404,651,There are better ways to get tight abs.
8849,7377,6,36,190,232,1.206896551724138,0.030565698635445462,651,I'm going to cut back on the dosage of Snake Oil.
1350,7377,7,34,191,232,1.206896551724138,0.031170193068204066,651,You know  there are better ways to get thin...
9020,7377,10,28,194,232,1.206896551724138,0.03291713754897059,651,Not everything is worth media exposure.
8831,7377,9,30,193,232,1.206896551724138,0.032345307875820344,651,And then you prefer a green burial?
4808,7383,8,33,196,237,1.2067510548523206,0.031320892786928255,651,"Don’t tell anybody, but I like it."
6291,7383,5,39,193,237,1.2067510548523206,0.02955884313726544,651,"Are you having trouble breathing?"" - Chris Knight, London, U"
5375,7383,7,35,195,237,1.2067510548523206,0.03074476572011336,651,"Yup,a classic case of boa-constrictive pericarditis."
1222,7386,6,31,171,208,1.2067307692307692,0.03272528502670214,651,You seem to be very wound up lately.
1302,7387,8,34,200,242,1.2066115702479339,0.03089528101627343,651,I'm going to prescribe that you move to a warmer climate.
1104,7387,5,40,197,242,1.2066115702479339,0.029182893253764206,651,"Your vital signs are fine. But, call me if you start feeling any aches or pains."
2576,7387,5,40,197,242,1.2066115702479339,0.029182893253764206,651,The good news is that you aren't going through a rough patch of claustrophobia.
905,7387,7,36,199,242,1.2066115702479339,0.030335227249352673,651,A squeezing feeling in your chest?
5047,7391,7,30,176,213,1.2065727699530517,0.0329112700916384,651,You have to understand that other people don't see you as a Carvel cone and just want to have you committed.
7535,7392,6,39,202,247,1.2064777327935223,0.0293858321737231,651,This should help with the inflammation.
1431,7392,10,31,206,247,1.2064777327935223,0.03154660628630148,651,Now I understand why you feel like you're up to your neck in things.
3650,7392,8,35,204,247,1.2064777327935223,0.03048536944769684,651,It seems to me that Eve had the apple all to herself.
4036,7392,8,35,204,247,1.2064777327935223,0.03048536944769684,651,The tightness you feel seems to be asystematic.
4637,7392,8,35,204,247,1.2064777327935223,0.03048536944769684,651,From what I can see is that you are emotionally all tied up.
2861,7397,6,33,179,218,1.2064220183486238,0.03175785691450977,651,"So, I'm seeing here that you're generally constricted in your mid-section...and it started when you logged into Twitter this morning?"
5231,7397,10,25,183,218,1.2064220183486238,0.03431724371777352,651,Can you tell me about your health hissstory?
3470,7399,7,38,207,252,1.2063492063492063,0.029560173415692184,651,"Okay, now say “Ahhhhhhhhh!”"
2910,7399,7,38,207,252,1.2063492063492063,0.029560173415692184,651,So far you're down to 152
1071,7399,6,40,206,252,1.2063492063492063,0.02902041176196318,651,We have no idea why your hiccups stop
4715,7399,11,30,211,252,1.2063492063492063,0.03162723615008766,651,"Now, I understand you tried a novel approach to squeezing a pimple on your back, Mr. Simpson, and it went a little awry?"
9197,7399,10,32,210,252,1.2063492063492063,0.03112334353763277,651,"I'm gonna write you a 'script for the hypertension and asthma, 
and refer you to a specialist for the scaly skin."
473,7399,11,30,211,252,1.2063492063492063,0.03162723615008766,651,"That snake is fucking awesome, bro."
839,7399,5,42,205,252,1.2063492063492063,0.02847041877637185,651,People were complaining that our hospital gowns were less constricting.
6122,7399,12,28,212,252,1.2063492063492063,0.03212322555450053,651,I also need you to remove your python scarf.
3831,7407,9,28,186,223,1.2062780269058295,0.03318287380582167,651,I see Paul Manafort is selling stuff on ebay to pay his legal bills.
803,7407,8,30,185,223,1.2062780269058295,0.032568450538441776,651,So let me know how you feel in the morning.
7666,7407,7,32,184,223,1.2062780269058295,0.03194221073965876,651,I've Given him a triple dose of a muscle relaxent.
6471,7410,9,42,240,291,1.2061855670103092,0.02788701026680388,651,I'm sending you in for a series of tests.
4531,7411,8,31,189,228,1.206140350877193,0.03209443288309856,651,"It all started with that apple, and the rest is history."
6601,7411,5,37,186,228,1.206140350877193,0.0302344841877271,651,"Ever heard that Queen song, ""Too much love will kill you?"""
2189,7413,8,38,216,262,1.2061068702290076,0.029341138627395798,651,"I'm going to need you to breathe deep, I don't care if it feels constricting."
2743,7413,4,46,212,262,1.2061068702290076,0.027274760582297386,651,It’s a rare affliction - pythonitis
1342,7415,5,38,190,233,1.206008583690987,0.02983340973670776,651,You do seem rather wound up. I'll order a tranquilizer for you to try.
1630,7415,6,36,191,233,1.206008583690987,0.030447183852800565,651,OK - So you're feeling all wound up - Do you have regular BMs?
4217,7415,8,32,193,233,1.206008583690987,0.03163903191727174,651,Name of patient and date of birth ?
7217,7418,8,33,197,238,1.2058823529411764,0.031201110310012516,651,Says here your feeling constipated.
5980,7418,6,37,195,238,1.2058823529411764,0.030043216253449162,651,We find that patients who value a holelitic lifestyle appreciate our  blood pressure test.
4684,7418,9,31,198,238,1.2058823529411764,0.031764233115889925,651,I'm not sure a little blue pill is going to fix your problem.
2171,7418,4,41,193,238,1.2058823529411764,0.028838869622879713,651,We're a bit squeezed for time today!
3712,7418,6,37,195,238,1.2058823529411764,0.030043216253449162,651,"Sammy Slither is here to entertain my younger patients, Clyde. You need to uncoil yourself and put on the robe so I can examine you."
2068,7418,9,31,198,238,1.2058823529411764,0.031764233115889925,651,Feeling of constriction isn't inside the chest?
4446,7418,6,37,195,238,1.2058823529411764,0.030043216253449162,651,Did you press charges?
7590,7425,5,40,198,243,1.205761316872428,0.029074985750430903,651,"Sorry but I’ll have to refer you to a specialist, I’m just a general practitioner."
6705,7425,8,34,201,243,1.205761316872428,0.030779623153126292,651,"1. You were supposed to wear a johnnie
2.It appears you are under a great deal of pressure
3.I recommend three white mice in the morning
4. Well now, that about wraps it up"
9163,7427,10,31,207,248,1.2056451612903225,0.03143017389140919,651,"Your arteries, like your ability to charm, appear constricted."
3276,7427,10,31,207,248,1.2056451612903225,0.03143017389140919,651,I'm writing you a prescription for Nosnakecil.
8964,7429,8,36,209,253,1.2055335968379446,0.029982180165770735,651,You've been diagnosed with mesothelioma.
4913,7429,10,32,211,253,1.2055335968379446,0.031010809738971856,651,"Besides feeling constricted, do you have any other symptoms that may indicate being wrapped up in a snake?"
1668,7431,9,27,183,219,1.2054794520547945,0.03355465401072847,651,"Sorry, I'm a Podiatrist.  Did you try calling Pets-R-Us ?"
5771,7432,9,35,214,258,1.2054263565891472,0.030109644670945335,651,I don't understand it.  It says here you're suffering from severe constriction.
1107,7433,6,34,184,224,1.2053571428571428,0.03117698755399972,651,I am going to put your pet on a higher calorie diet.
1463,7433,9,28,187,224,1.2053571428571428,0.03304723685333653,651,"When I told you to bring in your main squeeze to talk about your STD, I presumed they would not be completely cold-blooded about it!"
4196,7433,4,38,182,224,1.2053571428571428,0.029865158280903293,651,I'm at a loss to explain your high blood pressure ...
6003,7436,12,30,221,263,1.2053231939163498,0.031161995644531634,651,Unfortunately the patient who complained about our comfort boa is no longer with us.
8272,7436,11,32,220,263,1.2053231939163498,0.03069275034813355,651,"Your wife and I have been seeing each other for quite some time. But don't worry,it will all be over for you soon."
8049,7438,6,35,188,229,1.205240174672489,0.03074501757508107,651,"Yes, we’re going to the all natural hospital gown."
7730,7438,8,31,190,229,1.205240174672489,0.03196665210055485,651,"I'm still a little concerned about your cholesterol. Like I said last year, you need to stick to small mammals."
3645,7438,6,35,188,229,1.205240174672489,0.03074501757508107,651,I am recommending a trainer for your pet.
1293,7441,10,28,196,234,1.205128205128205,0.032659033811861936,651,"On the bright side, you get a snakeskin jacket out of this."
1404,7442,7,35,197,239,1.205020920502092,0.030511380196528153,651,I submit to your claim that you have cold feet.
1702,7442,8,33,198,239,1.205020920502092,0.031082226902440915,651,Your lungs are clear. I can’t understand why you’re having trouble breathing. It could be your outfit. I think we’ll ask for a psych consult if you feel that constricted.
3830,7442,8,33,198,239,1.205020920502092,0.031082226902440915,651,I can give you something for the discomfort.
4886,7442,7,35,197,239,1.205020920502092,0.030511380196528153,651,You may have noticed some constrictions.
7603,7442,11,27,201,239,1.205020920502092,0.03273509359033537,651,I think we're making progress with the antidepressants.  Especially with your indication of feelings of being intertwined and engulfed.
8819,7442,6,37,196,239,1.205020920502092,0.029929647738978802,651,"Well, I guess, not all of Marvel's superhero ideas are perfect."
260,7448,7,36,201,244,1.2049180327868851,0.030109790992379856,651,Take off your boa.  How are our cramps doing.
8853,7448,5,40,199,244,1.2049180327868851,0.028967857821409232,651,If wool is still an irritant stick to the snake
2491,7448,6,38,200,244,1.2049180327868851,0.029544342101036698,651,"Sorry about the wait, my alligator needed a snack."
4790,7448,7,36,201,244,1.2049180327868851,0.030109790992379856,651,Are you allergic to any prescription medications?
2077,7448,8,34,202,244,1.2049180327868851,0.030664814968078782,651,At least it won't be prolonged.
4641,7453,7,37,205,249,1.2048192771084338,0.029722726752626764,651,And I have trouble swallowing.
2377,7453,8,35,206,249,1.2048192771084338,0.030262651909364252,651,"I thought she said feather boa, not her boa named Feather."
3948,7455,5,33,172,210,1.2047619047619047,0.03173254821121639,651,I'll schedule a few lab tests and we'll get to the bottom of your constricted feeling in no time.
6120,7455,9,25,176,210,1.2047619047619047,0.03448519222016263,651,"So you feel as if a snake is pressing on your chest, not an elephant?"
1286,7457,7,38,209,254,1.204724409448819,0.02934936322954435,651,"So you were reading ""The Little Prince"" and then..."
2965,7457,7,38,209,254,1.204724409448819,0.02934936322954435,651,Congratulations on your continuing existence. The over/under for survival is maybe ten minutes.
5154,7459,8,37,214,259,1.2046332046332047,0.0295006581171375,651,That apple doesn’t keep the doctor away
6605,7459,9,35,215,259,1.2046332046332047,0.030003651308343003,651,"First of all, we need to talk about this scarf."
3479,7461,8,30,187,225,1.2044444444444444,0.032304219696957195,651,"Hold on, when was your last PSA test?"
7986,7461,11,24,190,225,1.2044444444444444,0.0340970706846922,651,That's one hell of a tapeworm you have there buddy.
904,7463,6,35,189,230,1.2043478260869565,0.030624055469185996,651,"Crushing chest pain"" suggests to me that you're having a heart attack."
1903,7463,10,27,193,230,1.2043478260869565,0.03301093598069423,651,"Look...we've been through this before. YOU have to take the pills, not him."
3195,7465,3,42,190,235,1.2042553191489362,0.028349693515122263,651,Can you stick out your tongue and say ahh...
237,7465,10,28,197,235,1.2042553191489362,0.03253147501043891,651,What was the last thing you ate before feeling the tightness in your throat?
7433,7465,9,30,196,235,1.2042553191489362,0.03196758697835363,651,If I​ need to reach you... how can I get a hold of you?
8300,7465,10,28,197,235,1.2042553191489362,0.03253147501043891,651,How long have you had this crushing chest pain for?
4442,7469,6,37,197,240,1.2041666666666666,0.02981691966451045,651,This is beyond my expertise. I'm referring you to a herpetologist.
4161,7469,4,41,195,240,1.2041666666666666,0.028623656148479167,651,Your weight reduction program does have merit
1622,7469,8,33,199,240,1.2041666666666666,0.030964232676644363,651,"So Mr Jones, you slipped in the shower."
5653,7469,7,35,198,240,1.2041666666666666,0.030395989896146173,651,I know of a clinical trial that may help
6272,7469,10,29,201,240,1.2041666666666666,0.03207052715854342,651,I’m going to prescribe Advil and a muscle relaxant.
1377,7474,13,24,208,245,1.2040816326530612,0.033175808935886814,651,Does this boa make me look fat?
5348,7474,11,28,206,245,1.2040816326530612,0.032151551873036324,651,We'll need to do a CT scan to investigate the cause of the constrictions.
7722,7474,9,32,204,245,1.2040816326530612,0.031093572923332948,651,"There are, indeed, safer, more effective ways to eliminate excess weight and fat shaming."
7440,7477,8,35,207,250,1.204,0.030152490622883082,651,"I see that the snake got Eve, too."
9120,7477,7,37,206,250,1.204,0.02961493165122667,651,"Don’t worry, the Emergency Room will know what to do."
890,7477,4,43,203,250,1.204,0.027940269049136816,651,I would recommend losing some weight.
3284,7477,8,35,207,250,1.204,0.030152490622883082,651,"I'm glad to see you're ASPirational about your health, though you had me rattled at first!"
4268,7477,7,37,206,250,1.204,0.02961493165122667,651,The good news is that you are past your best-by date.
8046,7482,8,36,211,255,1.203921568627451,0.029768308765408598,651,"It's a large meal, but two of these should help him avoid digestive trouble."
2685,7482,10,32,213,255,1.203921568627451,0.030788133964431377,651,"Well, this one's way over my pay grade. I'm calling in Professor Babu, the eminent fakir."
8903,7484,10,33,217,260,1.2038461538461538,0.030391015254992597,651,We just neee to wait for the chamber to open again
8543,7484,6,41,213,260,1.2038461538461538,0.028369238435831758,651,Vertebrae 126-288 are nicely softened.  Come back tomorrow and we will start unwrapping
1255,7486,8,28,180,216,1.2037037037037037,0.03315099906419541,651,Are you comfortable or just feeling overwhelmed?
570,7487,9,27,185,221,1.2036199095022624,0.033276172594424065,651,Have you tried the inhaler I prescribed last time?
2159,7487,5,35,181,221,1.2036199095022624,0.03070443488361201,651,Are you on any Medication?
6740,7489,10,26,190,226,1.2035398230088497,0.03337377138343586,651,"He's not exactly a 'narrow fellow in the grass,' is he?"
5525,7489,9,28,189,226,1.2035398230088497,0.03277921978310112,651,But it should't constrict your diet.
480,7491,8,31,192,231,1.2034632034632036,0.031714075709427844,651,Asclepius recommends this treatment.
1694,7491,10,27,194,231,1.2034632034632036,0.03287962332375619,651,Python for your thoughts.
4838,7491,8,31,192,231,1.2034632034632036,0.031714075709427844,651,"So, you got into the pet taxi and then what happened."
6558,7491,4,39,188,231,1.2034632034632036,0.02924394868149271,651,I believe you need a bit more charm
3945,7495,7,34,195,236,1.2033898305084745,0.030690246648933907,651,"If it’s not a pain, please rate the scales from 1 to 10."
8840,7495,6,36,194,236,1.2033898305084745,0.030096996738653164,651,Possessiveness is not love.
2072,7497,7,35,199,241,1.2033195020746887,0.03028145530256123,651,"Sir, if you’d just let me finish my exam then we’d both be out of here much faster."
6116,7498,5,40,201,246,1.2032520325203253,0.028755908021230996,651,"Now, have you tried some deep breathing?"
4703,7498,8,34,204,246,1.2032520325203253,0.030437711182903025,651,You thought it would be just like Harry Potter?
2531,7498,4,42,200,246,1.2032520325203253,0.0281730055339514,651,I feel so constricted!
4671,7498,12,26,208,246,1.2032520325203253,0.0325452036910446,651,I’m just feeling a bit suffocated by this relationship.
21,7502,7,37,207,251,1.203187250996016,0.02950790297252429,651,Have you always played with your food?
4890,7502,8,35,208,251,1.203187250996016,0.030043116479421157,651,"Surgery can't be scheduled until next Tuesday. In the meantime, I'm prescribing two Monte Python's a day to get you through this."
7046,7502,3,45,203,251,1.203187250996016,0.02726217705898174,651,It'll probably kill you but I must admit it has a certain savoir faire!
7086,7502,4,43,204,251,1.203187250996016,0.027840596400857325,651,"You may be a charming person Mr. Slink. However, next time I suggest that you charm something else."
5016,7506,7,38,211,256,1.203125,0.02914148948344483,651,I see you have been trying the boa constrictor diet.
5385,7506,7,38,211,256,1.203125,0.02914148948344483,651,Stick to enjoying your Samuel L Jackson thrillers in 2D.
5778,7506,10,32,214,256,1.203125,0.03067797538983966,651,Viagra might cause chest pains and shortness of breath
8534,7509,6,28,163,197,1.2030456852791878,0.03371033879382005,651,I see you've been snooping in the cupboards.
2508,7510,4,46,216,266,1.2030075187969924,0.02690799517004131,651,IBS is more common than you think
4011,7510,2,50,214,266,1.2030075187969924,0.02583204533891699,651,These new waist-slimming fads are getting a bit ridiculous.
7117,7512,8,39,224,271,1.2029520295202951,0.02859701445436106,651,It says here that you're both experiencing pain in your lower back and spine.
7144,7513,5,33,174,212,1.2028301886792452,0.03146199953877571,651,"Gerbils and hamsters sure, but never anything like this."
5866,7514,7,31,184,222,1.2027027027027026,0.031884788361872224,651,This wouldn't have happened if you put the robe on.
5078,7515,6,34,187,227,1.2026431718061674,0.030803570707990575,651,We can say for sure it is not a skin condition.
5194,7515,8,30,189,227,1.2026431718061674,0.032044182594671115,651,Your feeling of being constricted will require more labs.
4716,7517,8,31,193,232,1.2025862068965518,0.0315892573740254,651,"Sir, the tightness in your chest and abdomen is puzzling. Test results including a CT scan and endoscopy are completely normal."
937,7517,5,37,190,232,1.2025862068965518,0.02976447837496377,651,"New from accounting. They call him the ""payment squeezer."" Then we get to your ailment."
7052,7517,4,39,189,232,1.2025862068965518,0.029130828517181614,651,I'm going to prescribe you something for that eczema.
1828,7520,9,30,198,237,1.2025316455696202,0.03172057192194782,651,"While not ruling out the invisible constrictor, can I ask you if you're taking the anxiety prescription on schedule?"
2210,7520,12,24,201,237,1.2025316455696202,0.03336866494800556,651,It's emotional!
6169,7520,8,32,197,237,1.2025316455696202,0.03115183746217657,651,Far East medicines answer to constipation requires no drugs and what’s better is you’ll lose the extra 15 pounds you’ve been struggling with.
7952,7523,7,35,200,242,1.2024793388429753,0.03016776713097109,651,Snake-oil salesmen shouldn't get so wrapped up in their work.
8359,7523,10,29,203,242,1.2024793388429753,0.03182721012093911,651,Oh Why? Oh Why? Would you swallow a fly?
7116,7523,5,39,198,242,1.2024793388429753,0.02900878177482169,651,It is still mostly water weight.
7038,7523,8,33,201,242,1.2024793388429753,0.030730872920780104,651,It should pass in a couple days.
4707,7523,6,37,199,242,1.2024793388429753,0.02959394865278818,651,"I just felt like my life unraveling, Doc."
1176,7523,8,33,201,242,1.2024793388429753,0.030730872920780104,651,"Sorry, there’s nothing I can do. We don’t work with your insurance company."
6029,7529,5,40,202,247,1.2024291497975708,0.02865107009092243,651,It looks like you've been coiled again.
9156,7529,9,32,206,247,1.2024291497975708,0.03086332861173024,651,I think you get too wrapped up in your work as a veterinarian.
5399,7531,10,32,215,257,1.2023346303501945,0.030568592144884565,651,"I understand your overcompensation, but you have chosen the wrong species."
7013,7531,8,36,213,257,1.2023346303501945,0.029557421409024308,651,I'm prescribing a muscle relaxant for your lung congestion.
2925,7533,10,33,219,262,1.202290076335878,0.030178566854202258,651,Looks like a classic case of asthma to me
6791,7533,5,43,214,262,1.202290076335878,0.027649748343529946,651,Nothing physically wrong with you but perhaps you're a bit uptight.
6958,7533,9,35,218,262,1.202290076335878,0.02969003931608969,651,Once the snake sheds its skin you will be in tip top shape.
4737,7536,8,39,225,272,1.2022058823529411,0.028501452860396626,651,Sammy is my security blanket.
61,7537,7,42,228,277,1.2021660649819494,0.027704213002819982,651,"Frank, I'll be honest with you; your 'snake-girdle' isn't doing you any favors."
2478,7538,7,31,185,223,1.201793721973094,0.031754497787653754,651,If I were you I'd just do a cake for your next gender reveal.
8602,7538,8,29,186,223,1.201793721973094,0.03238436773019143,651,"Let me get this straight - our colonoscopy team found it and it won't let you go?"""
1502,7540,9,28,191,228,1.2017543859649122,0.03251546037760776,651,Your pet python is not a substitute for Spanx.
7648,7540,9,28,191,228,1.2017543859649122,0.03251546037760776,651,It appears the pharmacist missed the word “feather”.
3451,7542,6,35,192,233,1.201716738197425,0.03026671963497053,651,I will prescribe you a boa decongestant. It should start working in about 24 hours.
7390,7542,11,25,197,233,1.201716738197425,0.03318233954533137,651,It could just be stress. Take this anti-anxiety medicine and let me know in a month is you're still feeling squeezed.
1703,7544,5,38,195,238,1.2016806722689075,0.029268319693094902,651,No venom from the puncture leads us to conclude it's a rare form of inter-species sexual attraction.
5723,7544,7,34,197,238,1.2016806722689075,0.03045568878523788,651,Do you have a PPO or HMO?
7285,7546,9,31,203,243,1.2016460905349795,0.031165979198890432,651,"Yes, well there's a lot them going around."
3718,7546,9,31,203,243,1.2016460905349795,0.031165979198890432,651,"So, apply the snake three times a day and call me if you have any questions."
7538,7546,8,33,202,243,1.2016460905349795,0.030615488309113002,651,"Ok, let's wrap things up in here."
931,7549,6,38,204,248,1.2016129032258065,0.02911322565272221,651,It says here you are a Snake Charmer
342,7549,12,26,210,248,1.2016129032258065,0.03230292688178237,651,I think they meant you should wear a scarf when you go outside during the polar vortex.
1368,7551,5,41,207,253,1.2015810276679841,0.02820501817418286,651,A typical side-effect of the apple diet.
5643,7551,5,41,207,253,1.2015810276679841,0.02820501817418286,651,Congrats on quitting smoking and getting more exercise.
5743,7551,6,39,208,253,1.2015810276679841,0.028755741110132658,651,"So, you were airing Ralph, here, and you fell asleep..."
2208,7554,10,32,216,258,1.2015503875968991,0.030459976207953703,651,"I'm sorry, Mrs. Slither, your insurance doesn't cover pre-existing human conditions."
8852,7554,8,36,214,258,1.2015503875968991,0.02945307768215409,651,"Change your diet, it is too constricted"
8861,7554,7,38,213,258,1.2015503875968991,0.028936492567896897,651,Your bloodwork does not indicate the cause of your stomach pain. I am referring you to a gastro specialist.
6639,7557,6,31,177,214,1.2009345794392523,0.03189144148955199,651,Feed once a week and keep her calm.”
6797,7558,9,28,192,229,1.2008733624454149,0.032385146231858786,651,I think you’re overcompensating on your fear of snakes
2330,7559,10,27,197,234,1.2008547008547008,0.03249180652541168,651,PA: What seems to be the problem?
1094,7559,9,29,196,234,1.2008547008547008,0.03192232841082975,651,I can see the tapeworm meds have not been working very well.
1560,7559,7,33,194,234,1.2008547008547008,0.030751750697107234,651,"You know, snake oil is grossly underrated."
7271,7559,7,33,194,234,1.2008547008547008,0.030751750697107234,651,Have you ever been diagnosed with anxiety?
6386,7563,10,28,201,239,1.200836820083682,0.032030933063235956,651,I am confident with modern medical technology that we will be able get to the bottom of your chest tightness.
8574,7563,6,36,197,239,1.200836820083682,0.029754640680582527,651,At least twice a day make several sharp counterclockwise spins and stops  until you free your self
215,7565,6,37,201,244,1.2008196721311475,0.029374232099945604,651,Not what I would recommend to lose weight.
5748,7565,6,37,201,244,1.2008196721311475,0.029374232099945604,651,You could try talking to it but then you'd need to know Python.
6216,7565,10,29,205,244,1.2008196721311475,0.03158751280408625,651,"Well, so far you're doing fine."
8083,7565,9,31,204,244,1.2008196721311475,0.03104898712883567,651,I'm afraid your test has come back possssssssssitive.
2050,7569,11,28,210,249,1.2008032128514057,0.031675948455297274,651,"Well, on the positive side we can take your blood pressure using your legs..."
8428,7569,7,36,206,249,1.2008032128514057,0.029560366212862062,651,"...alas...medical insurance, just like Judaism and Christianity, has trouble with preexisting conditions..."
582,7571,10,31,213,254,1.2007874015748032,0.03074901447207344,651,It looks like you didn’t follow our orders advising you against binge-watching Monty Python classics.
6582,7572,8,36,215,259,1.2007722007722008,0.02934945728968475,651,I'm prescribing a diuretic for hypertension and you might work on reducing your stress as well.
7608,7573,10,33,221,264,1.2007575757575757,0.029969030103848403,651,"So, you say you’re feeling tightly wound these days."
3696,7574,11,32,226,269,1.2007434944237918,0.03006398217480147,651,It constricts when I pee.
7526,7575,10,35,229,274,1.2007299270072993,0.029241330335390156,651,--- and other side effects as well.
6889,7576,6,41,218,265,1.2,0.027885250450399975,651,Have you considered de-couple therapy?
5124,7576,7,32,191,230,1.2,0.031056334587002937,651,"So seems to be the problem, sir?"
6372,7576,10,25,190,225,1.2,0.03333333333333333,651,"Well, it was advertised as a feather boa..."
4552,7576,4,43,208,255,1.2,0.02744877469689059,651,My recommendation is for you consider a wardrobe selection that does not include a boa.
6064,7576,8,33,204,245,1.2,0.030387262919547714,651,So have you been feeling constricted mentally?
6926,7576,8,32,200,240,1.2,0.030796040246103218,651,I see... the snake was included your VIP SurgiTourism Gastric Band/Elephant Trekking package.
9152,7576,4,41,200,245,1.2,0.02809914102476935,651,It’s a little extreme but you’re ten pounds lighter since this morning.
8367,7576,9,29,197,235,1.2,0.031797687431424054,651,I think you should delete your Facebook account immediately.
8388,7576,9,32,209,250,1.2,0.030524201998259056,651,Sorry our vet is out of the office today so just rest and drink fluids and come back tomorrow
8882,7576,6,36,198,240,1.2,0.02964221799842428,651,Maybe lay off the middle-aged men next time
3937,7576,9,33,213,255,1.2,0.03013017918978142,651,Definitely not Peyronie's.
2974,7576,10,30,210,250,1.2,0.031046021028253313,651,"Well no, I'm not a herpetologist, but next time you've got an STD you can give me a call."
7963,7576,8,27,180,215,1.2,0.033097039753216505,651,"I'd rather go with, 'he really likes you,' rather than..."
3670,7576,7,32,191,230,1.2,0.031056334587002937,651,You're wrapped too tightly.
6295,7576,13,23,209,245,1.2,0.03302522936342038,651,...and how did you wind up with the boa?
2886,7576,8,34,208,250,1.2,0.02999330581270256,651,"Anorexia isn't a disease, it's a symptom. Don't force feed, reduce stress and Fluffy will be just fine."
3607,7576,6,36,198,240,1.2,0.02964221799842428,651,"I’m referring to you to a friend of mine, best charmer in the village!"
110,7576,11,30,219,260,1.2,0.03073208330818047,651,Have you tried antidepressants?
390,7576,10,31,214,255,1.2,0.030638312472097296,651,Your constricted colon has gotten worse.
632,7576,9,30,201,240,1.2,0.03135703427185612,651,We try to squeeze every penny we can out of our patients.
90,7576,6,40,214,260,1.2,0.028212777175613112,651,"If there's no significant improvement by Friday, go ahead and increase the Flexeril to 4 times a day."
1344,7576,7,35,203,245,1.2,0.029831690236873248,651,Hmm. That feeling of pressure on your chest could indicate a heart attack.
1795,7576,9,31,205,245,1.2,0.030932858792789914,651,We wanted something a little more form fitting than the traditional hospital gown.
2232,7576,8,32,200,240,1.2,0.030796040246103218,651,"I'm less concerned about the snake, Mr Hobnerts, than I am about the 2 bushel of apples you're eating per week."
1218,7576,6,38,206,250,1.2,0.028902272669495167,651,"Well, Mr. Adams, the snake says it's payback for eating the apple."
2696,7601,8,40,233,281,1.199288256227758,0.02780749827813771,651,"Well, let's say it's ""Paleo-esque."""
5559,7602,14,25,227,266,1.199248120300752,0.031611525528426526,651,Your vitals look great. No need for a follow-up unless there's a change to the status quo.
8615,7603,8,36,217,261,1.1992337164750957,0.02914435719806298,651,Sorry to say that insurance does not cover free hugs!
4883,7603,9,34,218,261,1.1992337164750957,0.029645674216550243,651,"There's nothing wrong with your feet, Mr. Snake-Torso, you can get dressed."
1920,7605,12,27,217,256,1.19921875,0.03151598658436745,651,It looks like you have snake-wrapped-around-your-neck-itis.
6257,7606,8,34,209,251,1.199203187250996,0.02988419631580273,651,"Besides making a complete Asp of  yourself, it's been awhile, what else you've been up to lately ?"
7787,7606,6,38,207,251,1.199203187250996,0.028797919534596917,651,"You have a very unusual skin condition, and I'm going to refer you to a dermatologist."
7908,7608,3,43,200,246,1.1991869918699187,0.0273974360518086,651,I have your lab tests back and it seems that unfortunately this route did not yield the results we hoped for.
9078,7608,9,31,206,246,1.1991869918699187,0.03081758481889174,651,"Oh, you want a favorable prognosis? Go see a veterinarian."
6412,7608,4,41,201,246,1.1991869918699187,0.027996490985878614,651,"I’m afraid your insurance isn’t going to cover this, sir."
4437,7611,7,34,200,241,1.1991701244813278,0.03011039911050071,651,"Look sir, i know Dr. Oz said that heart attack pain feels like a constricting pain around the chest but..."
8961,7611,9,30,202,241,1.1991701244813278,0.031237676415129298,651,I'd cool my affection for snakes for a bit...
491,7611,8,32,201,241,1.1991701244813278,0.03067921578536491,651,Is that all your in here for?
4356,7614,6,35,195,236,1.1991525423728813,0.029917493983288027,651,So where's the albatross?
2887,7614,7,33,196,236,1.1991525423728813,0.030514233939687475,651,Have you considered trying a hug machine instead?
5190,7614,8,31,197,236,1.1991525423728813,0.031099525713616193,651,you are sick
5831,7614,11,25,200,236,1.1991525423728813,0.03279278243256546,651,You'll have to sign this waiver before I can treat you.
5347,7618,9,28,194,231,1.199134199134199,0.03212758856371551,651,I'm not really happy about your weight gain.
7904,7618,7,32,192,231,1.199134199134199,0.030933718093863413,651,Must you insist on giving me the Full Monty every time?
4997,7620,6,32,183,221,1.1990950226244343,0.0311707057350434,651,"Now, I need you to say aahhh..."
4303,7620,6,32,183,221,1.1990950226244343,0.0311707057350434,651,We'll have this wrapped up in a moment.
2881,7622,4,33,169,206,1.1990291262135921,0.031097916531933556,651,Your skin condition could be helped with a good moisturizer!
4725,7622,8,25,173,206,1.1990291262135921,0.034007634440208656,651,"Restrictive, constricted...same diff."
3153,7624,10,34,228,272,1.1985294117647058,0.02929962886518417,651,I’m sorry but this isn’t covered by your PPO.
1068,7625,8,37,222,267,1.198501872659176,0.02869491930893642,651,Your weight loss should go easier now.
4087,7626,8,36,218,262,1.1984732824427482,0.029042863084195073,651,You wouldn't survive the surgery.
8464,7626,6,40,216,262,1.1984732824427482,0.028017726006264208,651,"Now, are you feeling any tightness in your chest today?"
8750,7626,5,42,215,262,1.1984732824427482,0.027490825883910622,651,"I am sending you to a dermatologist.That 
growth should be checked out."
1139,7629,7,37,213,257,1.198443579766537,0.028881386846894015,651,I can give you something for the anxiety but I wouldn’t worry. Everyone is losing their grip these days.
4365,7630,7,36,209,252,1.1984126984126984,0.029240087030465302,651,"Tryouts for the new HBO series, the next floor, above."
4346,7630,9,32,211,252,1.1984126984126984,0.03030217478355297,651,The python on your back swallowed the monkey on your back.
7133,7632,9,31,207,247,1.1983805668016194,0.030703155967401634,651,Nice Eve costume.
2003,7632,8,33,206,247,1.1983805668016194,0.030162368564958825,651,"The next time somebody dares you to jump into the pool wearing your inflatable snake, I would advise you to think twice about it . . ."
1692,7634,9,30,203,242,1.1983471074380165,0.031119212468184655,651,"Yet another victim of the old 
flotation device disguise trick."
7969,7634,6,36,200,242,1.1983471074380165,0.029419861560281185,651,Have you considered going gluten-free?
36,7636,6,35,196,237,1.1983122362869199,0.02980284116661643,651,So what's got you all coiled up?
7205,7636,8,31,198,237,1.1983122362869199,0.030979424674673357,651,I see that your boa constrictor  has developed quite the tongue.
6392,7636,7,33,197,237,1.1983122362869199,0.030396826271638352,651,"This is the best treatment I know for getting rid of that ugly belly fat, Mr. Smith."
3619,7636,6,35,196,237,1.1983122362869199,0.02980284116661643,651,At least put your gown back on
3860,7640,5,36,191,232,1.1982758620689655,0.029576080840096042,651,Patients tell us that Bo provides warmth and various levels of modesty and pain relief.
5966,7640,6,34,192,232,1.1982758620689655,0.030200390075231485,651,This is the most accurate tech we have for taking your blood pressure.
4572,7640,9,28,195,232,1.1982758620689655,0.03200032139221219,651,Dad said going to veterinary school wasn't a good idea.
1161,7640,5,36,191,232,1.1982758620689655,0.029576080840096042,651,This is how we treat constricted bowels.
4825,7644,9,26,187,222,1.1981981981981982,0.0329538792963733,651,"I'm a big Monty Python too, Mr. Evans, but I think you're taking this a bit too far."
22,7645,5,33,179,217,1.1981566820276497,0.030805059161229414,651,I’d like to get your coil number down.
3106,7645,3,37,177,217,1.1981566820276497,0.029387291044099827,651,"So you say you fell a tightness, a constriction all over your body?"
6836,7645,6,31,180,217,1.1981566820276497,0.0314900153609831,651,Say “Ah” please.
3043,7648,6,29,172,207,1.1980676328502415,0.03244172221974344,651,"So aside for the huggy-huggy feeling, do you have any other reactions?"
6717,7648,8,25,174,207,1.1980676328502415,0.03385660306578015,651,The oil should start to work in about two days.
838,7650,4,44,215,263,1.1977186311787071,0.02686154953768027,651,Your blood pressure seems to be snaking higher
3532,7651,6,39,213,258,1.197674418604651,0.028250606600762663,651,"Yours looks to be a difficult case - but fortunately, we have a reptile specialist at our clinic."
3444,7651,11,29,218,258,1.197674418604651,0.030804426425536807,651,"It says here you’re experiencing some indigestion — is that right, Mr. Hiss?"
6774,7651,9,33,216,258,1.197674418604651,0.029809165063252076,651,I think I have a prolapsed esophagus.
8502,7654,12,26,215,253,1.1976284584980237,0.03171256767101601,651,"Please listen carefully, as our menu options have recently changed."
3022,7655,9,30,204,243,1.1975308641975309,0.031001632585708497,651,"Cats and kittens meow, purr and rub.  Snavely, with neither voice nor legs can only hug.  I suggest you take him out for regular drags around the park"
6487,7655,11,26,206,243,1.1975308641975309,0.032079923519543106,651,"Your tests look OK, but the internal torso organs seem totally constricted.”"
3187,7657,5,36,192,233,1.1974248927038627,0.029461163754049197,651,"So, you're a coder. And you're too wrapped up in your work."
9166,7658,4,37,187,228,1.1973684210526316,0.029196421746996576,651,What I had in mind was a simple neck wrap.
7505,7659,7,28,178,213,1.1971830985915493,0.03250759154818586,651,"Mr. Mowgli, your test results look great. As for you Mr. Kaa, I suggest reducing the amount of meat in your diet."
6209,7660,5,41,213,259,1.196911196911197,0.027614961682566108,651,"Um, Mortal Coil Syndrome. DSM-5 says you’re a goner."
3675,7660,7,37,215,259,1.196911196911197,0.028678330385613425,651,How long have you had this sensation of being all choked up?
3333,7660,8,35,216,259,1.196911196911197,0.0291954944502538,651,You can get dressed now.  I’m just writing you a prescription.
1922,7660,8,35,216,259,1.196911196911197,0.0291954944502538,651,Have you given any thought to moving to a warmer climate?
3263,7664,8,34,212,254,1.1968503937007875,0.02956151502699486,651,"I prefer a sweater myself, not medically speaking you understand."
3638,7665,8,33,208,249,1.1967871485943775,0.029940734124247484,651,I told him I wouldn't eat the fruit....
4777,7665,4,41,204,249,1.1967871485943775,0.027692907034017663,651,"The good news is, the snake is not in your boot."
5644,7665,7,35,207,249,1.1967871485943775,0.029394896579556875,651,"Mr. Levine, I don't care what Big Boi is wearing. I don't think it's a good idea to wear that during the Super Bowl halftime show."
6432,7665,8,33,208,249,1.1967871485943775,0.029940734124247484,651,Can we make this quick? I'm a little wrapped up at the moment.
395,7669,8,32,204,244,1.1967213114754098,0.030333930775462772,651,"Mr. Python, your vet just recommends less fiber."
3802,7669,9,30,205,244,1.1967213114754098,0.03088492706341197,651,"I'm going to order some expensive tests so we can get to the bottom of this. We should be able to tell what's causing your shortness of breath in couple weeks, max."
7178,7669,7,34,203,244,1.1967213114754098,0.02977273908912074,651,I’m going to give you something that should relax and open up your airways. Get this filled right away
9211,7669,9,30,205,244,1.1967213114754098,0.03088492706341197,651,...and I am recommending a python cleanse for your hypertension.
5262,7673,8,31,200,239,1.1966527196652719,0.0307419480616015,651,I’m going to prescribe you some laxatives to help with the constricting you’re describing in your stomach.
2787,7673,8,31,200,239,1.1966527196652719,0.0307419480616015,651,This isn't how I pictured my Florida retirement.
4115,7673,4,39,196,239,1.1966527196652719,0.028362393054029808,651,And this cream for skincare.
6780,7673,8,31,200,239,1.1966527196652719,0.0307419480616015,651,"You mentioned you were highly motivated to lose weight at your last visit, but this method seems a bit extreme"
7543,7677,6,34,194,234,1.1965811965811965,0.029965579754394286,651,I don’t want any of your snake oil remedies.
5635,7678,8,29,192,229,1.1965065502183405,0.03160617871894832,651,"Your insurance company might be squeezing you dry, but I've got school loans and a Lamborghini to pay off."
2890,7678,5,35,189,229,1.1965065502183405,0.0297327163571596,651,"You can breathe easy, it's just plastic."
4990,7678,10,25,194,229,1.1965065502183405,0.03279575085342559,651,Try swallowing her again and call me in the morning.
1843,7678,5,35,189,229,1.1965065502183405,0.0297327163571596,651,Take a teaspoon of this whenever you have difficulty breathing
9229,7682,8,28,188,224,1.1964285714285714,0.03206446415909978,651,This Python boot camp was not what I expected.
7752,7682,4,36,184,224,1.1964285714285714,0.02946143435429614,651,I feel a little tightness in my chest
5060,7684,9,25,185,219,1.1963470319634704,0.03317915338550023,651,"I gotta tell you, when the receptionist said you were looking for a ""snake oil salesman,"" I was a little offended."
8804,7685,10,31,219,260,1.1961538461538461,0.030096408264262613,651,It’s just a strep throat.  I’ll write you this prescription while you get  dressed.
6306,7685,5,41,214,260,1.1961538461538461,0.027518968765363038,651,It's called Idiopathic Dyspnea.
3249,7685,8,35,217,260,1.1961538461538461,0.029092846732644017,651,We can rule out some of the causes of sudden weight gain by looking at the most obvious signs right in front of us.
6711,7685,5,41,214,260,1.1961538461538461,0.027518968765363038,651,Unfortunately snake shedding doesn't really work like that.
1944,7689,8,34,213,255,1.196078431372549,0.029455476755180544,651,I'm going to refer you to a veterinarian for this -- and some opioids.
2069,7689,7,36,212,255,1.196078431372549,0.028926572865540883,651,"Kind of Ironic that you named him, Albatross."
4152,7689,6,38,211,255,1.196078431372549,0.02838781648200352,651,"I didnt mean that kind
of boa for your sore throat"
1542,7692,8,33,209,250,1.196,0.029831117684882634,651,"Your blood pressure is fine, your cholesterol is fine, your breathing is fine....Yes, Mr. Knowles, I'm giving you a clean bill of health!"
2718,7692,10,29,211,250,1.196,0.030889360796911406,651,The snake charmer on call will be with you as soon as he finishes with his current patient.
8063,7692,6,37,207,250,1.196,0.02873392688472753,651,I am scared a little doc!
8431,7692,10,29,211,250,1.196,0.030889360796911406,651,"Doctors advise against free hugs for hygienic reasons, among others."
9190,7692,6,37,207,250,1.196,0.02873392688472753,651,"Rather than  now subjecting you to a complete g.i. series, I’m prescribing a laxative that will likely relieve your feelings of constriction"
2117,7697,4,40,201,245,1.1959183673469387,0.02791875081664728,651,You're suffering from too much love--from being your snake's main squeeze.
7828,7697,8,32,205,245,1.1959183673469387,0.03022053388962357,651,You chose this because feathers tickle?
8059,7697,7,34,204,245,1.1959183673469387,0.029661838500351353,651,"I'm not going to sugarcoat it for you, Mr. Hiss: you have a malignant Carl."
6718,7700,7,33,200,240,1.1958333333333333,0.03004988684961343,651,"I know you feel trapped inside, but you've got to untangle yourself."
2041,7700,10,27,203,240,1.1958333333333333,0.031742687506492284,651,"The good new?  You'll live.
Bad news?  The snake in your pants has died."
5248,7700,6,35,199,240,1.1958333333333333,0.029464015276058693,651,"You feel heavy but I can't see anything, we should do some tests, maybe a scan."
979,7700,9,29,202,240,1.1958333333333333,0.031188631047996816,651,I don't  need to check you out.  I’ll prescribe antibiotics for your sore throat
3005,7704,7,32,196,235,1.195744680851064,0.030452651271514405,651,"Remember, I'm a G.P., not a sex therapist!"
4884,7704,6,34,195,235,1.195744680851064,0.029849517924553846,651,I can give you a referral to a different lawyer.
6219,7704,8,30,197,235,1.195744680851064,0.03104406897622595,651,"Well,I wouldn’t let her get too close to you."
3698,7707,6,33,191,230,1.1956521739130435,0.030249783556887216,651,This is why we warn all our New Hampshire visitors.
5657,7707,8,29,193,230,1.1956521739130435,0.031480056634469074,651,Separation anxiety. Give him two asps and call me in the morning.
4198,7709,11,31,229,271,1.1955719557195572,0.029721196929171665,651,It’s a trend now. Ball Pythons are much cozier than a blanket for keeping patients warm while waiting your turn to be seen.
1397,7710,9,25,186,220,1.1954545454545455,0.03304005096446784,651,"I think we will skip the examination today, Mr. Smith, until you can unwind Mr. Snake."
2015,7710,5,33,182,220,1.1954545454545455,0.030423690868699546,651,"Think you're safe, snakes are not of interest to PETA."
2712,7710,6,31,183,220,1.1954545454545455,0.031098423858602578,651,It doesn't seem like anything serious but I'd like to do a blood panel to be sure.
3221,7713,8,35,218,261,1.1954022988505748,0.02899090855150327,651,It seems you're just a bit choked up
4979,7713,10,31,220,261,1.1954022988505748,0.02999029284906566,651,"I’m sorry Mr. Warren, could you repeat that? I can barely hear you."
296,7713,9,33,219,261,1.1954022988505748,0.029494833817249627,651,I think you misinterpreted the rules for the RuPaul Drag Race auditions
5469,7716,5,40,211,256,1.1953125,0.02774025370932723,651,Tightness in the chest suggests you have a chest cold
4708,7716,10,30,216,256,1.1953125,0.030376108216288125,651,I can't wrap my head around this.
1035,7716,8,34,214,256,1.1953125,0.029350186380391614,651,This should help you get your clothes back on.
1417,7716,8,34,214,256,1.1953125,0.029350186380391614,651,"In point of fact, we’ve received nothing but positive feedback on our new comfort blanket animal."
3331,7720,7,27,176,210,1.1952380952380952,0.03272232371404436,651,IT'S A PERSCRIPTION FOR CONSTRICTION
9000,7720,9,23,178,210,1.1952380952380952,0.03408646949287806,651,you say you can not recall when you first noticed this condition?
6998,7722,6,37,208,251,1.1952191235059761,0.028629871272066423,651,So how's your exposure therapy going?
1548,7723,4,40,202,246,1.1951219512195121,0.02781643183260897,651,It's an experimental trial designed to constrict excessive food intake.
3416,7723,5,38,203,246,1.1951219512195121,0.028406652129521044,651,"Yes, you have an acute case of Pythonitis!"
105,7725,5,37,199,241,1.1950207468879668,0.028757711364724724,651,I'm sorry but this doesn't seem to be covered by your HMO.
358,7725,7,33,201,241,1.1950207468879668,0.029935969270419506,651,I think you've got the two boas confused
2464,7725,6,35,200,241,1.1950207468879668,0.02935275301480526,651,And why do you blame #MeToo?
6366,7725,12,23,206,241,1.1950207468879668,0.03269637578105881,651,What do you know about tapeworms?
6524,7725,8,31,202,241,1.1950207468879668,0.030508038330427648,651,I'll have to call the Specialist - a Snake Charmer.
814,7730,7,32,197,236,1.194915254237288,0.030334681492999557,651,skipped the middleman & decided to wear the snakeskin directly?
2752,7730,7,32,197,236,1.194915254237288,0.030334681492999557,651,How long have you had this tightness in your chest ?                                  /
6000,7730,9,28,199,236,1.194915254237288,0.031501062754350516,651,I’m going to have to put you on a stricter diet.
996,7733,9,35,228,272,1.1948529411764706,0.028689825078314756,651,Let me guess... you were watching Crocodile Hunter reruns and decided to try it at home.
7504,7734,7,31,193,231,1.1948051948051948,0.03074878516427894,651,Tell me again where you’ve been getting your mud baths?
1388,7735,6,40,221,267,1.1947565543071161,0.02754151064475117,651,"I've consulted with the other three veterinarians in our practice.  Unanimously, we conclude a diet of humans is not good for constrictors."
6653,7736,7,37,218,262,1.1946564885496183,0.028378966262468257,651,Like I said last time this isn’t a veterinarian clinic
4789,7737,6,31,184,221,1.1945701357466063,0.030970017799925177,651,"Sorry, but payment is due before service may be rendered."
9073,7738,13,24,220,257,1.1945525291828794,0.0317380118697966,651,Pressure in the chestb is almost certainly a heart attack.
8690,7739,5,32,179,216,1.1944444444444444,0.030722471040200573,651,I've been feeling short of breath lately
2044,7739,5,39,208,252,1.1944444444444444,0.027966851618459066,651,As I told you. Just keep taking your heart tablets-they’ll ease that chest tightness
2287,7739,7,35,210,252,1.1944444444444444,0.029075486178441017,651,So obviously this treatment given to you by a witch doctor didn't cure your neck  pain!
3847,7739,9,24,183,216,1.1944444444444444,0.03340861438851245,651,"Look, we all get a little wrapped up in our own lives sometimes."
6343,7739,6,37,209,252,1.1944444444444444,0.02852655504930118,651,I've told you before that you will have problems if you get too wrapped up in your job.
6938,7739,6,37,209,252,1.1944444444444444,0.02852655504930118,651,Stay close to a bathroom though.
8825,7739,11,27,214,252,1.1944444444444444,0.031174703056169296,651,He's got You Under His Skin!
4845,7746,8,32,207,247,1.194331983805668,0.029996232270926952,651,Sorry. I’m genitourinary not veterinary. Wrong kind of snake.
7140,7747,8,31,203,242,1.1942148760330578,0.030392396436629467,651,Alrighty...the shamanic ceremony is next. Here's the prescription for the Ayahuasca.
6442,7747,4,39,199,242,1.1942148760330578,0.02804511105242235,651,"You say you have ""problems with relationships""?"
7571,7747,8,31,203,242,1.1942148760330578,0.030392396436629467,651,That's my Boa!
4455,7747,5,37,200,242,1.1942148760330578,0.02864996737777093,651,Your pet certainly hides your weigh gain!
5112,7747,9,29,204,242,1.1942148760330578,0.030951415766744563,651,"Sir, please remove the onseie."
6753,7752,7,39,227,273,1.1941391941391941,0.027635443109948452,651,"So, aside from assuming that you suffer from herpetophobia - any other complaints?"
7565,7753,6,34,197,237,1.1940928270042195,0.029620031078828064,651,So the nurse tells me you're having some throat constriction problems.  Is that correct?
2024,7753,4,38,195,237,1.1940928270042195,0.02838715958914429,651,"No, you’re not snakebit. It’s just a cold."
3013,7753,10,26,201,237,1.1940928270042195,0.03194334146975121,651,We had limited access for the usual tests but your varicose veins are about the same as last year.
318,7756,6,40,222,268,1.1940298507462686,0.027448172965307948,651,Take twice a day for severe cramping.
543,7756,7,38,223,268,1.1940298507462686,0.027952680302417033,651,So at what point did you realize that you had become obsessed with reptiles?
1873,7758,7,31,194,232,1.1939655172413792,0.030627472809354517,651,So your Great Uncle had high blood pressure and your Great Great Grandfather suffered from gout? Very interesting...
4468,7758,6,33,193,232,1.1939655172413792,0.030012049044533865,651,"If the rest of your Bucket List is this kinky, I can't think of anything to prescribe."
7783,7760,8,35,220,263,1.193916349809886,0.028789132079766598,651,Didn't I warn you about the dangers of eating a human based diet?
126,7761,5,34,188,227,1.1938325991189427,0.029771577738419996,651,"And there are no other changes, you are still on the same medication."
3078,7761,8,28,191,227,1.1938325991189427,0.031674932450321935,651,"This is not what I meant by ""hug therapy"" ."
57,7763,6,38,214,258,1.193798449612403,0.02808770577579973,651,Mardi Grad is traditionally ‘feather’ but you’re not the first patient I’ve seen to mix them up
4931,7764,5,39,209,253,1.1936758893280632,0.027866691652461723,651,Portion control is only half the battle.
2846,7764,9,31,213,253,1.1936758893280632,0.03003382909322971,651,Take three rabbits and feed them to Kaa.
4895,7764,6,37,210,253,1.1936758893280632,0.028423970522085187,651,"You know, the feeling of being crushed by your medical liabilities may not be your only problem.  Please put your gown back on now."
5904,7767,3,42,203,248,1.1935483870967742,0.02701633613880332,651,Think of all the money you’ll save on heating bills this winter
4603,7767,4,34,179,217,1.1935483870967742,0.02988819973358866,651,Try a different after shave lotion.
3946,7767,10,28,210,248,1.1935483870967742,0.030958544191528804,651,"Yep, it's the new crabs. Have you come in contact with any politicians?"
400,7767,8,32,208,248,1.1935483870967742,0.029885309647344965,651,"You know what they say; ""A forbidden fruit a day..."""
116,7771,8,31,204,243,1.1934156378600822,0.03027761701503675,651,It’s a gag reflex.
1575,7771,8,31,204,243,1.1934156378600822,0.03027761701503675,651,I’ll prescribe a new medication that specifically addresses chest constriction.
4297,7771,4,39,200,243,1.1934156378600822,0.02794089390174013,651,I see here that you believe you are snake bit.  We will need to do a CT Scan to check it out.
7280,7771,9,29,205,243,1.1934156378600822,0.03083414060954965,651,You have snakeskin syndrome.
6684,7775,4,33,175,212,1.1933962264150944,0.03030101550549056,651,I'll just prescribe something for the discomfort and you should be good to go.
377,7776,5,42,222,269,1.1933085501858736,0.026843595903802513,651,Are you sure you are just hear to check your cholesterol  ?
5496,7777,5,36,197,238,1.1932773109243697,0.028899505691895123,651,I'm going to prescribe a muscle relaxer. It should help you get some rest. Call me if the chest tightness doesn't go away
8483,7777,5,36,197,238,1.1932773109243697,0.028899505691895123,651,"The side effects are in: You’re all
tied up"
3251,7777,7,32,199,238,1.1932773109243697,0.030101426394141793,651,"Mr. Morrison, a snake skin suit that is pet-friendly is not recommended."
8364,7777,7,32,199,238,1.1932773109243697,0.030101426394141793,651,Do you have insurance for her?
5938,7781,4,43,217,264,1.1931818181818181,0.026605528000504138,651,Unfortunately this is not a good substitute for tummy tuck surgery.
9241,7781,10,31,223,264,1.1931818181818181,0.029676338916646516,651,I see you are experiencing the side-effects of my bill.
3487,7783,3,39,191,233,1.1931330472103003,0.027976571652173796,651,So how long have you had this constricting feeling?
7265,7783,7,31,195,233,1.1931330472103003,0.03050710136346971,651,It doesn't seem to want to negotiate.
948,7783,9,27,197,233,1.1931330472103003,0.03169669651078667,651,I'll write a prescription for frozen mice!
3823,7786,5,34,189,228,1.1929824561403508,0.02965290224967962,651,I'm giving you a prescription for a mild sedative. Call me in a couple of weeks if the problem hasn't cleared up and we'll run some additional tests.
6824,7786,6,32,190,228,1.1929824561403508,0.030297482972886057,651,Is your chest pressure present when you get up in the morning?
8923,7788,11,27,216,254,1.1929133858267718,0.030947615092873266,651,"Rest, check, ice, check, compression, check. Ok, next try elevation."
3859,7788,11,27,216,254,1.1929133858267718,0.030947615092873266,651,I just thought the down jackets were overpriced...
5028,7790,10,34,236,280,1.1928571428571428,0.02852979557599777,651,Always a good idea to lose 15 pounds and avoid getting wrapped up in other people's problems.  See the nurse on the way out.
3113,7791,6,31,186,223,1.1928251121076232,0.030716316601941063,651,I will note that you have a high deductible insurance plan
85,7791,5,33,185,223,1.1928251121076232,0.030051505154526342,651,Technology has afforded us many wonderful diagnostic tools.
408,7793,8,32,209,249,1.1927710843373494,0.02977519409576249,651,"So, I'm assuming that the prescription I gave you last time didn't help with your feeling all wound up?"
1690,7793,5,38,206,249,1.1927710843373494,0.028096251324905074,651,This is a boa constrictor. Asp-irin won't alleviate the pain.
7188,7793,5,38,206,249,1.1927710843373494,0.028096251324905074,651,She seems not angry but affectionate so I’m referring you to a professional psychologist.
4448,7796,6,30,182,218,1.1926605504587156,0.0311520970967718,651,"Lower back pain is notoriously difficult to treat, but we no longer recommend pythons or boas of any kind. Have you tried meditative yoga?"
383,7797,7,33,204,244,1.1926229508196722,0.029599271402550094,651,I'm updating your restrictions and limitations.
1391,7797,9,29,206,244,1.1926229508196722,0.03071774071127691,651,No excuses now on how hard it is to shed excess weight.
6284,7797,6,35,203,244,1.1926229508196722,0.029023878171948528,651,yeah yeah. .. you look fine. You'll take 2 of these pills for that problem with your voice and visit me in 2 weeks.
6913,7797,8,31,205,244,1.1926229508196722,0.03016369060614979,651,"I know you love your work, but shouldn't you be less wrapped up in your job?"
8782,7797,5,37,202,244,1.1926229508196722,0.028436844774313495,651,I've had other patients too wrapped up in their pets.  I'll give you a prescription for a trip to the Florida Everglades.
3445,7802,4,38,197,239,1.1924686192468619,0.028172432231037315,651,"I can give you some pain relievers, anything else?"
5969,7802,5,36,198,239,1.1924686192468619,0.028789693390693163,651,I had a feeling we could cure your gymnophobia with a support snake.
4298,7802,6,34,199,239,1.1924686192468619,0.029393995190308053,651,And your thought the snake was real cute before it got bigger?
976,7802,9,28,202,239,1.1924686192468619,0.031136609905399903,651,Is this a new diet fad or a fashion statement?
2500,7802,3,40,196,239,1.1924686192468619,0.027541340383043428,651,My blood pressure is off.
3453,7802,7,32,200,239,1.1924686192468619,0.02998612113904672,651,Here’s the number for our telemedicine practice.
3715,7808,8,29,197,234,1.1923076923076923,0.030985356652458367,651,And patient’s blood pressure?
4934,7808,9,32,219,260,1.1923076923076923,0.029445074383909163,651,"If the constriction persists, come back for another checkup."
9102,7808,8,34,218,260,1.1923076923076923,0.02893635042250342,651,"Sorry, no snake oil prescribed here."
4814,7808,5,35,194,234,1.1923076923076923,0.029155531319670653,651,"I don't care if it's all the rage at Fashion Week, you must understand the serious risk it poses to your respiratory health."
6616,7812,8,28,193,229,1.1921397379912664,0.031420398915710405,651,"Such a remarkable example of imprinting, can I take you to my next conference?"
7088,7812,7,30,192,229,1.1921397379912664,0.030804806404349367,651,You are not leaving until the bill is paid.
4416,7812,7,30,192,229,1.1921397379912664,0.030804806404349367,651,I ordered a feather boa from Amazon and this is what I got.
3303,7812,9,26,194,229,1.1921397379912664,0.032024160229978046,651,I understand your hesitation but low blood pressure is very difficult to treat.
3201,7812,5,34,190,229,1.1921397379912664,0.029535154592173374,651,"Some specialists might think it strikes the right note of middle aged whimsy, some might not."
1946,7812,7,30,192,229,1.1921397379912664,0.030804806404349367,651,"I understand that you wanted to wear a boa to the opening of La Cage aux Folles, but next time try a feather boa, okay?"
3599,7812,4,36,189,229,1.1921397379912664,0.028879404190021787,651,I'll concede you haven't been scratching your rash as much but....
4488,7819,6,36,208,250,1.192,0.02856233934599305,651,"So what seems to be the problem?    I’m sorry, I couldn’t hear you."
5398,7819,4,40,206,250,1.192,0.027414415930367964,651,Mark didn't think much of Florida's python problem until things got personal.
4565,7821,7,29,188,224,1.1919642857142858,0.03123855835201923,651,"I am prescribing this OTC lotion for your snake-like skin issue. If you feel the tightness persist for more than 4 days, please see me again."
4055,7822,8,31,206,245,1.1918367346938776,0.030050607885401658,651,I think a laxative will do!
4820,7822,5,37,203,245,1.1918367346938776,0.028331449278554067,651,This anti-anxiety medication should fix you right up.
5267,7822,9,29,207,245,1.1918367346938776,0.0306022064504363,651,How long have you had this feeling of being compressed?
8163,7825,9,33,224,266,1.1917293233082706,0.028985250824771578,651,How is that weight control program going?
1214,7826,6,34,200,240,1.1916666666666667,0.0292822475784391,651,Looks like you're still using python 2.
7612,7827,4,33,177,214,1.191588785046729,0.03004423187288446,651,The convenient thing to do is take a cold shower .
5916,7828,8,29,198,235,1.1914893617021276,0.030864072857181554,651,Ah like your man wrap.  Anaconda like your painted toenails.
5110,7828,3,39,193,235,1.1914893617021276,0.027762199978610815,651,I'm pleased to tell you this is only a  fake snake--pay no attention to it and it will go away.
991,7828,6,33,196,235,1.1914893617021276,0.029662273936112822,651,I would recommend laying off the python yoga classes for awhile.
1518,7828,5,35,195,235,1.1914893617021276,0.029042731378518642,651,"You live in a swamp, you love in a swamp."
1274,7828,10,25,200,235,1.1914893617021276,0.03202079779777238,651,I'll schedule a colonoscopy to find what what sort of bowel obstruction we're dealing wth.
4594,7828,5,35,195,235,1.1914893617021276,0.029042731378518642,651,And how long has this been going on?
207,7834,5,39,212,256,1.19140625,0.027570401681267204,651,Ok well look like that wraps this up.
2193,7834,7,35,214,256,1.19140625,0.02866010395428361,651,"Speaking as a veterinarian, I would suggest you feed the snake every day. Speaking as a friend, I would suggest you don't wear that cape over the snake."
1774,7836,6,32,192,230,1.191304347826087,0.030056780863259667,651,"In my two days at working here,​ I have never seen someone using a snake as a t-shirt."
986,7837,11,26,214,251,1.1912350597609562,0.03113285172094699,651,"I'm sorry, I can't help you anaconda this qualifies as a pre-existing condition."
3306,7837,5,38,208,251,1.1912350597609562,0.027892999059217632,651,It’s it’s the latest cure for IBS.
3995,7837,11,26,214,251,1.1912350597609562,0.03113285172094699,651,"I had the same problem so I bought my python a heated mannequin. It worked for me. Here's a prescription and remember, you can write it off as a medical deduction."
7459,7840,6,31,188,225,1.191111111111111,0.030466681717662685,651,I’m writing you a prescription for a lifetime supply of Aleve
6887,7840,6,31,188,225,1.191111111111111,0.030466681717662685,651,Immobilized by Severe and acute pain....Vicodin should do it. Come back if it persists.
6953,7840,9,25,191,225,1.191111111111111,0.03236149430933283,651,Amazing medical Hissss...tory!
4870,7843,15,17,214,246,1.1910569105691058,0.03359454444321733,651,hmm- - - and do you have any more pet peeves?
6784,7843,6,35,205,246,1.1910569105691058,0.02880863357680014,651,How long have you had this constricting symptom?
9214,7843,9,29,208,246,1.1910569105691058,0.030487528343417065,651,He's a professional hugger
3350,7846,11,29,227,267,1.1910112359550562,0.02984439264465239,651,It says on your chart that you feel you are in a right squeeze. Do I have that right?
3767,7847,10,26,205,241,1.1908713692946058,0.03145281131747394,651,"No, I'm not sure why your aortic valve is constricting...do you smoke?"
6677,7847,9,28,204,241,1.1908713692946058,0.030898239321380028,651,Is this love at first bite?
5776,7849,9,32,221,262,1.1908396946564885,0.029238233751986385,651,Take two asp-irin and I'll see you in the morning.
4980,7850,5,35,196,236,1.1906779661016949,0.028930787598471352,651,I need you to go all the way down to your skivvies.
3794,7851,4,41,212,257,1.1906614785992218,0.02691407652190062,651,"Actually, we find it's more common than you'd first think."
1386,7852,8,37,233,278,1.1906474820143884,0.027655368548774956,651,Most people are wrapped up in their own world
9146,7853,6,32,193,231,1.1904761904761905,0.029937838736282443,651,I’m sorry Senator. There’s nothing That I can do.  I’ll have to refer you to a herpetologist.
513,7853,7,34,211,252,1.1904761904761905,0.028907778002770567,651,Take two Advil and call back tomorrow if the difficulty breathing persists.
0,7855,7,33,207,247,1.1902834008097165,0.02926996505266532,651,Good news. Your body is starting to reap the rewards of those regular forest walks.
194,7855,5,37,205,247,1.1902834008097165,0.02812294857165409,651,Another weight loss fad strikes again..
228,7855,8,31,208,247,1.1902834008097165,0.029826936870795556,651,I'm going to recommend this organic compression jacket.
917,7855,5,37,205,247,1.1902834008097165,0.02812294857165409,651,Don't you know that animal skin clothing is no longer P.C.?
2199,7855,5,37,205,247,1.1902834008097165,0.02812294857165409,651,it is just her way to show affection
2260,7855,11,25,211,247,1.1902834008097165,0.03143870369186595,651,Exactly what drug company do you represent?
2460,7855,4,39,204,247,1.1902834008097165,0.027531526064744884,651,Let's try a ten-day course of  antibiotics and see how it goes.
8205,7855,9,29,209,247,1.1902834008097165,0.03037369704208886,651,I’m going to go ahead and cancel this prescription I made for you when I was told you were coming in because of your snake.
8866,7863,9,25,192,226,1.1902654867256637,0.03222907927707696,651,We care unable to treat you because there is no billing code for your condition.
2885,7863,9,25,192,226,1.1902654867256637,0.03222907927707696,651,you seem a bit wrapped up in yourself today.
4532,7865,5,32,184,221,1.1900452488687783,0.03008902858257497,651,"Sorry for the delay, I have been wrapped up, uh, tied, uh busy, with some other patients....."
7024,7865,9,24,188,221,1.1900452488687783,0.032709188037231114,651,"We’ll get that hideous thing off you in no time... TWIST, I’m talking to the snake!!"
7340,7867,8,37,234,279,1.189964157706093,0.027564538183437803,651,Take two asp-irin and kaa me in the morning.
2036,7868,8,33,217,258,1.189922480620155,0.028981910086492247,651,The anesthesiologist called it sick. Only a matter of seconds now.
5662,7869,6,33,198,237,1.1898734177215189,0.029433522796688705,651,Ssssnakes don’t have sssssssurmames that’s just ssssssssilly
7241,7869,7,31,199,237,1.1898734177215189,0.03003481263482079,651,Just tell your wife you are tied up at work.
8551,7871,5,31,180,216,1.1898148148148149,0.030505923724244707,651,So. Any allergies that you know of?
530,7872,9,30,214,253,1.1897233201581028,0.029872389107242714,651,"If Eve gave you the apple, who gave the snake Eve?"
3526,7872,9,30,214,253,1.1897233201581028,0.029872389107242714,651,"'Received the 2.4.19 issue in the mail today 2.5. I have a caption for the contest. But, it's too late -- Not fair! Here it is anyway:
Hug the machine, hold your breath. First Manogram?"
3678,7874,5,34,193,232,1.1896551724137931,0.029187373201433893,651,"Now, when did you start to notice these asthma symptoms?"
7855,7875,6,39,224,269,1.1895910780669146,0.02719854903202003,651,Sequeezing chest pain ?? I don't think it's your heart..take this.
322,7876,6,28,177,211,1.1895734597156398,0.031660956954055346,651,Are you still eating these apples?
6371,7877,10,27,211,248,1.189516129032258,0.030795454680596163,651,"It's a little bigger than Trump's tie, but I don't like the color."
8302,7877,9,29,210,248,1.189516129032258,0.030260703331450776,651,We're moving to a BigFarma approach to pain management.
8766,7877,8,31,209,248,1.189516129032258,0.02971633058174411,651,So I’m gonna have you start a gluten free diet and we’ll see how your body reacts in five to six weeks.
7400,7877,6,35,207,248,1.189516129032258,0.02859651338017186,651,"I am referring you to a Dermatologist, for scaly skin"
1221,7881,6,31,190,227,1.1894273127753303,0.030221017863049243,651,You could have saved yourself a lot of trouble if you'd turned up the heat.
8172,7881,5,33,189,227,1.1894273127753303,0.02956898858228866,651,Let me scale back your dosage.
8518,7883,7,36,221,264,1.1893939393939394,0.02802458033964575,651,"Definately, Python bivittatus."
8732,7884,9,28,206,243,1.1893004115226338,0.030663451728015226,651,"They promised you feathers?"""
8106,7884,7,32,204,243,1.1893004115226338,0.02953348949643181,651,I understand you picked up the snake in church and he's listed as a boa conscripture.
8193,7884,8,30,205,243,1.1893004115226338,0.030103772801030836,651,"Yes, you are correct, Google does say Hulk Hogan wore a boa."
3644,7884,9,28,206,243,1.1893004115226338,0.030663451728015226,651,And the ladder you put where?
4043,7888,3,36,183,222,1.1891891891891893,0.02857265620923916,651,"Sorry sir, you need to see a doctor. I'm a vet"
4810,7888,7,28,187,222,1.1891891891891893,0.031296256476450526,651,"As your veterinarian, I would advise you to change your diet, have you considered vegan?"
5883,7888,6,30,186,222,1.1891891891891893,0.03063806330029155,651,"You know, you wouldn't be here if you had taken more than just a bite out of that apple."
6462,7888,6,30,186,222,1.1891891891891893,0.03063806330029155,651,I respect your passion but there has got to be a better way to grow your collection.
6545,7888,6,37,216,259,1.1891891891891893,0.02782341090938443,651,"As your vet, I advise you to reduce your caloric intake."
8487,7888,6,30,186,222,1.1891891891891893,0.03063806330029155,651,They crave warmth during the winter.  Try wrapping him around a radiator.
3199,7894,9,30,215,254,1.188976377952756,0.029763922789938845,651,Here is a prescription for the pain.  I'm referring you to a specialist.
2039,7894,6,36,212,254,1.188976377952756,0.028151790780997988,651,"Like you, I’m having trouble wrapping my arms around your condition"
4370,7894,7,34,213,254,1.188976377952756,0.028699231976945582,651,Take two moth balls every six hours and it should go away in a few days.
3842,7897,6,29,182,217,1.1889400921658986,0.031071994722885358,651,"Yes, I do find you to be a little constricted. But, no....a colonoscopy will not be necessary."
8918,7897,5,31,181,217,1.1889400921658986,0.030377614431533435,651,Why did you think it would make loving pet??
6776,7899,6,39,225,270,1.1888888888888889,0.027106722920032203,651,Your blood pressure problem is one for the books.
6821,7900,7,30,196,233,1.1888412017167382,0.030319138655253684,651,Seems he has a problem holding things down
8977,7900,4,36,193,233,1.1888412017167382,0.02842981119621879,651,"Let's see..no more constipation, no more gas.  That's good, but I'm concerned about this sudden gain in weight."
2515,7902,9,29,211,249,1.1887550200803212,0.03014853812732781,651,"We'll have to wait for The Year of The Snake to treat this."""
750,7903,8,34,223,265,1.1886792452830188,0.028434983400002042,651,Oy. Bodega on 233rd?
7074,7903,10,30,225,265,1.1886792452830188,0.029423184902930437,651,"Hmm, you say you tend to feel constricted somewhat?"
3475,7905,7,32,205,244,1.1885245901639345,0.029422431900882517,651,My gravest concern is your eight missing vertebrae.
737,7905,5,36,203,244,1.1885245901639345,0.02825273034803274,651,"For my money, close fitting pants would be your better bet against ticks."
3076,7905,8,30,206,244,1.1885245901639345,0.029990179432337158,651,I could get out if I wanted to.
4430,7908,6,37,217,260,1.1884615384615385,0.027725741293159176,651,"Good news, the treatment lowered your cholesterol...Bad news, your insurance will not cover it."
256,7909,8,26,189,223,1.188340807174888,0.03180864991225482,651,"Let's not creep around the subject, you've put on some weight."
7995,7909,9,24,190,223,1.188340807174888,0.032437468347245375,651,How long has your anaconda rescue been with you?
8350,7911,6,33,200,239,1.1882845188284519,0.029208225488959627,651,"Well, yes, same spelling..."
5582,7911,8,29,202,239,1.1882845188284519,0.03038817947244247,651,It’s time for me to wrap this up!
8867,7913,7,34,214,255,1.188235294117647,0.028596068844301756,651,I applaud you for trying to find a natural alternative to prescribed antidepressants. Unfortunately snake hugs don't raise endorphin levels.
8157,7914,10,18,174,202,1.188118811881188,0.03538979991112887,651,Exactly what do you want me to do?
5363,7915,6,38,222,266,1.1879699248120301,0.027317146052007444,651,"I'm sorry, but we only have rattlesnake antidote in stock."""
975,7916,6,31,192,229,1.1877729257641922,0.029979232639360608,651,It feels like I'm suffocating.
542,7917,5,36,204,245,1.1877551020408164,0.028147696687431976,651,Quitting smoking will help reduce your high blood pressure
1160,7917,6,34,205,245,1.1877551020408164,0.02873584580555495,651,I’m not sure what you want me to do. Most people would kill for a large snake.
7172,7917,6,34,205,245,1.1877551020408164,0.02873584580555495,651,Your symptoms are common these days. There’s a new parasite. . . .
7710,7917,3,40,202,245,1.1877551020408164,0.026932894721914822,651,"Yea, I read the bible too. But my take away was to just stay away from snakes."
4537,7921,7,34,215,256,1.1875,0.028493635340229244,651,"Well, your weight isn't the problem I thought it was..."
9044,7921,4,37,199,240,1.1875,0.02787277456702429,651,I'm not that type of healer. Perhaps try oil or charming it.
8957,7921,10,28,218,256,1.1875,0.03006325031675456,651,"Well Fred, it looks like you have put on some weight."
8835,7921,8,26,190,224,1.1875,0.031677489243811606,651,"Mr. Snake, I'm afraid you have the disease Human."
7284,7925,9,32,226,267,1.1872659176029963,0.02873348653204399,651,I really can't examine you until you unsnake.
9178,7925,8,34,225,267,1.1872659176029963,0.028239209619353736,651,"If you can't get unwound, I don't think I can be of much help."
127,7925,8,34,225,267,1.1872659176029963,0.028239209619353736,651,I’m writing you a lifetime prescription for Mice-i-cillin...please fill it ASAP!
3046,7928,6,35,210,251,1.1872509960159363,0.02828404677179099,651,So you have the feeling that everyone is running circles around you.
9237,7928,4,39,208,251,1.1872509960159363,0.02713378487916018,651,"Sorry, but sometimes we have to adapt to circumstances."
8883,7928,5,37,209,251,1.1872509960159363,0.02771488394037942,651,So you're not quite feeling like yourself - any reason why?
4739,7928,4,39,208,251,1.1872509960159363,0.02713378487916018,651,Time to remove the compression sleeve.
5233,7928,9,29,213,251,1.1872509960159363,0.029926657542554573,651,I'm sending you to a marriage counselor.
517,7933,5,34,196,235,1.1872340425531915,0.028847569284775575,651,"So everything on your chart looks normal. You said you're feeling some stomach pressure?"""
608,7933,9,26,200,235,1.1872340425531915,0.03126760704282874,651,Your kegel exercises have gone a little too far.
4459,7935,9,31,222,262,1.1870229007633588,0.029082234141185465,651,"Our tests, Mr. Daniels, show absolutely nothing wrong with you that would cause the upper body pressure you say you have. If  in six months you somehow still feel the pain we could, perhaps, run the tests again. Thank you for coming in."
380,7936,7,32,207,246,1.1869918699186992,0.029202773114663686,651,"Basically, I can't find any issues, but I want to refer you to an excellent herpetologist I know who'll call you at home to schedule an appointment."
1060,7936,6,34,206,246,1.1869918699186992,0.02862897050676261,651,So how've you been feeling lately?
2379,7936,5,36,205,246,1.1869918699186992,0.028043429657722725,651,I’m going to refer you to a good snake charmer...but call me if you hear a rattle!
2388,7936,5,36,205,246,1.1869918699186992,0.028043429657722725,651,"Your trouble is stress, and you need to uncoil."
4131,7936,9,28,209,246,1.1869918699186992,0.030317816019716955,651,Now can I see your snake?
6912,7936,3,40,203,246,1.1869918699186992,0.026834044353186138,651,I'd recommend fasting. Be sure to drink lots of fluids and see me in two weeks.
7455,7942,5,33,192,230,1.1869565217391305,0.02921700479822466,651,I can’t treat you until you sbow proof of insurance.
7705,7942,12,19,199,230,1.1869565217391305,0.03345802341782132,651,I'm afraid we may need to amputate. No more Viagra for you.
5250,7944,8,35,230,273,1.1868131868131868,0.027820464236698005,651,"I'm a charmer, but you need to see a Herpetologist."
9213,7945,5,38,214,257,1.1867704280155642,0.02730025047611621,651,You have ssssssss-evere hypertension.
5467,7945,9,30,218,257,1.1867704280155642,0.02944314872424454,651,Do you think it a coincidence that your surname is Asclepius?
6119,7947,4,37,200,241,1.1867219917012448,0.027767780359562188,651,You'd feel better if you would loose a few pounds.
5335,7947,7,31,203,241,1.1867219917012448,0.029576748738340267,651,I've told you before. There's nothing we can do until you lose some weight.
7334,7947,4,37,200,241,1.1867219917012448,0.027767780359562188,651,"You didn’t read my ‘What to watch for’ DC pamphlet, did you?"
2734,7950,7,28,190,225,1.1866666666666668,0.030912061651652355,651,"No thank you, the snake is less constricting than medical debt."
5421,7950,5,32,188,225,1.1866666666666668,0.029600514796038205,651,I recommend less snug-fitting garments.
3502,7952,7,25,177,209,1.186602870813397,0.032430983327217215,651,Most Pyton programers dont get this wraped up in their work
8446,7952,5,29,175,209,1.186602870813397,0.03097991978140444,651,You'll be fine - Just drink more water.
1885,7954,13,21,218,252,1.1865079365079365,0.031867337641774615,651,"No shirt, no shoes, no service."
4858,7955,3,38,195,236,1.1864406779661016,0.02745241766504685,651,I’m giving you a referral to a veterinarian.
4966,7955,10,24,202,236,1.1864406779661016,0.031718597422608,651,"Well, in fact, this is actually dangerous, despite the familiar feeling it gives you as a teacher."
7835,7955,9,26,201,236,1.1864406779661016,0.03114494173652561,651,It says here your boss told you to learn Python.
5253,7958,3,35,182,220,1.1863636363636363,0.02858177075572493,651,"If your health insurance covered you as well as your current medical condition, I would be able to cure you."
4780,7959,7,35,221,263,1.1863117870722433,0.02796068970592235,651,"You don't by any chance own a pet boa constrictor, do you?"
8299,7959,6,37,220,263,1.1863117870722433,0.027436747624562125,651,"Unusual,yes, but it is the only treatment that has a chance"
2296,7961,5,36,206,247,1.1862348178137652,0.02793992105656284,651,"When your wife said, ""have you seen my boa?"" Why didn't you tell her?"
8088,7962,7,29,195,231,1.1861471861471862,0.030367493478813647,651,The boa that you wanted came with feathers.
8496,7962,9,25,197,231,1.1861471861471862,0.031582775242124626,651,Do you a family history of ringworm?
2790,7964,8,32,218,258,1.186046511627907,0.028819086237695524,651,"I'm afraid you're a snake in snake's clothing, Mr. Cohen."
7576,7964,9,30,219,258,1.186046511627907,0.02933773874031164,651,"Sir, I'm sorry to inform you  but you have snakewrapedaroundyoutoses"
8448,7966,2,41,199,242,1.1859504132231404,0.026394845990761355,651,Not feeling well -- my chest seems a little tight.
4386,7967,6,38,225,269,1.1858736059479553,0.027038824628047384,651,She’s keeping me warm during this polar vortex.
1786,7968,9,24,193,226,1.1858407079646018,0.03203816868999519,651,This way provides a much higher concentration of snake oil.
6040,7968,5,32,189,226,1.1858407079646018,0.029480820645779317,651,I think we should begin by increasing the dose of your blood pressure medication.
8073,7968,4,34,188,226,1.1858407079646018,0.028806030951583957,651,You've gained weight. What's up?
4788,7968,7,28,191,226,1.1858407079646018,0.03078606047350973,651,All your tests seem to be normal.  Nothing which would explain the constricted breathing you are experiencing.
989,7972,5,37,211,253,1.1857707509881423,0.027515195712540363,651,Cut down on red meat and come back in 6-8 weeks and we will re-evaluate.
2834,7972,4,39,210,253,1.1857707509881423,0.026939123937359425,651,"In my medical opinion, your definition of unconditional love goes out the window when a pet is trying to kill you."
954,7974,2,40,195,237,1.1856540084388185,0.02668588742758126,651,"The good news is those strange growths should just eventually fall off, Mr. Kaa."
5460,7974,3,38,196,237,1.1856540084388185,0.02734765608938244,651,Weight loss program? But you put on eighty pounds.
2631,7976,3,35,183,221,1.1855203619909502,0.028464641426982018,651,"doc, I think I picked up a man"
4009,7976,4,33,184,221,1.1855203619909502,0.02917826497274372,651,Idea for sustainable clothing:...
4967,7978,8,30,210,248,1.185483870967742,0.02954415713971961,651,"I'm sorry to tell you Mr. Lewis, that's a metaphoricobra. It appears you've been getting a little wrapped in distractions... Hah! Just kidding! I don't know what to do... Go see a vet or something, I dunno.."
4309,7978,9,28,211,248,1.185483870967742,0.030091644753436477,651,"Blood pressure, heart rate, respiration, and blood oxygen levels --- not only are we doing intake with fewer employees, but now we're doing it without expensive equipment."
702,7978,4,38,206,248,1.185483870967742,0.02724440804301208,651,Come on. It's not THAT cold in here.
5899,7981,4,35,193,232,1.1853448275862069,0.028335870609127414,651,Keeping warm?
7693,7981,5,33,194,232,1.1853448275862069,0.028986903353298277,651,"So, for how long now have your blood vessels been constricted?"
316,7983,6,36,217,259,1.1853281853281854,0.0276546879398618,651,i was cold with no blanket
1744,7983,7,34,218,259,1.1853281853281854,0.028190637231881435,651,Your body temperature is up a couple of degrees. Other than that . . .
1629,7985,5,35,203,243,1.1851851851851851,0.028170371263773593,651,Take two aspirins and call me in the morning
1718,7985,9,22,185,216,1.1851851851851851,0.033006339469051495,651,You seem to have gained weight around your tummy.
4052,7985,9,27,207,243,1.1851851851851851,0.03048951224962094,651,I'm referring you to a psychiatrist for your uptightness.
6294,7985,7,31,205,243,1.1851851851851851,0.02935285483865774,651,He’s poisoness so just be thankful he hasn’t bitten you.
2013,7989,5,37,212,254,1.18503937007874,0.027416411254684855,651,How lomg have you two been palling around?
5622,7989,6,35,213,254,1.18503937007874,0.027978245083912303,651,"Now stick out your tongue and say, ""AAAAHHHH!"""
7596,7991,4,34,189,227,1.1850220264317182,0.028690534262439865,651,Looks like you're going to have to contact the belt manufacturer.
8109,7991,4,34,189,227,1.1850220264317182,0.028690534262439865,651,Tell him to hold on and I'll get you a sweater.
641,7991,4,34,189,227,1.1850220264317182,0.028690534262439865,651,Ah! A B-oh-a! The nurse misunderstood yours as a much more severe condition. I'll be right back.
2297,7991,4,34,189,227,1.1850220264317182,0.028690534262439865,651,I thought you LIKED mamba-care for all
8051,7995,7,30,201,238,1.184873949579832,0.029732925232177174,651,Are you the proctologist removing the feeder mice?
6351,7995,7,30,201,238,1.184873949579832,0.029732925232177174,651,Weight gain can really snake up on you.
6418,7995,8,28,202,238,1.184873949579832,0.030323325406776656,651,"Well, bend over so we can get this prostrate exam started."
8664,7995,11,22,205,238,1.184873949579832,0.03202929481450306,651,"Since you have elected for ""Non-General Anesthesia"", side effects may include redness of the face, loss of breath, and Everglades destruction."
2873,7999,7,32,210,249,1.1847389558232932,0.028879293677626067,651,"No,no,you have to say feather boa."
6430,7999,8,30,211,249,1.1847389558232932,0.029434694126058217,651,"I'm sorry, it's too late for surgery. Physical therapy might help, plus I can recommend a fashion consultant."
3986,8001,8,25,189,222,1.1846846846846846,0.0317404864429728,651,You'll be OK. You just need a hug.
7395,8001,7,27,188,222,1.1846846846846846,0.031091698779408,651,I'm going to have to put you on a strict diet. You've gained 100 pounds in the past 3 months.
7749,8003,8,32,220,260,1.1846153846153846,0.02861480338309397,651,"There are some fractured bones in your ankle, but everything else is great."
587,8004,4,30,172,206,1.1844660194174756,0.030385591784077126,651,"It might seem dangerous, but again,  it all comes with side effects."
1564,8005,5,35,204,244,1.1844262295081966,0.028064945398596244,651,I'm sending you to the dermatologist for your scaly skin condition
4802,8005,6,33,205,244,1.1844262295081966,0.028659597409033816,651,I take it you're a Slytherin?
8342,8007,9,22,186,217,1.1843317972350231,0.03286496604506093,651,"I said ""aspirin"", not ""asp""."
8594,8008,9,31,226,266,1.1842105263157894,0.02867818717742321,651,"Now, you say you work for The Laocoon Group?"
3816,8008,4,34,190,228,1.1842105263157894,0.028575946233171747,651,This will give you some emotional support while you tame that screen addiction.
8208,8008,7,35,224,266,1.1842105263157894,0.02767115433270209,651,I have bad news.  It's a wrap.
4216,8011,3,38,198,239,1.1841004184100419,0.027140473115473147,651,"I can see that you are wrapped up right now, you owe $1,500, where should I send your bill?"
1461,8011,6,32,201,239,1.1841004184100419,0.029018731951705175,651,I know you don't like your body.  I don't either.
9196,8013,4,40,217,261,1.1839080459770115,0.02636556740538817,651,"I have some medication for you, but the side effects are rather restrictive."
6493,8013,5,38,218,261,1.1839080459770115,0.02691868473520974,651,"Ok, Mr. Cole, so you're liking how the new medication has slowed down your hair loss, but now you're shedding skin?"
1493,8015,4,33,186,223,1.1838565022421526,0.028939804587842503,651,So how’s the weight loss going?
7065,8016,7,29,198,234,1.1837606837606838,0.03000870794174302,651,"I rarely prescribe it, but yours is the worst case of constipation I've ever seen."
776,8016,6,31,197,234,1.1837606837606838,0.029391157041139333,651,"Our xray tech just went to lunch, can you hold on a few minutes?"
2706,8016,4,35,195,234,1.1837606837606838,0.028115391371721664,651,"Mr. Wilson, treatments have come a long way since the days of snake oil."
5914,8019,7,33,216,256,1.18359375,0.02832407587824566,651,I'm sorry to tell you that your condition has reached the Oh Heck Stage.
5570,8019,6,35,215,256,1.18359375,0.02777797723835659,651,The diet I have suggested is very effective for weight loss.
824,8019,7,33,216,256,1.18359375,0.02832407587824566,651,It says here you are feeling a tightness in your insides?
5302,8022,6,37,224,267,1.1835205992509363,0.027060542615401716,651,I don't think you should stick with this snake charmer business.
3415,8023,4,32,182,218,1.18348623853211,0.029317606615137472,651,We will X-ray to see if a tumor is causing your recent weight gain.
8245,8024,5,32,192,229,1.1834061135371179,0.029127399631969943,651,"Side effects include headaches, dizziness, and dry mouth."
3640,8024,7,28,194,229,1.1834061135371179,0.03041407815710262,651,Have you been getting your 30 minutes of cardio?
5891,8024,8,26,195,229,1.1834061135371179,0.031037421293646134,651,Your PETA values are dangerously low.
1264,8024,5,32,192,229,1.1834061135371179,0.029127399631969943,651,And you say this happened after climbing a ladder?
1543,8028,3,40,208,251,1.1832669322709164,0.02635029762845522,651,I counsel patience since you're due to moult in another 6 weeks
3956,8028,6,34,211,251,1.1832669322709164,0.0281061508390717,651,Do you feel like you're suffocating or feel like you're trapped? I'll just go ahead and prescribe a different pill for each.
7582,8030,9,30,223,262,1.183206106870229,0.02892346349959378,651,"Feeling a tad constricted?"" ""Take two aspirin and call me in the morning."
5341,8030,4,40,218,262,1.183206106870229,0.026274120858733138,651,Your life's too stressful; you need ti unwind a bit.
3295,8030,6,36,220,262,1.183206106870229,0.027364655168017792,651,"With your anxiety, Fred, a weighted blanket just isn't going to cut it."
2187,8030,7,34,221,262,1.183206106870229,0.027893938682931215,651,Beastiality?
290,8034,9,32,232,273,1.1831501831501832,0.028150087470890085,651,I see you wrote slithery here?
6914,8035,5,33,197,235,1.1829787234042553,0.02864837681854701,651,I think it might be too late to see if the pet store will take it back.
8807,8035,8,27,200,235,1.1829787234042553,0.030493281911694606,651,"If we leave that mortal coil, you'll soon be shuffling off this mortal coil."
983,8035,9,25,201,235,1.1829787234042553,0.031083926567959334,651,"Sir, you must stop imagining there's a snake wrapped around your body. You're making an asp of yourself."
7293,8038,5,35,206,246,1.1829268292682926,0.02785641104578735,651,Take two asprine and call me in the morning.  You might also try having your dog sleep on the bed with you.
7257,8038,9,27,210,246,1.1829268292682926,0.030144910973323953,651,"No, I’m sure you’re usually a very charming date."
7165,8038,8,29,209,246,1.1829268292682926,0.029589384114580453,651,I ‘m sorry. I don’t see anything in your work-up that would cause tightness in the chest.
1676,8041,8,33,227,268,1.1828358208955223,0.027985307543704364,651,This will require the escape of a lifetime Mr Plissken
2919,8041,4,41,223,268,1.1828358208955223,0.025910941520775197,651,"Yes, we're all having tight times"
230,8043,8,37,245,290,1.1827586206896552,0.026602957990849132,651,You look a little tense - to start with I'm going to suggest you try a bit of mindfulness...
2027,8044,2,34,172,208,1.1826923076923077,0.02853479930145945,651,The feather boa will feel far less constricting. Use only as needed since it may stimulate an adverse reaction in some people.
3997,8045,5,30,184,219,1.182648401826484,0.02990428642784214,651,"In most cases like this, we see the results of having trusted a snake _oil_ salesman."
1413,8045,3,34,182,219,1.182648401826484,0.028468977435022427,651,"I recommend you take some ASP-perin, scale back on eating
and hiss me in the morning."
5391,8047,5,32,193,230,1.182608695652174,0.029011443367433373,651,This is why you should have never skipped transfiguration class
3742,8048,7,30,204,241,1.1825726141078838,0.02939183141855002,651,These new dating apps are ruining evening shifts
5954,8049,8,30,214,252,1.1825396825396826,0.02911106704369562,651,How did you put that coat on?
8349,8049,5,36,211,252,1.1825396825396826,0.027433475241515227,651,And how long have you had the dry cough?
470,8051,8,34,232,274,1.1824817518248176,0.027574496010903428,651,How long have you been a boa constrictor?
2843,8052,4,33,188,225,1.1822222222222223,0.028705154426558264,651,"So let's see, your Great-Grandfather Adam was afraid of snakes."""
7137,8052,2,37,186,225,1.1822222222222223,0.02728774104405636,651,"'Extreme' burlesque, you say."
7062,8054,5,33,198,236,1.1822033898305084,0.028537261637905376,651,So now the stethoscope wasn’t too cold?
7557,8054,3,37,196,236,1.1822033898305084,0.027244288363223332,651,"This will help with the constriction, and next time, try some leather boots."
8854,8054,9,25,202,236,1.1822033898305084,0.030961644151011502,651,The dyspnea could also be your hay fever.
6854,8057,6,33,208,247,1.1821862348178138,0.028340080971659916,651,"I'll prescribe you some diet pills, see how that unravels."
1784,8058,8,33,228,269,1.1821561338289963,0.027889362349143913,651,"Mr. Beekman, please remain very still, please speak very softly and please find something casual to wear after the unwinding?"
8798,8059,5,30,185,220,1.1818181818181819,0.02977962252882277,651,"Well, Dr Dolittle, I think you are not a Parcelmouth, after all."
7912,8059,7,28,196,231,1.1818181818181819,0.030170990327203887,651,I imagine she won't mind a little Botox
7885,8059,8,30,215,253,1.1818181818181819,0.029004750383908786,651,Sometimes I feel like you just want to squeeze one more copay out of me.
6565,8059,7,32,214,253,1.1818181818181819,0.028458846572654153,651,I've been feeling very ssssick.
2524,8059,7,32,214,253,1.1818181818181819,0.028458846572654153,651,You must deal with your enmeshment issue first.
2643,8059,5,28,176,209,1.1818181818181819,0.030744544585699186,651,"You're having trouble breathing? You may have pneumonia, bronchitis, or snake-itis."
140,8059,4,36,202,242,1.1818181818181819,0.027466930838774092,651,I am afraid the only snake-related health problem covered by your insurance is Salmonella infection. Have you experienced any nausea recently?
6772,8059,11,20,200,231,1.1818181818181819,0.0325708876290127,651,"I’m going  to refer you to Dr. Boa, she’s a wonderful herpetologist over at St. Vincent’s"
882,8059,7,30,205,242,1.1818181818181819,0.02927984665458322,651,"Er...you married, sir?"
6693,8068,10,29,231,270,1.1814814814814816,0.02876775530191637,651,The lab report says serpentines
4888,8069,6,33,209,248,1.1814516129032258,0.028235133442846932,651,"Well, it’s a little unorthodox, but there’s no question you’ve got s COBRA account!"
6573,8069,5,35,208,248,1.1814516129032258,0.02765091133515851,651,My diagnosis is that the conversion therapy is working.
1881,8071,7,29,201,237,1.1814345991561181,0.02965820943763358,651,This prescription for oil should do the trick.
4656,8071,5,33,199,237,1.1814345991561181,0.028426993781885273,651,I am going to recommend we run a few tests and keep you overnight for observation.
7542,8071,5,33,199,237,1.1814345991561181,0.028426993781885273,651,Is this the way you provide warmth and comfort to all your patients?
5111,8074,3,35,188,226,1.1814159292035398,0.027892879410035643,651,You'll be wrapt to know the tests came back negative.
902,8074,3,35,188,226,1.1814159292035398,0.027892879410035643,651,"Yes, that is an unusual way to stay warm."
2929,8074,5,31,190,226,1.1814159292035398,0.029269018694052254,651,"Dont’t judge, it’s PETA approved!
Justin T 
New York, NY"
394,8077,4,31,180,215,1.1813953488372093,0.02945774564397821,651,They can fit you into the surgery suite on Wednesday!
5812,8077,2,35,178,215,1.1813953488372093,0.027943177274055393,651,I'm afraid 'Delusions-R-Us' has a strict no-refund policy.
1457,8079,7,34,224,265,1.181132075471698,0.027603348184750246,651,I'd like to add you to my LinkedIn network
4960,8080,6,34,214,254,1.1811023622047243,0.027801412587933637,651,"It's okay Bob, everybody loves a slinky"
5413,8080,5,36,213,254,1.1811023622047243,0.027235931230546576,651,He obviously misunderstood me when I said 'let's wrap it up'.
6853,8082,4,36,203,243,1.1810699588477367,0.027363896068701443,651,"Restricted breathing, faint heartbeat, cold....  I think I'll prescribe some antibiotics; they work for almost everything."
5081,8082,8,28,207,243,1.1810699588477367,0.029745980369448883,651,"If you weren't such a rat, you wouldn't be in this mess."
1853,8082,10,24,209,243,1.1810699588477367,0.030868165124932685,651,Take two boa dilaters and call me in the morning.
3081,8082,7,30,206,243,1.1810699588477367,0.02916870263003486,651,You look a little wound up. I'm writing a prescription for you to relax.
8251,8082,7,30,206,243,1.1810699588477367,0.02916870263003486,651,I see the problem and I'm making you an appointment with the audiologist straight away.... I don't think you were told to code in a python.
1385,8087,6,30,196,232,1.1810344827586208,0.029423400936882314,651,Not the improvement I hoped for. Have you been following the pamphlets I gave you.?
8607,8087,6,30,196,232,1.1810344827586208,0.029423400936882314,651,Have you tried this homeopathic remedy? It's pure snake oil.
8832,8089,8,33,230,271,1.1808118081180812,0.02769941091558764,651,"And the Snuggie I had prescribed, Mr. Smith?"
3404,8090,5,35,209,249,1.180722891566265,0.027549279204351816,651,I don't know of any reason you should feel restricted.
4580,8090,5,35,209,249,1.180722891566265,0.027549279204351816,651,Your insurance company wants to know if python attraction is part of your family history?
6445,8090,5,35,209,249,1.180722891566265,0.027549279204351816,651,You need to stop shopping for boas at the pet store
179,8093,5,33,200,238,1.180672268907563,0.028317563758327488,651,This Instagram mania sure has made my days more interesting
5745,8093,7,29,202,238,1.180672268907563,0.029543169412454714,651,Let me just check your breathing and then you'll be out of here.
8478,8095,6,27,183,216,1.1805555555555556,0.030766245658992396,651,Looks like we need to constrict your Adderall prescription a little.
8394,8096,6,38,233,277,1.1805054151624548,0.02632327659955157,651,"A magician huh, looks like your all wrapped  up in your work."
4748,8097,9,30,227,266,1.1804511278195489,0.028520610966260913,651,I'm going to prescribe blood pressure medicine and a citric acid descaler ...
6874,8097,7,34,225,266,1.1804511278195489,0.027507810022059168,651,My wife thinks I am too tightly wrapped.
8250,8097,7,34,225,266,1.1804511278195489,0.027507810022059168,651,We see this all the time when anybody comes out with a new body reduction fad.
8934,8100,7,32,216,255,1.1803921568627451,0.02825312939182077,651,Neuroscientific research suggests some experiences from as far back as Eden can influence subsequent generations
1787,8100,8,30,217,255,1.1803921568627451,0.02879440594213574,651,Is there a reptile show in town?  You're the third case I've seen of this today.
8756,8102,5,34,205,244,1.180327868852459,0.02787341574046881,651,"Tell me, do you feel any constriction in your chest? 

Toby Green, Cambridge"
2376,8102,5,34,205,244,1.180327868852459,0.02787341574046881,651,"...so I should put you down as a ""yes"" for our new alternative to weight-loss surgery?"
4183,8102,9,26,209,244,1.180327868852459,0.030196899819813498,651,"A major concern, of course, is the inaccessibility of the pocket areas."
5416,8105,6,30,197,233,1.1802575107296138,0.02930714918649248,651,I suggest we try to reason with it
5661,8106,10,31,242,283,1.1802120141342756,0.027829714092703458,651,I'll need to conduct additional tests to deterine why you are short of breath.
7283,8107,5,28,178,211,1.180094786729858,0.030476690503641258,651,Your surgery will have to wait for this condition to resolve itself.
4167,8108,6,35,220,261,1.1800766283524904,0.02728947724560219,651,"I know you love your pet snake, but try to stop getting hugs from him."
5612,8109,9,27,214,250,1.18,0.02969726773363794,651,"Between 1 and 10, how would you rate your current level of tension? 1 being light as a mite and 10 being heavy as a Chevy."
2438,8109,2,41,207,250,1.18,0.02563255961564898,651,"Well, it’s definitely NOT a Jessie Ventura signature boa."
4964,8111,5,33,201,239,1.1799163179916319,0.028208962213153742,651,That's a nice leather jacket you have on
3531,8111,7,29,203,239,1.1799163179916319,0.029429008895621993,651,You're OK.  I think you're just too uptight.
2265,8111,4,35,200,239,1.1799163179916319,0.02757870630441907,651,Squeeze 5more pounds off and then you'll reach your goal weight.
4022,8111,7,29,203,239,1.1799163179916319,0.029429008895621993,651,"From what you told me and after closer examination, I’m referring you to a proctologist"
19,8111,6,31,202,239,1.1799163179916319,0.028825441139050535,651,My diagnosis is irritable bowel syndrome.
859,8111,5,33,201,239,1.1799163179916319,0.028208962213153742,651,"I’ll write it down, but, well... I’d rather uncoil this thing than prescribe it a heat lamp"
8769,8117,6,38,234,278,1.1798561151079137,0.026236453309888438,651,Constricting your waist is not equal to wait loss.
311,8118,5,31,192,228,1.1798245614035088,0.029033425795149115,651,say aahhhh
6773,8118,7,27,194,228,1.1798245614035088,0.030335219444219654,651,Emotional pets do work.   I just wish I never tried that iguana.
6839,8118,3,35,190,228,1.1798245614035088,0.027670455147610018,651,Here is a prescription for some snake food.
3200,8121,5,29,183,217,1.1797235023041475,0.02993093240281717,651,"Yes,you're cold blooded."
5418,8121,5,29,183,217,1.1797235023041475,0.02993093240281717,651,"Our tests suggest that you're suffering from asphyxiation. Don't worry, there's no need to get all choked up."
1188,8123,9,28,219,256,1.1796875,0.02921941352659624,651,"So, we have established that Emily Dickinson was right about the “tighter breathing.”   Now I want to check the temperature of your bones."
7661,8123,5,36,215,256,1.1796875,0.027041174294589947,651,Take Clinton's advice and don't inhale.
4008,8125,4,36,205,245,1.1795918367346938,0.027160095346883722,651,"This is much better for you than the snake oil you've been swallowing, believe me!"
3886,8125,6,32,207,245,1.1795918367346938,0.028365168604429912,651,"No, it doesn't hate you; Mr. Squeezy is simply having an anxiety attack. I'm giving you a prescription for 'Pythonbien.'"
5950,8125,5,34,206,245,1.1795918367346938,0.027769169677985973,651,Take two hot salt baths daily until that tight feeling goes away.
6019,8125,7,30,208,245,1.1795918367346938,0.028948899725390206,651,"Seems you're a bit ""wrapped up"" at the moment,Steve,do you want to reschedule?"
2369,8125,8,28,209,245,1.1795918367346938,0.029521090776996335,651,"Ok, so you say you’ve been having trouble breathing. Here’s a prescription that should help."
3383,8130,4,34,196,234,1.1794871794871795,0.02790692424690573,651,My wife is concerned but honestly I’m really enjoying this.
4120,8131,6,35,221,262,1.1793893129770991,0.027193806631231027,651,"Yes, she may SAY she loves you, but it's a bit more complicated than that."
1590,8132,6,28,189,223,1.1793721973094171,0.030090664151442837,651,The symptoms you have... Allegedly reported lead me to believe you do indeed have asthma.
5369,8132,4,32,187,223,1.1793721973094171,0.028716716072674692,651,Let's try this.
6965,8134,7,31,213,251,1.1792828685258965,0.028489816707680065,651,"Well, Mr. Bennett, if this is indeed your new main squeeze, we'll need to come up with another approach to helping you lose those extra pounds."
4772,8134,6,33,212,251,1.1792828685258965,0.0279248481835989,651,"- So, you woke up this morning and felt your throat was kind of constricted?
- yessssssssssssss doctor"
3600,8136,9,20,183,212,1.179245283018868,0.033160679615583236,651,"We'll be taking you upstairs in a few minutes, Mr. Schenkman, but the staff was wondering if they could take a few photos with you and Rusty before he's killed."
716,8137,3,37,200,240,1.1791666666666667,0.026831722016470185,651,"Now sir if you'll just let me examine your abdomen, I'll figure out what's going on."
973,8137,6,31,203,240,1.1791666666666667,0.02871487100492325,651,"I Know you've been feeling a bit restricted, but this prescription will ease the pain a bit"
1888,8137,7,29,204,240,1.1791666666666667,0.0293157179737446,651,The research has shown that this is an effective weight loss program.
4220,8137,6,31,203,240,1.1791666666666667,0.02871487100492325,651,"And did you, in fact, trust in him, just in him?"
7464,8141,7,32,218,257,1.178988326848249,0.028050332403300033,651,"No problem, 5 days on antiboatics - a Siss-Pak will do it."
800,8141,4,38,215,257,1.178988326848249,0.026374697152406302,651,I’m seriously going to have to speak to billing.
3711,8141,7,32,218,257,1.178988326848249,0.028050332403300033,651,You say there's an apple in there somewhere for me?
4443,8141,8,30,219,257,1.178988326848249,0.02858705967077497,651,Has it occurred to you Balenciaga may have been tripping?
6244,8145,9,26,211,246,1.1788617886178863,0.02996875794295322,651,Have you tried losing weight?
7321,8145,5,34,207,246,1.1788617886178863,0.02766569051018894,651,"So, tell me please: when was the last time you shed your skin?"
9054,8145,6,32,208,246,1.1788617886178863,0.028259059374207755,651,I must admit that Rachel Weisz wore it better.
6645,8148,4,32,188,224,1.1785714285714286,0.028599441744345665,651,"Put an ice pack on it, and you'll be fine"
6229,8148,7,31,214,252,1.1785714285714286,0.02838545367224306,651,"Sir, I’m afraid you have a commitment issue"
1609,8150,13,22,234,269,1.178438661710037,0.03012737764259934,651,"Yes, we are part of Mutual of Omaha’s medical plan so this will be an in network office visit. So...now let me take a look at that ingrown toenail."
5541,8150,7,34,228,269,1.178438661710037,0.027225078661851712,651,So you don’t want it removed because it kept me warm during the polar vortex.
6433,8152,7,29,205,241,1.1784232365145229,0.02920328687930945,651,Your feelings of being constricted should be taken care of with this prescription to alligator alley I'm writing for you.
3373,8153,8,22,183,213,1.1784037558685445,0.032337637007503466,651,"As long as you keep its
head covered they’ll just think you’ve gained weight."
3929,8154,8,30,220,258,1.178294573643411,0.02848449114027159,651,"So, you say it’s only been three and a half hours?"
4600,8154,7,32,219,258,1.178294573643411,0.02795000988731774,651,"You think your snake problem is bad, wait until you see your HIV test."
524,8156,8,25,197,230,1.1782608695652175,0.03071556717659305,651,Did your plumber explain how to snake your clogged drain?
2137,8156,4,33,193,230,1.1782608695652175,0.028134621839258613,651,"I respect your modesty, but you must let me examine what's underneath."
3898,8156,7,27,196,230,1.1782608695652175,0.030091091484762928,651,You say you feel something crawling.  Interesting!
3281,8159,8,20,174,202,1.1782178217821782,0.033506823436181596,651,How long have you been playing with you food before you eat it?
6802,8160,5,34,208,247,1.1781376518218623,0.027562969943988415,651,"I wouldn't have recommended the copperhead coil, myself."
5054,8160,7,30,210,247,1.1781376518218623,0.028732349885687337,651,I see your insurance doesn’t cover ER visits...
65,8160,4,36,207,247,1.1781376518218623,0.02695926562840751,651,Take one pill the next time you have problems with your anaconda.
1447,8160,7,30,210,247,1.1781376518218623,0.028732349885687337,651,"Rupert, that is NOT a feather boa."
150,8164,4,31,184,219,1.178082191780822,0.028965227897267264,651,"Dr I am finding this whole free will thing a little suffocating, can you tell me what to do?"
4948,8164,5,29,185,219,1.178082191780822,0.02967955967365307,651,Dr. I googled it..and it looks serious.
177,8166,7,28,201,236,1.1779661016949152,0.02957976610331011,651,I told you that if you didn't quit smoking I'd see you in here again
798,8166,7,28,201,236,1.1779661016949152,0.02957976610331011,651,I am writing you a referral for a good podiatrist.
5752,8166,6,30,200,236,1.1779661016949152,0.028963779726420964,651,So  you're sure this is not a fashion statement----
6638,8169,7,23,178,208,1.1778846153846154,0.03211914498998693,651,I'm in a little bit of a twist.
8407,8170,9,27,217,253,1.1778656126482214,0.02937008530617498,651,I am going to send you to a snake charmer specialist.
8438,8170,2,41,210,253,1.1778656126482214,0.025357735206107825,651,You really should not get so wrapped up in your work.   Try leaving it alone for a while.
3871,8172,4,32,189,225,1.1777777777777778,0.028483108642740264,651,Have you considered compromising on just a leg?
7735,8173,6,31,205,242,1.177685950413223,0.028496227478240082,651,The comprehensive tests will be available in about 5 weeks!
7774,8174,6,34,219,259,1.1776061776061777,0.02730776855239956,651,You better get used to it. This species breeds on mammals.
583,8175,6,29,196,231,1.1774891774891776,0.02933574917425797,651,It's a living!
8711,8175,6,29,196,231,1.1774891774891776,0.02933574917425797,651,"---AND WHEN DID YOU START FEELING THIS TIGHTNESS ON YOUR CHEST.

BURKE LEON
BLAUTOENTERPRISES@GMAIL.COM"
6676,8177,8,28,212,248,1.1774193548387097,0.029189999979166492,651,"I’m sorry, we ran out of the old model of back braces."
8166,8177,6,32,210,248,1.1774193548387097,0.028049177760543855,651,"Oh dear, they mixed up the cages at the leech farm again."
3751,8179,7,33,225,265,1.1773584905660377,0.027436748544926,651,Take two aspirin and we'll see how you feel in the morning.
9036,8180,5,29,186,220,1.1772727272727272,0.02955543146681808,651,"You are beginning to sense your relationships are going nowhere."""
1976,8181,6,30,201,237,1.1772151898734178,0.028851084471579823,651,"If we can resolve the laundry issues, they'll replace those tacky white gowns."
7676,8181,7,28,202,237,1.1772151898734178,0.029464262776655915,651,"I see under ""occupation"" you list ""Python coating"""
3146,8183,3,39,212,254,1.1771653543307086,0.02587594597760398,651,Does your throat feel constricted?
3593,8183,7,31,216,254,1.1771653543307086,0.028178980602457746,651,My lunch?  Homemade wild mushroom risotto.  I picked them myself.  Why do you ask?
4463,8185,5,30,191,226,1.176991150442478,0.02905267788140443,651,Biggest Tape Worm I ever saw!
4878,8186,1,41,201,243,1.176954732510288,0.025215780169066764,651,Your ability to recoil is at fault.
992,8187,8,30,222,260,1.176923076923077,0.028281524817422635,651,"Doctor, I feel an odd tightness in my chest."
1361,8187,7,32,221,260,1.176923076923077,0.027751479533503487,651,"Luckily, snakes are cold-blooded, so this is protecting you from our current heat wave."""
5362,8189,3,32,180,215,1.1767441860465115,0.02846646292803097,651,I'm referring you to a specialist named Mr. Hannah.
4123,8190,8,25,199,232,1.1767241379310345,0.030469503186579813,651,"Monty, finding the cure to your ailment IS the holy grail."
5654,8190,4,33,195,232,1.1767241379310345,0.027912624618477218,651,You need a therapist to work on boundary issues.
4122,8192,8,28,213,249,1.176706827309237,0.02908126493427306,651,I'm going to recommend a specialist.
3950,8192,5,34,210,249,1.176706827309237,0.0273597720248046,651,"At your last visit, I suggested you leave your position as a snake oil salesman and try something else.  Now I have nothing to offer."
9031,8194,3,41,222,266,1.1766917293233083,0.025180716872728087,651,"It has a fancy name, but rest assured, it’s nothing but snake oil."
961,8195,6,33,216,255,1.1764705882352942,0.027521469303945466,651,A snake skin coat is normally made from a dead snake!
2238,8195,4,37,214,255,1.1764705882352942,0.026375638122876608,651,"Well, now you know why they call it ""The Asphalt Jungle."""
3825,8195,5,32,201,238,1.1764705882352942,0.02811560871398859,651,This examination is wrapped up--your legs look fine!
3862,8195,3,36,199,238,1.1764705882352942,0.026824858091554812,651,"This might cost you an arm and a leg.  Okay, maybe just a leg in your case"""
3978,8195,4,28,172,204,1.1764705882352942,0.030151048801509383,651,It's the newest advancement in medical technology.  It's a green zero carbon footprint sphygmomanometer
6078,8195,7,31,217,255,1.1764705882352942,0.02807685462756731,651,I'm going to prescribe a down-filled ski jacket.  It should keep you warm without the nasty scaling.
7036,8195,6,30,202,238,1.1764705882352942,0.028739253195257875,651,Soo ... It says here you were playing virtual Snakes n’ Ladders.
7717,8195,3,39,213,255,1.1764705882352942,0.025783634213574443,651,Buy yourself a decent coat.
3344,8203,5,36,220,261,1.1762452107279693,0.026566101351783004,651,Sorry it took a couple months to see you we have  been busy with our appointments lately
7688,8203,7,32,222,261,1.1762452107279693,0.027653257087806134,651,Your shortness of breath
8100,8203,4,38,219,261,1.1762452107279693,0.026005485916776483,651,I have finally determined what seems to be slowing you down.
7763,8206,5,33,206,244,1.1762295081967213,0.027678063634639042,651,"I suggest the Love Doll at Amazon, various prices, various options for when you really need a hug next time. Don't know if Medicare will cover the cost."
8149,8206,5,33,206,244,1.1762295081967213,0.027678063634639042,651,Have you tried going Keto?
4102,8206,9,25,210,244,1.1762295081967213,0.03001667303766302,651,I've misplaced my laptop.
3804,8209,6,28,193,227,1.1762114537444934,0.029600915843064762,651,This new snake oil will have you de-furled in due time.
899,8209,3,34,190,227,1.1762114537444934,0.027554667736166404,651,Tell me again how many of those purple pills you've been taking.
5127,8211,2,33,175,210,1.1761904761904762,0.028028950458723074,651,"Take two aspirin, call me in the morning."
837,8212,6,38,240,284,1.176056338028169,0.025727164906315495,651,it is as if we have become one.
5998,8213,4,36,210,250,1.176,0.026663453621692448,651,"Sir, I'm going to need you to wheeze a little louder.
I'm a little hard of hearing."
6825,8213,8,28,214,250,1.176,0.02897332937825827,651,This called Florida man syndrome. You may feel the need to commit brainless crimes and import bales of cocaine.
7358,8215,4,33,196,233,1.1759656652360515,0.027802917379993065,651,Were you playing with Mowgli?
8637,8216,9,27,220,256,1.17578125,0.029049970615113718,651,"Sorry, my oath doesn’t allow me to treat this."
2986,8216,6,33,217,256,1.17578125,0.02742241834764192,651,Before I examine you..could you let me know what type of insuranve coverage do you have?
3779,8216,5,35,216,256,1.17578125,0.02685799272341713,651,Take 2 aspirins and call me if you start choking.
4798,8216,6,33,217,256,1.17578125,0.02742241834764192,651,Refrain from driving and get plenty of rest.
5292,8216,7,31,218,256,1.17578125,0.02797545858310546,651,"No, John, this is nothing like a mink"
7993,8216,9,27,220,256,1.17578125,0.029049970615113718,651,Tom's career as a Britney Spears impersonator was short-lived.
6403,8222,9,24,206,239,1.1757322175732217,0.03041479438850376,651,I'll try to summarize how Theranos became Theranoose.
1736,8222,6,30,203,239,1.1757322175732217,0.02862827613639643,651,"We've tried the reptile route for your chills, but I'm gong to move you into some of the larger mammals."
438,8224,7,32,223,262,1.1755725190839694,0.027555720222384165,651,Any family history of cystic fibrosis?
867,8224,5,36,221,262,1.1755725190839694,0.02647305784017223,651,"Like your HMO's claim adjuster just said, you will need to keep paying out pocket until you reach your deductible."
7304,8224,7,32,223,262,1.1755725190839694,0.027555720222384165,651,Adds a whole new twist to the word copay.
4245,8224,9,28,225,262,1.1755725190839694,0.02859742370458428,651,You’ll need to uncoil for me to treat that growth.
6826,8228,8,34,243,285,1.1754385964912282,0.026590282445412127,651,"Paranoid, no, but he does look like he's trying to shrink you."
6338,8229,6,32,213,251,1.1752988047808766,0.027740072008811498,651,I'm afraid your rolls of fat have been snaking up on you
6411,8229,6,32,213,251,1.1752988047808766,0.027740072008811498,651,How's your back holding up?
7734,8229,7,30,214,251,1.1752988047808766,0.028308728424537306,651,I would like to start you on Turtlenecks for tension.
8623,8232,8,25,201,234,1.1752136752136753,0.030227315589695644,651,Snakes alive!  It's good to see you again.
1516,8233,3,32,182,217,1.1751152073732718,0.028226894935663542,651,"It's difficult -- clearly you ought to lose weight, but then that snake will really make you uncomfortable"
3642,8233,9,20,188,217,1.1751152073732718,0.03244647874203965,651,Well I'm glad to hear that you're no longer having trouble sleeping.
6837,8233,7,24,186,217,1.1751152073732718,0.03110362017099323,651,"Actually, it says here that that serpent is a musical instrument, invented in 1590 in France."
1717,8236,6,30,204,240,1.175,0.028518143677814155,651,We could give you a trial of nitroglycerine for the tightness you are experiencing.
1485,8237,7,32,224,263,1.1749049429657794,0.027458861877932145,651,"No, of course I don't think you a terrible boa..."
4411,8238,4,31,188,223,1.1748878923766817,0.02848870148560774,651,So will the wedding be in Brazil?
9079,8238,4,31,188,223,1.1748878923766817,0.02848870148560774,651,"I recommend that you, as care giver, do this bonding exercise with Monty three times a day after he eats."
2432,8240,7,29,210,246,1.1747967479674797,0.028653696842599715,651,"I'm prescribing three more weeks"""
5956,8241,7,33,229,269,1.174721189591078,0.02705979456604682,651,I felt under pressure
3110,8242,5,34,213,252,1.1746031746031746,0.02706046392774689,651,We saved a pretty penny with these cheaper monitoring devices
4576,8242,6,32,214,252,1.1746031746031746,0.027638528570037783,651,"I know how this sounds, but the best I can do is offer you some oil to rub all over the snake. One-time, low price."
9075,8242,7,30,215,252,1.1746031746031746,0.028204748094047903,651,"The biggest side effect is social stigma, but with sexting what it is these days...who knows?"
3172,8245,6,25,181,212,1.1745283018867925,0.030839129089458073,651,Does it hurt when swallows?
8145,8246,5,31,199,235,1.174468085106383,0.028237557873862416,651,I guess that'll teach you to order a boa from amazon.net.
3527,8246,3,35,197,235,1.174468085106383,0.026918751390198545,651,"Doctor , I know I'm a little over weight but, I don't think this blood pressure cuff is to scale!"
4784,8246,7,27,201,235,1.174468085106383,0.02949746044920041,651,"Sorry, your appointment was a tight fit into my schedule"
6278,8249,5,35,218,258,1.1744186046511629,0.02666673155250426,651,"I'm going to prescribe some pain killers. If the problem persists, don't call me. I'll be out of town."
7063,8249,6,33,219,258,1.1744186046511629,0.02722641648312127,651,"Mr. Tork, saying your skin is covered with scales is funny, but you had to know you would be directed to the wrong doctor!"
9115,8251,3,32,183,218,1.1743119266055047,0.028108595748802125,651,So it says here that you suffer from ophiophobia.
5717,8252,5,32,204,241,1.1742738589211619,0.02779360365200199,651,"Well the Caduceus won best dressed, so I don’t regret it."
8521,8252,8,26,207,241,1.1742738589211619,0.029600993966395844,651,"Doctor, I  think I have a sore throat."
6866,8254,5,29,190,224,1.1741071428571428,0.02906901504870598,651,Doc. are you sure all I need is a cough medicine?
7662,8254,3,33,188,224,1.1741071428571428,0.02765738169283289,651,You say  in the drag queen competition it was rethinking the show stopper?
220,8256,8,27,212,247,1.174089068825911,0.029117046726392332,651,I suggest you try being a vegan.
7002,8256,6,31,210,247,1.174089068825911,0.027963758550069162,651,"And do you like it, even one bit?"
8808,8256,5,33,209,247,1.174089068825911,0.027368896275450933,651,I’m going to take a gander and assume that’s not haute couture.
9111,8259,7,30,216,253,1.173913043478261,0.028101521252235178,651,It's nothing to get your knickers in a twist about.
5824,8259,6,32,215,253,1.173913043478261,0.027537717772227195,651,I assume Taylor didn't like your apology.
1374,8259,7,26,197,230,1.173913043478261,0.02988601796635854,651,Much improved compared to last time. No flea bites.
284,8259,7,30,216,253,1.173913043478261,0.028101521252235178,651,Your insurance doesn't cover cold-blodded cases.
5352,8259,9,22,199,230,1.173913043478261,0.03113067025228274,651,"Sofia rocks - this is so funny, it made me crazy:  Any shortness of breath?  It's definitely not a rash.  I said, ""Ask yourself, not Asp yourself.""  The good news is, it's not an std.  Just making sure we've squeezed every last dollar out of you."
3996,8264,6,29,201,236,1.173728813559322,0.02876127497881972,651,I see that you have a tightest about your body.
5853,8265,5,36,224,265,1.1735849056603773,0.026197749964385026,651,Two aspirin should do the trick.
8396,8266,5,32,205,242,1.1735537190082646,0.027687882490918646,651,"No, you misunderstood, I did not mention compassionate therapy."
8181,8266,7,28,207,242,1.1735537190082646,0.028899889107749047,651,It is a new breakthrough treatment!
2231,8266,7,28,207,242,1.1735537190082646,0.028899889107749047,651,Cat got your tongue?
3109,8266,7,28,207,242,1.1735537190082646,0.028899889107749047,651,"Go home, take two aspirin, and call  me in the morning."
7160,8266,3,36,203,242,1.1735537190082646,0.026420334653854155,651,"Unfortunately, we just laid off our snake charmer, but I'll call the morgue to see if they can help you instead."
8136,8266,5,32,205,242,1.1735537190082646,0.027687882490918646,651,I think your serpent bracelet has gone viral.
2828,8272,6,26,187,219,1.17351598173516,0.03015272336701371,651,"Mr. Boa, your constrictive clothing is the cause of your anxiety attacks."
1301,8273,4,35,209,248,1.1733870967741935,0.0266619317967732,651,I need to listen to your heart.
4809,8273,8,27,213,248,1.1733870967741935,0.029007896487303068,651,Adam an apple a day will keep me away
17,8275,3,33,189,225,1.1733333333333333,0.027545056883770614,651,You seem a little wrapped up. How about we schedule another appointment for next week?
6152,8275,2,35,188,225,1.1733333333333333,0.02681506328628779,651,"No, as long as it doesn't affect your work/life balance I am OK- just try not to over feed that thing..."
1312,8277,3,34,194,231,1.173160173160173,0.027118881082257868,651,"I ordered a boa online to jazz up my outfit, and got this."
1656,8277,6,28,197,231,1.173160173160173,0.02912669323604724,651,You say that breathing isn’t a problem. Have you had a colonoscopy yet?
2160,8277,4,32,195,231,1.173160173160173,0.027804266346336655,651,Thanks for now. If you have any questions or concerns we will be in contact.
6691,8277,3,34,194,231,1.173160173160173,0.027118881082257868,651,No surgeons are available that day.
4927,8281,3,39,218,260,1.1730769230769231,0.025331640054402988,651,And don’t remove the restrictions before your follow up visit.
4471,8282,3,35,199,237,1.1729957805907174,0.026711317364724218,651,"I know that healthcare is putting the squeeze on people, but really......?"
6540,8282,5,31,201,237,1.1729957805907174,0.0280180278915239,651,The tests for vascular constriction have come back negative.
8287,8284,6,34,226,266,1.1729323308270676,0.02664508321217388,651,What do you mean  you have a squeezing sensation?
2127,8285,7,23,184,214,1.1728971962616823,0.0312812710419656,651,"But if your insurance refuses to cover it, don’t worry — there’s a generic available for a $1200 copay."
6336,8286,7,28,208,243,1.1728395061728396,0.0287895742724594,651,You're overweight again; I told you to avoid large meals
5681,8286,7,28,208,243,1.1728395061728396,0.0287895742724594,651,How long have you had this constricted  feeling ?
5234,8286,5,32,206,243,1.1728395061728396,0.027582953372490483,651,"No, I can't see you again on Monday.  That's my day at the Bronx Zoo."
6223,8286,2,38,203,243,1.1728395061728396,0.025666883560110605,651,Would you say you're feeling a little verklempt?
347,8286,4,34,205,243,1.1728395061728396,0.026959398764229668,651,Hug a dog a call me in the morning.
3843,8286,6,30,207,243,1.1728395061728396,0.028192719836319803,651,"Don't worry, it's all a constriction of your mind."
7104,8292,8,22,190,220,1.1727272727272726,0.0313777860165468,651,"I'm no herpetologist, but I know herpes when I see 'em...
 And I see 'em."
1019,8293,7,29,213,249,1.1726907630522088,0.028333665929921953,651,"I’m going to refer you to a specialis, he’s a Vet"
1960,8293,7,29,213,249,1.1726907630522088,0.028333665929921953,651,An upper endoscopy will no doubt confirm a diagnosis of GERD!
3044,8293,5,33,211,249,1.1726907630522088,0.027166549193380334,651,You are suffering from constriction of your core. It’s fatal
3177,8293,7,29,213,249,1.1726907630522088,0.028333665929921953,651,You've called your wife a snake once too often.
5397,8293,6,31,212,249,1.1726907630522088,0.027756242722176697,651,"So at this health fare one salesperson """"our snake oil will do it"" and the guy at the next booth shouted ""why not try the snake?"""
5689,8293,9,25,215,249,1.1726907630522088,0.029454572734644895,651,You say you haven't lost any weight at all?
5632,8299,7,25,194,226,1.1725663716814159,0.030165036545348297,651,"Well, I guess I heard what I wanted to hear when the nurse said something about herpetology."
3367,8299,6,27,193,226,1.1725663716814159,0.029505898783416227,651,"Yes, this is a perfectly normal way to get your blood pressure."
1995,8299,7,25,194,226,1.1725663716814159,0.030165036545348297,651,"Hi, I am Dr. Clark's resident."
5114,8302,7,27,204,238,1.1722689075630253,0.02915228895499881,651,"So you're saying you feel stifled in following these new, exotic fashion trends"
1705,8303,6,30,208,244,1.1721311475409837,0.028085872395463157,651,In my professional opinion your days (dare I say hours) are numbered.
2865,8304,10,17,188,215,1.172093023255814,0.03317331085900013,651,Mr. Hissy's infectious stomatitis has cleared up nicely. And I wish you'd put your pants on.
2629,8305,4,35,211,250,1.172,0.026466315638067475,651,This type of thing really snakes up on you
7750,8305,8,27,215,250,1.172,0.028792011386471673,651,Should I treat you or your pet snake?
5451,8307,5,28,188,221,1.1719457013574661,0.029203770453988528,651,I'm afraid you're making an asp of yourself.
7227,8308,8,28,220,256,1.171875,0.028342027573213323,651,"So...when did you notice 'the constriction' ?""  

J.K.Fuller, Genoa, N"
6460,8308,6,32,218,256,1.171875,0.027239603836268667,651,That's the worst case of measles I've ever seen!
8748,8310,5,30,198,233,1.1716738197424892,0.028247701637748104,651,Your blood pressure is 130 over 85. Have you had your colonoscopy?
8557,8310,5,30,198,233,1.1716738197424892,0.028247701637748104,651,You're the first two-headed snake with legs I've ever treated.
1074,8310,5,30,198,233,1.1716738197424892,0.028247701637748104,651,"Well, your weight loss is working. Would you prefer a less affectionate pet?"
3900,8313,4,33,202,239,1.1715481171548117,0.027162146485359855,651,two doses of Thorazine should take care of this
6857,8314,4,34,207,245,1.1714285714285715,0.02675740111732383,651,I thought I had it all under control Doc.
4807,8314,7,28,210,245,1.1714285714285715,0.028571428571428574,651,"I don’t know if Obama care covers snake sharmers; however, Trump’s health care will cover your precondition."
6607,8314,6,30,209,245,1.1714285714285715,0.027979823538744564,651,I have to recommend other ways to lose weight.
2125,8317,8,27,216,251,1.1713147410358566,0.028685258964143423,651,Yours is the very first case of snakes I've  seen
8545,8317,8,27,216,251,1.1713147410358566,0.028685258964143423,651,"Your wife told me she said ""you aught to get a dog!"""
1001,8319,8,28,221,257,1.171206225680934,0.028239452075865347,651,did you win?
2465,8319,4,36,217,257,1.171206225680934,0.025997525320803058,651,So which pharmacy would you like that sent to?
5212,8319,4,36,217,257,1.171206225680934,0.025997525320803058,651,"Yoga, twice a day."
6765,8322,4,30,188,222,1.1711711711711712,0.028372732222818595,651,That's not going to fix your Hot Flashes
450,8322,4,30,188,222,1.1711711711711712,0.028372732222818595,651,So you describe the chest pressure as a tight squeezing sensation that started shortly after you bought this exotic and highly fashionable jacket?
4962,8322,4,30,188,222,1.1711711711711712,0.028372732222818595,651,Life sort of does that to you sometimes.
1670,8325,8,29,226,263,1.1711026615969582,0.027812282605208228,651,"Problems like this typically resolve in a few days, even faster if you wrap tighter"
1768,8325,6,33,224,263,1.1711026615969582,0.026748326423872863,651,"I've been practicing gastroenterology for years, but I've never seen one of these things so tightly coiled externally."
98,8325,4,37,222,263,1.1711026615969582,0.0256402587593055,651,"And, SECURITY FIRST tatooed  on your forehead, got it!"
4643,8328,5,29,194,228,1.1710526315789473,0.02859817913642854,651,"Here's a prescription.  If you don't feel better, don't come back here because I have no idea what you have."
7530,8328,4,31,193,228,1.1710526315789473,0.02791438674332629,651,Could you please localize where exactly you feel the healthcare system is squeezing you?
9187,8328,10,19,199,228,1.1710526315789473,0.0317973294984907,651,I used to wear mink
9136,8331,6,34,229,269,1.171003717472119,0.026370714726526676,651,"Yes, you are thinner… but you still weigh the same because the snake has been eating your dinner leftovers."
8911,8332,6,28,200,234,1.170940170940171,0.02878078163176745,651,It appears you have a “Staff” infection.
8414,8332,7,26,201,234,1.170940170940171,0.029411151481222204,651,Have you tried deep-breathing?
1159,8332,6,28,200,234,1.170940170940171,0.02878078163176745,651,I suggest that you step into a kiddie pool and wait for it to unwind.
7109,8332,4,32,198,234,1.170940170940171,0.02747669032295647,651,So you say you sat on Satan?
6323,8332,7,26,201,234,1.170940170940171,0.029411151481222204,651,"Next time, ask him what's in that drink, and say ""No"" with a bit more conviction .  .  ."
7646,8332,3,34,197,234,1.170940170940171,0.026800859519570133,651,I can't help you if your employer thinks it's rubber.
2726,8338,7,27,206,240,1.1708333333333334,0.02892658713104165,651,I don't have prescriptions for magic tricks gone astray?
2836,8338,7,27,206,240,1.1708333333333334,0.02892658713104165,651,"Sir, it’s simple - stop dressing like a turd."
6727,8340,3,37,212,252,1.1706349206349207,0.02566472211756729,651,So you said the symptoms started before or after you started banking?
3901,8341,3,30,178,211,1.1706161137440758,0.028447300853825293,651,"Well, yes and no- you can be a mobile home for Charlie and forgo the cage, but these mishaps still won't be fully covered."
5988,8342,7,30,221,258,1.1705426356589148,0.027596411186971075,651,Does this so-called 'pressure' wake you overnight?
1316,8343,5,35,224,264,1.1704545454545454,0.026108764991493862,651,"Well, at least you’re keeping warm."
781,8344,5,28,190,223,1.1704035874439462,0.028961706167507383,651,Just relax and the constipation will be gone in no time.
2140,8344,4,30,189,223,1.1704035874439462,0.028255641571107142,651,"OK. Let me get this straight. Ever since you’ve come back from a trip to the Amazon, on a ship called “DeNial”, you’ve had shortness of breath and a feeling of constriction."
2599,8346,9,21,199,229,1.1703056768558953,0.031056278384224516,651,"Just cut-one then, he’ll leave you alone”"
3721,8346,7,25,197,229,1.1703056768558953,0.02979734361067421,651,Your symptoms are caused by an underlying stress and anxiety. How much do you exercise?
1225,8348,4,32,199,235,1.1702127659574468,0.027369186418091686,651,"Sir, there are no humans allowed in the office."
8226,8348,7,26,202,235,1.1702127659574468,0.029294762545493933,651,I'm guessing that you're a Snake Charmer who is ALL wrapped-up in your work?
8253,8348,3,34,198,235,1.1702127659574468,0.026696481342155333,651,Your feet are pretty swollen. I’d recommend tennis shoes.
48,8351,7,27,207,241,1.170124481327801,0.028815029967579536,651,Had you noticed any snakes in your corporate job
2990,8351,6,29,206,241,1.170124481327801,0.028208647706353545,651,'I've always believed if you really like something gopher it
6859,8351,5,31,205,241,1.170124481327801,0.027588940878725727,651,Thighness In The Chest -- Cool!  They told me about that in medical school!
6864,8351,8,25,208,241,1.170124481327801,0.02940891189153125,651,"Hmmm, this seems to be just in your head."
8003,8355,4,35,214,253,1.1699604743083003,0.026178149197380707,651,How long have you had this Kaa-off?
370,8355,4,35,214,253,1.1699604743083003,0.026178149197380707,651,"To be honest we didn't spend a lot of time with reptiles in vet school, generally they're quite shy, so what's the problem?"
1089,8355,5,33,215,253,1.1699604743083003,0.02677060126308918,651,So you say you mistook this for a feather boas?
2095,8355,7,29,217,253,1.1699604743083003,0.02791781304402778,651,I'm looking at a health plan that doesn't cover Khanna strophic events
29,8359,7,21,178,206,1.1699029126213591,0.031929577843006214,651,I’m going to recommend a low sodium diet.”
1541,8360,3,38,218,259,1.16988416988417,0.0252268438507552,651,You say that your wife doesn't hug you enough.
3435,8360,8,28,223,259,1.16988416988417,0.028036493416837914,651,"Well, he likes you. Got a problem with that?"
8344,8360,7,30,222,259,1.16988416988417,0.02749753990130742,651,I thought it would help me lose weight. My mistake.
5038,8363,8,20,184,212,1.169811320754717,0.03202835933903051,651,"In Vet school, we call this Intrusive Owner Syndrome."
8174,8364,7,23,188,218,1.1697247706422018,0.030746357647147796,651,"So, your Pythonidae hurts?"
1370,8364,3,31,184,218,1.1697247706422018,0.027860846505153674,651,"When your adjustment is complete, please slither back into the gown."
3,8366,8,31,238,277,1.1696750902527075,0.026827899363310766,651,"Give it to me coiled, Doc."
2235,8366,4,39,234,277,1.1696750902527075,0.024801116181815252,651,Does it hurt when I do this?
4903,8368,7,25,198,230,1.1695652173913043,0.029676746050671554,651,"You probably can't fornicate in this condition, but do eliminate apples. Maybe that will help."
4577,8369,5,30,201,236,1.1694915254237288,0.02791606184421804,651,Again Steve? I was on my jog.
1583,8369,7,26,203,236,1.1694915254237288,0.029179283100549368,651,"You're wrapped-up in toxic thoughts. Here's my script to see a psychiatrist."""
5186,8369,7,26,203,236,1.1694915254237288,0.029179283100549368,651,"The doctor will see you now. Oh wait he's already here, my apologies."
8200,8372,6,29,207,242,1.1694214876033058,0.02810063598467344,651,I see you've overcome white coat syndrome since your last visit.
5718,8372,8,25,209,242,1.1694214876033058,0.029295571275406055,651,"I am sure that I prescribed ""bow"" tie !!"
6280,8372,3,35,204,242,1.1694214876033058,0.02620627047729636,651,"You have what we call ""exo-bowels""."
2085,8372,4,33,205,242,1.1694214876033058,0.02685257881719838,651,"Don’t tread on me, it’s health care reform!"
778,8372,9,23,210,242,1.1694214876033058,0.029875121307821207,651,You Jehovah's witnesses are out of control
8060,8377,7,28,213,248,1.1693548387096775,0.028250283235907517,651,I actually didn’t get to watch most of the game.
7701,8377,5,32,211,248,1.1693548387096775,0.0270698869071861,651,"You really should quit smoking, Dan. Your lungs are a bit constricted."
567,8377,2,38,208,248,1.1693548387096775,0.025195816886064988,651,I see from your chart that you have put on some weight. You need to get a tighter hold on this problem.
2676,8377,3,36,209,248,1.1693548387096775,0.025835615948273685,651,I like to use CeraVe myself and you can pick that up without a prescription.
5945,8377,7,28,213,248,1.1693548387096775,0.028250283235907517,651,Says here you were trying to grow your own Botox’
518,8382,5,33,216,254,1.169291338582677,0.026673391280192423,651,Looks like you have snake-loopus
4333,8382,4,35,215,254,1.169291338582677,0.02608346622856695,651,"It's nothing to worry about, Mr. Smith. I'm writing you a prescription to get you uncoiled."
5835,8384,1,43,222,266,1.169172932330827,0.023638172541335625,651,You appear to be starved for affection.
8231,8384,4,37,225,266,1.169172932330827,0.025374823302096283,651,"This one is even better than the Keto Diet""."
4117,8386,4,38,230,272,1.1691176470588236,0.025040825206124197,651,Hmm... I not sure I can give you a sick note Mr Adams
5203,8387,6,23,178,207,1.1690821256038648,0.031038996369419872,651,"I'm going to refer you to the reptile house at the zoo"""
3695,8388,7,23,189,219,1.1689497716894977,0.030615452039032244,651,"I'm not sure what you mean by ""Me too."""
6815,8388,5,27,187,219,1.1689497716894977,0.029215102823568432,651,No...............I am not trying to sell you snake oil!!
7261,8390,6,26,193,225,1.1688888888888889,0.029406234566725784,651,"Just tell the pharmacist it's not my handwriting, it's in parseltongue."
3515,8391,8,23,200,231,1.1688311688311688,0.030187189517808456,651,The test results conclude
609,8391,3,33,195,231,1.1688311688311688,0.026889567334975054,651,I'm going to have to refer you to my competitor.
3924,8393,5,30,202,237,1.1687763713080168,0.027807220790004625,651,"Now Mr Regal, I need to ask who initiated this- act? You or the snake ?, And is it a he, she, they...?"
7753,8394,6,30,213,249,1.1686746987951808,0.027563439718884607,651,Take one tablet by mouth twice  daily for 7 days
6742,8394,5,32,212,249,1.1686746987951808,0.026969530847987554,651,"Your bloodwork came back clean, but nonetheless here's a prescription.  If your shortness of breath doesn't improve in two weeks, come back to see me."
3505,8394,5,32,212,249,1.1686746987951808,0.026969530847987554,651,I'm going to write you something so he'll calm down a bit but that's the most I can do for you.
969,8394,7,28,214,249,1.1686746987951808,0.028144818779175303,651,"Good news: these new weight loss schemes can be very effective.
Bad news:  this one is definitely deadly."
3057,8394,5,32,212,249,1.1686746987951808,0.026969530847987554,651,You said you didn't want a Lap-Band.
1239,8399,6,31,218,255,1.1686274509803922,0.02715159087330639,651,"This is my new squeeze, but I am not sure how to be more interactive"
7898,8399,9,25,221,255,1.1686274509803922,0.02880701939354401,651,Your belly fat index seems a little high.
2902,8401,4,36,221,261,1.1685823754789273,0.02563153850187287,651,It might work for RuPaul but I don’t think it’s a good choice for you.
4301,8402,5,38,242,285,1.168421052631579,0.024833467944326365,651,"I know you're trying to avoid big pharma, but 2 Advil would have been a more effective fever reducer."
8662,8403,5,24,173,202,1.1683168316831682,0.03070411079405365,651,I presume your weight loss is due to your gastric bypass.
4613,8404,4,29,187,220,1.1681818181818182,0.028369731971580655,651,"I think Paleo makes sense for some people, but in this case I think medication is warranted."
6706,8404,8,21,191,220,1.1681818181818182,0.031159038717517674,651,"I said a boa
 not a boa constrictor"
1958,8406,5,28,193,226,1.168141592920354,0.02860596559858563,651,"When I suggested that you get a Comfort Animal,
I told you to look for fur or hair.  So I can't help you with choking."
4561,8406,3,32,191,226,1.168141592920354,0.027196296334197317,651,We are trying out new scales.
6596,8408,8,23,201,232,1.168103448275862,0.030065599000658947,651,"Excuse me for asking, but we need to know if this is your first visit here"
1959,8408,4,31,197,232,1.168103448275862,0.02747115272287363,651,Have you ever tried Lucky Charms?
4856,8410,3,34,201,238,1.1680672268907564,0.026388106111951568,651,"Well, James, you have become far too wrapped up in your job."
1621,8410,9,22,207,238,1.1680672268907564,0.030150878417614768,651,"Well, mr. Irwin, I'm afraid were in a legal bind. Trouble is, we need an exception from animal care and use requirements. Meanwhile, we can give you a new opioid, Desuvia, to help with the pain."
3550,8410,6,28,204,238,1.1680672268907564,0.028332027932442497,651,I think you’re just feeling a bit anxious about something. Here’s a prescription for something to help you sleep.
6030,8413,5,31,208,244,1.1680327868852458,0.027275561950750347,651,I think you need to go on statins.
3749,8414,4,34,212,250,1.168,0.026265251832321375,651,I think it's the ferenomes in your after shave.
4944,8414,7,28,215,250,1.168,0.028040131882427658,651,Apply liberal amounts of my special snake oil twice a day for a month.
5480,8414,7,28,215,250,1.168,0.028040131882427658,651,...but I'm afraid the evidence-based treatments only pertain to internal fauna.
4108,8417,6,32,224,262,1.16793893129771,0.026662138507057932,651,I feel an unusual constriction about my chest
5091,8417,9,26,227,262,1.16793893129771,0.028259724310710325,651,I seems you overdosed on your deworming medicine.
9223,8417,5,34,223,262,1.16793893129771,0.026107894725292152,651,Here's a prescription that should help give you some relief....you can go ahead and put your clothes on.
7591,8420,6,34,234,274,1.167883211678832,0.025925651612835925,651,Take this for pain and come back if it gets worse.
8203,8421,5,24,174,203,1.167487684729064,0.030563733437987208,651,The good news is your chicken pox is receding.
1964,8422,7,22,186,215,1.1674418604651162,0.03091451606067481,651,I think it's something to do with your fear of sharks.
1897,8423,7,23,191,221,1.167420814479638,0.030356929839989156,651,I can't decide if you have frost bite or a snake bite.
3845,8423,5,27,189,221,1.167420814479638,0.02897020053096042,651,when's the last time you had your cholesterol checked? It's very important to your health you know...
9015,8425,7,25,201,233,1.167381974248927,0.02932069160632084,651,"I have just the thing to remove this growth from your coils. You'll be slithering happily in no time.""


Doug Friedenberg
dsf333@gmail.co"
2174,8425,4,31,198,233,1.167381974248927,0.027362509974947886,651,"As your doctor, I have to say that what is good for your boa this winter may not be good for you."
5490,8427,5,30,204,239,1.1673640167364017,0.02759203901310432,651,But at least you don't have to tie these behind your back.
4892,8427,7,26,206,239,1.1673640167364017,0.0288381974529639,651,"I completely get it that you’re soulmates, but the mating part has me baffled."
3483,8427,9,22,208,239,1.1673640167364017,0.0300326929823417,651,I’m gonna have to refer you to the nearby veterinary hospital.
2194,8430,6,29,210,245,1.1673469387755102,0.02778146072877061,651,I'm referring you to a Ophidiophobia specialist. on our medical group .my practice is limited to Herpetophobia
5327,8430,6,29,210,245,1.1673469387755102,0.02778146072877061,651,Malingering
5978,8430,7,27,211,245,1.1673469387755102,0.028377201510670223,651,"What, cat got your tongue?"
7768,8430,8,25,212,245,1.1673469387755102,0.028960690097615857,651,"Take two aspirin, go on a diet, and call me in the morning."
3889,8430,5,31,209,245,1.1673469387755102,0.027172661902567858,651,Don't worry about it---it's just our reduced cost alternative to liposuction.
7119,8435,6,30,215,251,1.1673306772908367,0.02735981627631777,651,"Doctor, I always suspected my husband was a ""Snake in the grass,""  but maybe we need a separation."
4229,8436,4,35,218,257,1.1673151750972763,0.025803434542219915,651,"So when did you first notice it, Mrs Quigly?"
893,8437,6,33,230,269,1.1672862453531598,0.026196104793070305,651,They say python stew tastes like chicken.
5493,8437,7,31,231,269,1.1672862453531598,0.026720371172112945,651,Can you tell me 1-10 the size snake we have at this moment?
777,8439,6,34,235,275,1.1672727272727272,0.025838417446329483,651,"All right, Mr. Serpentine, just take all of this prescription, and your digestive issues should clear right up."
7341,8440,3,32,193,228,1.1666666666666667,0.026977285139381833,651,"Please, tell me more about your fear of intimacy."
8227,8440,5,31,210,246,1.1666666666666667,0.027070527342175764,651,Apiphobia. Sciophobia. Iconophobia.  Kinetophobia. Gamophobia. But congratulations - no more ophidiophobia.
6950,8440,3,33,198,234,1.1666666666666667,0.026573237895134137,651,How do you like our new snake wrap therapy?
9204,8440,4,31,199,234,1.1666666666666667,0.027254713580357238,651,He's just a bit sleep-deprived...the last guy cuddled him and sang lullabies.
9155,8440,8,26,218,252,1.1666666666666667,0.028395397779632448,651,I'm gonna put you back on C++.
6491,8440,7,26,207,240,1.1666666666666667,0.02872625249697144,651,"Well, I think it's a case of sepenteria."
6340,8440,5,31,210,246,1.1666666666666667,0.027070527342175764,651,I see you
5948,8440,3,34,203,240,1.1666666666666667,0.026186400450859154,651,I warned you that your intestines would rebel against that diet of yours.
5098,8440,2,34,192,228,1.1666666666666667,0.026251305697588562,651,Ten percent of all doctors recommend squeezing for weight loss.
3545,8440,4,28,184,216,1.1666666666666667,0.02860524638218839,651,"Oh, it's just another encounter with a rare leg-hair eating python."
2633,8440,4,28,184,216,1.1666666666666667,0.02860524638218839,651,My own brand of the oil should provide quicker relief.
1507,8440,7,29,222,258,1.1666666666666667,0.027414703571405293,651,It's nothing to get chocked up about.
999,8440,5,26,185,216,1.1666666666666667,0.02934836354418746,651,That's not a snake skin coat.
261,8453,7,30,228,265,1.1660377358490566,0.026918746622124505,651,"We're waiting for a taser. Don't worry, you will feel great when you wake up!"
562,8453,3,38,224,265,1.1660377358490566,0.024703600182136513,651,"In Russia, the scales step on  you."
1062,8453,6,32,227,265,1.1660377358490566,0.026382402378656085,651,The party theme was early 2000's Britney.
1232,8453,4,36,225,265,1.1660377358490566,0.025275593492451887,651,"It says you’re here for a squeezing sensation around your core?
Did you mean chest?"
2119,8457,6,30,217,253,1.1660079051383399,0.027159151064520024,651,"Your snake has frostbites all over, sadly we need to take it off you"
3431,8457,7,28,218,253,1.1660079051383399,0.027730652410868504,651,You have an excessive case of worms and I am giving you a prescription for a snake charmer.
6994,8459,4,33,210,247,1.165991902834008,0.026351845016102802,651,Have you thought of a less dangerous coat?
6220,8460,5,30,206,241,1.16597510373444,0.027380128485240886,651,"Here, fill this prescription for snake oil and seems again in a week."
8084,8460,4,32,205,241,1.16597510373444,0.026741228267545186,651,Get some exercise and call me in a month or so.
8426,8460,6,28,207,241,1.16597510373444,0.02800445647534765,651,"I've entered your symptoms into the algorithm, and it's definitely your heart."
2371,8463,3,32,194,229,1.165938864628821,0.026869080841179577,651,Take two stool softeners and forget your pet!
8404,8464,5,27,191,223,1.1659192825112108,0.028729330488425905,651,"I get a lot of these, but I've never seen one this long before."
638,8465,9,18,190,217,1.1658986175115207,0.032010239607027195,651,"People dick around on WebMD and get all sorts of crazy ideas in their heads. Don't worry, it happens. You're just dehydrated. I'm writing up a prescription for a liter of Gatorade, you fucking baby. You idiot bitch."
9181,8465,3,30,184,217,1.1658986175115207,0.027724340472780405,651,I think it’s time you start shedding some skin.
3738,8467,7,31,234,272,1.1654411764705883,0.026446421631277438,651,so...only when you're watching Murder She Wrote.
397,8468,6,32,228,266,1.1654135338345866,0.02629044439463272,651,"Unwind and don't wear your pet too tight."""
4332,8468,2,40,224,266,1.1654135338345866,0.024035311337885102,651,"Mr. Jones, I’m afraid this is a suffocating relationship, or you may suffer from separation anxiety"
5357,8470,9,25,226,260,1.1653846153846155,0.028288592296022923,651,I’m going to write you a prescription for a human laxative.
3103,8470,8,27,225,260,1.1653846153846155,0.02775868196421757,651,"Don't worry Ms. Morelia , We can remove that head and those pesky legs while we are doing your tummy tuck."
6679,8470,4,35,221,260,1.1653846153846155,0.025529283295667723,651,It's the best organic remedy for stress relief
946,8473,6,30,218,254,1.1653543307086613,0.027059907956743585,651,First things first - let's see how we can get your behind wiped. Then we'll work on maintaining nutrition.
8611,8473,3,36,215,254,1.1653543307086613,0.02527589450363878,651,"Even with the hissing, I doubt it will keep the flu bug away."
8305,8475,2,36,204,242,1.165289256198347,0.025319341630377416,651,I’ve been having difficulty breathing!
4458,8476,4,29,191,224,1.1651785714285714,0.02790188581019841,651,"Doctor, I’ve heard about your reputation as a snake oil salesmen but don’t you think this is going too far."
3667,8477,6,24,188,218,1.165137614678899,0.029816107240089443,651,Her name is Alice and all I said was you might want to do keto.
7328,8478,8,29,236,273,1.164835164835165,0.026862434947570443,651,"Mr. Slytherin, you are suffering from a case of Parseltongue."
2693,8479,7,30,230,267,1.1647940074906367,0.026731145383498404,651,"Relax, don't e so uptight"
6241,8480,4,33,212,249,1.1646586345381527,0.026156683802153535,651,Stop eating so many apples and you'll be fine.
7578,8480,7,27,215,249,1.1646586345381527,0.027952369353132493,651,"A little more comfy than an ankle bracelet, right?"
967,8482,5,30,208,243,1.1646090534979423,0.027171416098641883,651,You’ll be greatly relieved once we run the snake through you!
3921,8482,9,22,212,243,1.1646090534979423,0.029569010684946485,651,This prescription is for you...not the snake.
4406,8482,5,30,208,243,1.1646090534979423,0.027171416098641883,651,"When you applied for the pole dancing job Ms. La Tour, this wasn't the boa they meant!"
6465,8482,3,34,206,243,1.1646090534979423,0.025889487881475434,651,"Before we had back to the operating room..
What insurance policy did you say you have?"
2905,8486,5,29,203,237,1.1645569620253164,0.02759206938238233,651,I am sorry. My specialty is ENT.
3432,8487,4,30,197,231,1.1645021645021645,0.027352230416032755,651,"I’m prescribing a broad-spectrum antibiotic, you may not feel better for 2-3 days."
8070,8488,4,29,192,225,1.1644444444444444,0.027787299955208053,651,Our next appointment in serpentology is in two months.
2365,8488,3,31,191,225,1.1644444444444444,0.02706384117449269,651,"Doctors Who Circum-prescribe
Now, Mr. Kellerman, I would like to suggest that a colleague of mine, head of our psychoanalytic department, take a look into your case to discuss this ""imagination"" of yours. By the way, where are your pants and shoes?"
742,8490,6,24,189,219,1.1643835616438356,0.029689225708650797,651,"Sorry""  Your workmen's compensation policy only covers 4 leg animals."
670,8491,6,23,184,213,1.164319248826291,0.030223730325913297,651,He's trying to shed!
5473,8492,6,22,179,207,1.1642512077294687,0.03078612117809573,651,"I'm prescribing a medium-sized python.  As  you can see, it will do wonders for your back"""
3792,8493,6,32,230,268,1.164179104477612,0.0261084202651137,651,"Yes, I imagine it is quite warm."
5464,8494,6,29,215,250,1.164,0.027265171157227895,651,"Doc, I've been feeling a little bound lately..."
8925,8495,8,24,212,244,1.1639344262295082,0.028877041774363364,651,"I'm afraid you have a nasty case of  'Snake-wrap'. We can treat it, but no more Everglades vacations for you."
7077,8495,8,24,212,244,1.1639344262295082,0.028877041774363364,651,Your midsection seems to be constricted.
6099,8497,5,29,204,238,1.1638655462184875,0.027484589905873873,651,I like snake skin coat but I wanted to stay politically correct
713,8497,6,27,205,238,1.1638655462184875,0.028122231475419812,651,"I'm not qualified to tell you that it wears like a poncho, but I am concerned that it's a tad too constrictive...given your blood pressure and circulation ailments."
4397,8497,3,33,202,238,1.1638655462184875,0.026162726168501755,651,We can schedule your snakeectomy procedure next Wednesday. Takes time to collect the rats and mice!
1185,8497,8,23,207,238,1.1638655462184875,0.029355993338382375,651,"You’re not Britney, b*itch"
3808,8501,5,28,199,232,1.1637931034482758,0.02791982731893476,651,Wouldn't a scarf be easier on your feet?
5514,8501,6,26,200,232,1.1637931034482758,0.028580338702600776,651,"Choked up about the diagnosis, I see."
1494,8503,3,31,192,226,1.163716814159292,0.026953646752831507,651,The psychiatric report concludes that you have a devishly twisted personality disorder.
4338,8503,5,27,194,226,1.163716814159292,0.02837537324523529,651,What is that spa’s name again?
7655,8503,4,29,193,226,1.163716814159292,0.027673641611494132,651,"You have what is known as the serpent syndrome, and the only prescription known to work is learning how to play the Pungi"
6631,8506,9,27,239,275,1.1636363636363636,0.027173009471668032,651,"let's put it this way--if it were me, i'd start jerking off"
3047,8507,5,34,230,269,1.1635687732342008,0.02547963415926022,651,"Mmhmm. Well, the New England Journal just published an article refuting that very premise in particular circumstances like yours. An apple a day does not keep the doctor away."
314,8508,6,30,221,257,1.1634241245136188,0.02676644405813834,651,After seeing Milton Berle's nothing surprises me.
4429,8508,7,28,222,257,1.1634241245136188,0.02732839842000029,651,"This medication should help you , Mr. Laocoon."
2577,8510,4,33,214,251,1.1633466135458168,0.025964360754625913,651,I wouldn't do any dancing for awhile.
4986,8511,6,28,211,245,1.163265306122449,0.027579195783511774,651,A but conztricting
7528,8511,5,30,210,245,1.163265306122449,0.02696583087376157,651,"No guarantees, but let's try a new attorney general."
2821,8511,4,32,209,245,1.163265306122449,0.02633818576438688,651,your DNA shows ancestor Medusa gene.......
2276,8514,3,33,203,239,1.1631799163179917,0.0260620489190882,651,So it says here you suffer from anxiety. Have you considered that being the root of your discomfort?
889,8515,5,28,200,233,1.1630901287553648,0.027808628156962,651,"Don't worry, the same thing happened to Britney Spears as well"
2504,8515,10,18,205,233,1.1630901287553648,0.030956633218293155,651,"It will only tighten to enforce Python Correctness if you use transgressive terms such as 'meritocracy,' 'masculinity,' and 'mongoose.'"
1850,8517,4,37,235,276,1.1630434782608696,0.0245279662058597,651,I recommend a salve for your pressure sores.
4663,8518,4,29,194,227,1.1629955947136563,0.027560899709046308,651,I'm writing you a prescription for some charm therapy to help remedy your odd condition.
9077,8518,5,27,195,227,1.1629955947136563,0.028259299843968765,651,Your snakeabetes is getting worse...
2146,8518,4,29,194,227,1.1629955947136563,0.027560899709046308,651,"For the last time, I can assure you that this is no longer part of the role play."
2637,8521,2,32,187,221,1.16289592760181,0.026497031727746766,651,Now this diagnosis shouldn't significantly affect your life.
96,8522,8,26,224,258,1.1627906976744187,0.027777982372256625,651,No one likes your new fashion choice; especially the snake.
451,8522,6,23,186,215,1.1627906976744187,0.02996133333018979,651,"The results speak for itself, this alternative new diet plan seems to be working out."
649,8522,4,34,220,258,1.1627906976744187,0.02551398779879765,651,"Of course Mr. Purdue, I can prescribe something for the discomfort."
1163,8522,3,36,219,258,1.1627906976744187,0.024915866241777433,651,Next time hold out for the feather.
100,8526,3,35,214,252,1.1626984126984128,0.025250708089424825,651,"As your neck becomes less inflamed, she’ll adjust the manipulation—well, more like serpenulation in this case."
4327,8526,6,29,217,252,1.1626984126984128,0.027063941317056108,651,"It's known in the medical world as Samuel L. Jackson syndrome. These things sneak up on you, next thing you know, it's hard to shake 'em off."
51,8528,4,26,179,209,1.1626794258373205,0.028963865270125382,651,"Your holistic healer might be on to something, but I'm afraid he hasn't ironed out all the kinks."
7330,8529,4,32,210,246,1.1626016260162602,0.026239296160637287,651,"It's just a little flu bug, take two asprins and  call me in a week if you havn't got rid of it."
3385,8530,4,31,205,240,1.1625,0.02662517474618699,651,"I must say, that is a different way to lose weight."
4032,8530,6,27,207,240,1.1625,0.027904030842129137,651,"I warned you about online dating""  Leslie Chain, Tigress@KatrinasKritters.or"
6409,8530,3,33,204,240,1.1625,0.025962134480397466,651,"Because of the expense of laundry services, we have adopted a holistic gown policy"
4712,8533,6,26,202,234,1.1623931623931625,0.02835274997699878,651,"Now Eve,didn't you have a problem with a snake a couple thousand years ago?"
4694,8533,5,28,201,234,1.1623931623931625,0.027698303037231142,651,Our Pharma Rep ran out of free pens.
6181,8533,6,26,202,234,1.1623931623931625,0.02835274997699878,651,"What seems to be the problem?""  ""I'm all choked up."
3038,8533,6,26,202,234,1.1623931623931625,0.02835274997699878,651,Hello
2185,8537,5,27,196,228,1.162280701754386,0.02814416354196869,651,"The results say you do have something constricting your breathing, but we'll have to conduct some more tests to find out what is causing the problem."
7410,8537,6,25,197,228,1.162280701754386,0.028822505167669682,651,This is what happens when muggles try to learn Parseltongue
7232,8539,7,29,229,265,1.1622641509433962,0.026739815743374567,651,Thanks Obama... Am I right or am I right?
6662,8540,1,34,187,222,1.162162162162162,0.025603538741387627,651,"Yeah, you obviously turned a curve. No constriction in either neck or chest region."
1187,8540,7,28,224,259,1.162162162162162,0.027131580713479438,651,You seem to want to be Cleopatra.
7614,8542,4,33,216,253,1.1620553359683794,0.025774815243609753,651,Maybe a tatoo is an option that would relieve the constipation.
3662,8543,6,28,213,247,1.1619433198380567,0.02737133068917827,651,Give him three bananas and call me in the morning.
4636,8544,6,22,182,210,1.161904761904762,0.03037520292488827,651,"Sore throat, upper and lower abdominal pain and restrictive breathing. It sounds like you need the ER."
1580,8544,3,28,179,210,1.161904761904762,0.02803475615846955,651,"It’s just that time of year. You know, when everyone needs a hug. 


Lin Axamethy Floyd
Media, PA"
3540,8546,4,25,175,204,1.161764705882353,0.029345283697873217,651,"So we can unwind you from the cobra, but it's a no on the snakeskin shoes."
3548,8547,3,32,200,235,1.1617021276595745,0.026237448318933577,651,So you say you have a need for being embraced?
5630,8548,7,29,230,266,1.1616541353383458,0.02664608398526714,651,Patrick?
2498,8549,6,25,198,229,1.1615720524017468,0.02870511530681841,651,"For a serious case of human pox, there are many routes we can take..."
5101,8549,3,31,195,229,1.1615720524017468,0.026628322018838232,651,"""I said you had a lisp"
5759,8549,5,27,197,229,1.1615720524017468,0.02802995316379977,651,"I think the problem is, the actual Bible verse is , “Satan get behind me” and not, “Satan get around me”."
6448,8549,4,29,196,229,1.1615720524017468,0.02733812180732021,651,I’d welcome a second opinion—just not hers.
3214,8553,6,30,224,260,1.1615384615384616,0.02647922133839332,651,"""At $50 for the first four feet and $25 for each additional foot, I calculate you get $175, plus a $150 bonus if we can show she's bearing eggs."""
3497,8553,5,32,223,260,1.1615384615384616,0.025912335537106538,651,It’s a panic attach. I suggest you see a psychiatrist
5611,8555,5,26,192,223,1.1614349775784754,0.028491880850774226,651,"I'm writing you a prescription for snake oil.
let me get this straight you are having some tightness in your chest"
7401,8556,8,29,242,279,1.1612903225806452,0.02632280412134492,651,"Sorry, the circus did not work out..."
8734,8557,6,32,235,273,1.1611721611721613,0.025664101414984382,651,I'll never understand disco fashion.
2733,8558,8,23,211,242,1.1611570247933884,0.028901114899920102,651,"I'm sorry sir, your anaconda wants some"
3346,8559,12,19,236,267,1.1610486891385767,0.02908372987236292,651,All I can legally prescribe is a wall.
6301,8560,8,22,206,236,1.1610169491525424,0.029382807348721663,651,Good news is that it constricts your appetite; bad news is it isn't poisonous.
3605,8561,2,29,174,205,1.1609756097560975,0.027526694525113766,651,"Well, looks like you’re up a sphincter, but everything else looks normal."
4159,8562,1,35,194,230,1.1608695652173913,0.025048965181675733,651,"Plus, with a little exercise and proper diet, you should lose those extra pounds in mere days."
1008,8563,5,30,214,249,1.1606425702811245,0.026563768183379417,651,It’s not the worst case of herping I’ve seen.
1349,8563,7,26,216,249,1.1606425702811245,0.027756242722176697,651,You are just too wrapped up in you job.
7959,8565,4,27,187,218,1.1605504587155964,0.028110320572891666,651,The hospital gown was uncomfortable so I brought my own.
2230,8566,6,27,210,243,1.1604938271604939,0.027582953372490483,651,You’re its emotional support human?  It’s a little backed up. I might have to snake it out.
1983,8566,10,19,214,243,1.1604938271604939,0.029947618550227467,651,This is one dumb cartoon. Please stop these stupid cartoon caption contests because they are scams!
6977,8568,6,31,231,268,1.1604477611940298,0.025927036524436616,651,"Sir, we're a respectable practice - go try the internet for snake oil."
4822,8569,6,26,205,237,1.160337552742616,0.0280180278915239,651,It appears that you have an an anaconda infection wrapping around your throat.
7168,8570,3,36,223,262,1.1603053435114503,0.024565831776070808,651,it's nothing that 90 days of a nice painkiller can't cure
1376,8571,5,27,199,231,1.1601731601731602,0.027804266346336655,651,"With your allergies to wool and fur worse in winter, I understand your need to keep warm!"
3592,8571,7,23,201,231,1.1601731601731602,0.02912669323604724,651,there are a lot safer ways to keep warm!
7362,8573,2,32,191,225,1.16,0.026064632730293354,651,You seem to be all wrapped up in details. You should try to loosen up a bit.
592,8574,5,29,210,244,1.1598360655737705,0.026856738069327483,651,I’m sorry; it’s non-ouroboros.
3291,8574,6,27,211,244,1.1598360655737705,0.027477549802450974,651,"Sir, I'm afraid your idea to save on your heating bill doesn't make much sssssssssense."
6410,8574,6,27,211,244,1.1598360655737705,0.027477549802450974,651,Take two aspirins and come back in six months.
5677,8574,8,23,213,244,1.1598360655737705,0.02867888543841257,651,"No- we don't do physical exams much these days.  I think you have cancer, so I'm sending you to a specialist."
8224,8578,7,24,207,238,1.1596638655462186,0.028536366981326135,651,"it's 2019. an apple a day, doesn't, keep the doctor away."
1470,8579,3,35,219,257,1.1595330739299612,0.02479829377276762,651,Another 10 years it will make a fine suit.
1477,8580,5,27,200,232,1.1594827586206897,0.02769276841537758,651,Your frostbite on your toes could have been prevented if you had adopted both siblings!!
1941,8580,5,27,200,232,1.1594827586206897,0.02769276841537758,651,I concur.
3491,8580,3,31,198,232,1.1594827586206897,0.026310671158966004,651,"Your astrological report for your condition says snake men are romantic, charming and have a sense of humor."
5880,8580,5,27,200,232,1.1594827586206897,0.02769276841537758,651,"I see here that you had an emergency aspendectomy in 1994, but it seems that surgery was not entirely successful."
6492,8584,3,27,177,207,1.1594202898550725,0.02812860274952616,651,We'll run some tests and I promise we'll get to the root of the problem.
7883,8585,4,32,215,251,1.159362549800797,0.025755670248078944,651,"Yep, your insurance only covers eastern medicine this year, so give Arnie about two weeks and will have you deconstipated in no time!"
6808,8586,5,26,195,226,1.1592920353982301,0.028139799451827305,651,This is a pretty restrictive diet.
7626,8587,7,29,234,270,1.1592592592592592,0.02627758592648502,651,Waiting for biopsy results is pretty tough for most patients
7727,8588,5,29,211,245,1.1591836734693877,0.026754849269421666,651,"Doctor, this is going to constrict your practice."
2972,8588,6,27,212,245,1.1591836734693877,0.027372942201788136,651,I would recommend shedding a few pounds
3209,8588,7,25,213,245,1.1591836734693877,0.027977383189558575,651,We'll just use a leaf blower to unwind it like a party horn.
1396,8588,2,35,208,245,1.1591836734693877,0.0248083442287185,651,I'm glad you contacted me. This new OCPD medicine is definitely right for you.
1951,8588,6,27,212,245,1.1591836734693877,0.027372942201788136,651,"Breathe in, breathe out..."
1109,8588,6,27,212,245,1.1591836734693877,0.027372942201788136,651,Have you heard about ‘An apple a day?’
1120,8588,5,29,211,245,1.1591836734693877,0.026754849269421666,651,About that tightness in you chest !!
4864,8595,4,27,189,220,1.1590909090909092,0.027873214921172774,651,Perhaps you are on your phone too much.
7142,8595,4,27,189,220,1.1590909090909092,0.027873214921172774,651,We have a problem. Our lawyers insist you sign a waiver allowing me to kill your pet snake.
1454,8597,4,29,200,233,1.1587982832618027,0.02690309497348969,651,It's quite normal to have a tight feeling in your chest when you're having a cold...
1751,8597,4,29,200,233,1.1587982832618027,0.02690309497348969,651,"No, seriously, trust in ME"
8155,8599,4,28,195,227,1.158590308370044,0.0273199425693268,651,"I see your feeling contrained, can I help you?"
3684,8600,4,31,211,246,1.1585365853658536,0.02602377732779579,651,Recently changed your laundry detergent?
7348,8600,7,25,214,246,1.1585365853658536,0.027870934723023207,651,The culprit of the circulation problem is your new fashion accessory.
332,8602,4,27,190,221,1.158371040723982,0.027756141761501846,651,I'm referring you to a flautist Uptown; that should relieve the pressure.
2553,8603,7,24,209,240,1.1583333333333334,0.028313636602637287,651,"Mr. Slitheran you need a specialist I'm referring you 
to Dr. Potter..."
3182,8603,6,26,208,240,1.1583333333333334,0.02769105476827222,651,Has there been any accidents that I should know about?
5360,8605,5,31,223,259,1.1583011583011582,0.02580877353615879,651,I take it you are the latest von Trapp babysitter?
7415,8606,2,33,199,234,1.1581196581196582,0.025390668500632325,651,We are working on finding the cause of a mysterious disease. Victims suffer shortness of breath and we think you could be a perfect test subject.
6805,8606,5,27,202,234,1.1581196581196582,0.02747241102008981,651,I'm afraid your health insurance is constrictive for this.
8068,8608,6,28,219,253,1.158102766798419,0.026765969270449084,651,"As your doctor, I have to tell you that I have concerns about this tight relationship you have developed."
7407,8608,8,24,221,253,1.158102766798419,0.02791337142232376,651,I'd say it's a case of being snake bit.
6880,8610,6,24,198,228,1.1578947368421053,0.02859373393874312,651,"Hmm, I think this is a case of lead poisoning."
1765,8610,2,32,194,228,1.1578947368421053,0.02574937222354296,651,"Mongoosol does have side effects, the primary one being a reduced ess drive."
2917,8610,6,27,214,247,1.1578947368421053,0.027166079464282178,651,"Keep trying the apples, meanwhile I’m going to give you a prescription for moth balls."
3863,8610,2,32,194,228,1.1578947368421053,0.02574937222354296,651,"We're okay for now, but call me if you come out of your comfort level."
3126,8614,4,30,207,241,1.157676348547718,0.026300311975594542,651,"So tell me again... why you thought
a boa constrictor was a good
idea for a pet"
6399,8614,7,24,210,241,1.157676348547718,0.028203560942682872,651,I recoil at your stupidity.
8450,8614,4,30,207,241,1.157676348547718,0.026300311975594542,651,I wouldn't recommend constricting your diet any tighter
2224,8617,4,27,191,222,1.1576576576576576,0.02764003888679108,651,"I tried to bring Martha to my nephew’s wedding in Iowa, but I was kicked off the flight."
1393,8617,5,25,192,222,1.1576576576576576,0.0283678778957895,651,Eating someone on the Jenny Craig' diet is not the same as being on the Jenny Craig diet.
4059,8619,3,31,201,235,1.1574468085106382,0.026000429474926742,651,"I'm afraid it's gone internal, sir."
4511,8619,6,25,204,235,1.1574468085106382,0.02802022627120022,651,"I'm suggesting we monitor your condition for the next 10 days, so I'll change your compress as soon as the monitor lizard arrives."
876,8621,4,31,213,248,1.157258064516129,0.02582924543505928,651,Can you speak or cat got your tongue?
1216,8621,7,25,216,248,1.157258064516129,0.027660432179491674,651,"I take it that you are not too vegan to want to remove your ""friend"""
5754,8621,3,33,212,248,1.157258064516129,0.025189284564551547,651,I'm going to prescribe some Advil for the pain...
7123,8621,5,29,214,248,1.157258064516129,0.026453729087126954,651,"You might feel a small pain in your anus, stomach and back."
6513,8625,4,28,197,229,1.1572052401746724,0.02709844386456713,651,After some tests your body seems to be constricted and I recommend a daily dose of three mice a day to relieve the pain.
5655,8626,7,27,227,261,1.157088122605364,0.02675036240480471,651,There has got to be a less constrictive way break to curb my addictions.”
8937,8627,10,18,214,242,1.1570247933884297,0.029869191704264043,651,It was actually your wife's idea -- she said you were complaining about not getting enough hugs.
8513,8628,5,25,193,223,1.15695067264574,0.028249229306966685,651,"Now, wreathe in ... wreathe out , wreathe in ... wreathe out"
6287,8628,3,29,191,223,1.15695067264574,0.026780975885155333,651,"Adam, you shouldn’t have tried to stop Eve from eating that apple. 

Joshua Halsband , Southbury, CT"
1700,8630,8,24,223,255,1.1568627450980393,0.027707834698712765,651,It's the band! the speckled band.
4433,8631,5,27,204,236,1.1567796610169492,0.02725550346645155,651,I said Bowel syndrome not Boa syndrome.
7047,8631,5,27,204,236,1.1567796610169492,0.02725550346645155,651,Your mouse probably appears to be doing much better.
366,8633,3,33,213,249,1.1566265060240963,0.025095866930708446,651,"Got the wrong astringent,eh!"
5361,8633,6,27,216,249,1.1566265060240963,0.026962295561244878,651,I'm writing you a referral to see a specialist named Mr. Hannah.
4879,8635,5,26,199,230,1.1565217391304348,0.02768356323295996,651,Weighted blanks are one thing....
4660,8636,8,25,229,262,1.1564885496183206,0.027197911356783653,651,For awhile I thought it was my neck cushion!
1935,8636,10,21,231,262,1.1564885496183206,0.028252810616585893,651,"As long as you don't got buns, hun, you should be okay."
9105,8638,4,30,209,243,1.1563786008230452,0.026099471569906333,651,I didn't think I'd have to get totally snaked.
6879,8638,4,30,209,243,1.1563786008230452,0.026099471569906333,651,You’re saying all you did was beat him at Hearthstone?
1624,8638,4,30,209,243,1.1563786008230452,0.026099471569906333,651,"Oh, keep your shirt on!"
5251,8638,4,30,209,243,1.1563786008230452,0.026099471569906333,651,"When I am upset, I tend to experience a strange feeling of a surrounding danger"
1793,8638,4,30,209,243,1.1563786008230452,0.026099471569906333,651,I notice you’re not wearing any clothes. Was this a bad blind date?
175,8643,6,23,195,224,1.15625,0.028834409413747146,651,Maybe you shoulda worn clothes.
236,8643,3,29,192,224,1.15625,0.02667035536961065,651,So. How was the 21st-century treating you?
5760,8643,4,32,220,256,1.15625,0.025289379116111795,651,This might actually be a situation where I would advise you to take three.
6466,8643,7,21,196,224,1.15625,0.02952052850372116,651,I can't believe I ate the whole thing
7450,8647,2,33,202,237,1.1561181434599157,0.02509498108655431,651,"Unfortunately, we're starting to see a lot of this type of anhedonia around here."
4228,8647,5,27,205,237,1.1561181434599157,0.027148318421060795,651,Are you worm enough?
7509,8649,5,29,216,250,1.156,0.02625668780746105,651,This is how I get swaddled now that Mommy has passed on.
3208,8649,2,35,213,250,1.156,0.024352168536904452,651,We need a guarantor.  Hurry.
8844,8651,4,26,188,218,1.1559633027522935,0.027852144069675046,651,"This is where I tell most patients, ""the Anaconda don't want none unless you got buns hun."""
3369,8652,7,27,229,263,1.155893536121673,0.02655993371478523,651,I can give you an ice pack for that.
5006,8653,2,32,197,231,1.155844155844156,0.025441558969989612,651,"We seem to be at an impasse 
here, Mr. Miller. Get this filled and give him the bottle."
6640,8653,4,28,199,231,1.155844155844156,0.02688047534237871,651,It's constricting quite a lot of blood.
3087,8653,3,30,198,231,1.155844155844156,0.0261709082518709,651,"So, you say your blood pressure has been feeling a bit high today?"
2364,8656,5,28,211,244,1.1557377049180328,0.026640965913101177,651,"When Adam was punished, I didn't realize his punishment was to become the snake"
2490,8656,2,34,208,244,1.1557377049180328,0.02466874489141858,651,This is extreme measures for someone who doesn’t want surgery!
2754,8656,4,30,210,244,1.1557377049180328,0.026000186563971215,651,"Your Gay Pride Parade boa is a bit to constricting,don't you think?"
9217,8656,3,32,209,244,1.1557377049180328,0.0253432108845663,651,My chest tightens up whenever my daughter's beau is around.
4393,8660,5,30,222,257,1.1556420233463034,0.025794264877913947,651,You seem to have your healthcare all wrapped up.
9168,8661,2,31,192,225,1.1555555555555554,0.025802806677791834,651,I'm going to refer you to a therapist- maybe she'll be able to squeeze the problem out of you.
964,8662,5,27,206,238,1.1554621848739495,0.027041966188131917,651,We recently switched to a Python-based treatment recommendation system.
643,8662,4,29,205,238,1.1554621848739495,0.026378224247606986,651,"If he hisses,well you know,just pat him on the back."
1521,8662,6,25,207,238,1.1554621848739495,0.02768980238613303,651,"Yeah, sorry, didn't mean to kink shame you or anything, but wondering if you might be gay because it's a male snake is kind of the least of your problems right now."
1311,8665,7,25,219,251,1.155378486055777,0.027350532320748022,651,but baby its cold outside
6137,8666,5,24,190,219,1.1552511415525115,0.028479054354965762,651,You've been catfished - it's going around.
5084,8666,4,26,189,219,1.1552511415525115,0.02773381873582848,651,"So, do you every have tightness of breath?"
662,8666,5,24,190,219,1.1552511415525115,0.028479054354965762,651,"Sorry, I hate snakes."
7818,8669,5,26,201,232,1.1551724137931034,0.027460903658209905,651,Classic case of Constricting Boa condition.
8093,8670,3,32,210,245,1.1551020408163266,0.025247560640917797,651,"The more skin-to-skin you can do, the better."
8908,8670,9,20,216,245,1.1551020408163266,0.028951258183964764,651,This exam is a wrap.
8021,8672,4,34,233,271,1.154981549815498,0.02437990704530911,651,Think of this like the oat milk equivalent of taking your blood pressure.
2602,8673,6,23,197,226,1.154867256637168,0.028595316989682,651,Here's an Rx for an ace bandage you can pick up at CVS.
3761,8674,3,31,205,239,1.1548117154811715,0.02559786384383007,651,Follow up with me in three two four weeks if it doesn't get better.
5359,8674,9,19,211,239,1.1548117154811715,0.029431508280644596,651,You have the twisted body syndrome.
1487,8676,5,29,218,252,1.1547619047619047,0.02606253567961952,651,I'm suggesting that you get it a pet. Come back and see me  in a month..
2512,8677,3,30,200,233,1.1545064377682404,0.025962943703792617,651,"Mr McKenna, the pressure you feel is definitely not from an elephant sitting on your chest. Might it feel more like a python?"
2408,8678,3,32,211,246,1.1544715447154472,0.02515262233183242,651,You may not have considered an over the counter laxative Msiter Wilson but it certainly would have resulted in one less mouth to feed.
8167,8679,6,30,236,272,1.1544117647058822,0.02538896080861535,651,"Hey, wow! The secret loophole! No charge, then, obviously."
825,8680,4,27,196,227,1.1541850220264318,0.027073669715236805,651,It's up to you to extract the snake oil
6832,8681,2,33,205,240,1.1541666666666666,0.024806023379592302,651,"Yes, yes, taxes are squeezing the middle class."
695,8681,3,31,206,240,1.1541666666666666,0.025499143111007285,651,"Walk it off, and you will be fine in no time."
2245,8681,4,29,207,240,1.1541666666666666,0.0261739145502231,651,...and you say your watch is also stuck in the snake?
5438,8681,4,29,207,240,1.1541666666666666,0.0261739145502231,651,"You do seem wrapped too tight. Anyway, is it a therapy cobra or a just a mink alternative? 
PG. Ellicott City"
2274,8681,1,35,204,240,1.1541666666666666,0.02409297184703725,651,I'll refer you to a specialist. I didn't even take the herpetology course in med school.
8821,8686,5,29,219,253,1.1541501976284585,0.025966523465218137,651,You have nothing to worry about. This should make you feel better in no time.
5685,8686,9,21,223,253,1.1541501976284585,0.02827965217639134,651,Sir Mix a Lot would be proud.
8996,8688,4,28,202,234,1.1538461538461537,0.026559961232853896,651,A few drops of Basilisk venom should do the trick.
7474,8688,9,24,240,273,1.1538461538461537,0.0268514144609743,651,I’m afraid your tail coverage has lapsed.
7198,8688,1,36,210,247,1.1538461538461537,0.02370848367804664,651,I see here your breathing constructed. I suggest you try to shake it off.
3211,8688,8,20,206,234,1.1538461538461537,0.02919180195113635,651,"I said you have clogged veins, not clogged drains."
5378,8688,8,20,206,234,1.1538461538461537,0.02919180195113635,651,Listened to too much Taylor Swift have you?
4724,8688,4,26,191,221,1.1538461538461537,0.027500133042283454,651,I'll give you this for your feather allergy but I can't help with your lost cat. All things must pass.
6746,8688,4,30,213,247,1.1538461538461537,0.02570677196854413,651,I didn't prescribe THAT kind of a boa!
9183,8688,3,28,190,221,1.1538461538461537,0.026741764752729165,651,Organic snake oil may cause shortness of breath.
8274,8696,5,29,220,254,1.1535433070866141,0.025871210262707518,651,You seem to be comfortably constricted
2538,8697,3,31,207,241,1.1535269709543567,0.025401173341017703,651,It's not a charming look
7715,8697,4,29,208,241,1.1535269709543567,0.026072931436870887,651,It's been clinically proven to squeeze the truth out about your diet
125,8699,4,27,197,228,1.1535087719298245,0.026963145688376787,651,Is your Python release causing you any pain?
2742,8699,4,27,197,228,1.1535087719298245,0.026963145688376787,651,"When my nurse told you what to wear, she didn't realize that you had a pet snake named Johnny"
6752,8699,2,31,195,228,1.1535087719298245,0.025489713613261713,651,"My attending physician will be here in a moment, but my initial diagnosis is ophidiophobia, for which we don't yet have a cure but some promising research with mice."
7138,8702,3,25,174,202,1.1534653465346534,0.028180009872979177,651,I'ts quite normal to experience a feeling of constriction when starting this new medicine that I'm prescribing for you.
6550,8703,3,34,224,261,1.1532567049808429,0.02423900171738357,651,Now how long have you been wrapped up?
5895,8704,6,26,216,248,1.153225806451613,0.02685504313822091,651,"I warned you that your diet was too constrictive, and the problems are only going to snake around from here."
5861,8705,4,28,203,235,1.1531914893617021,0.02645480019941891,651,"Sir, have you not heard that an apple a day will keep the doctor away?"
7874,8705,5,26,204,235,1.1531914893617021,0.02713349779750818,651,But Cleopatra was a queen.
6136,8705,6,24,205,235,1.1531914893617021,0.027795628286901304,651,"We're going to do an X-ray, I'm giving you 16 prescriptions, and we'll ask you to come back for a follow-up in two weeks."
8159,8708,6,22,194,222,1.1531531531531531,0.028834942892485744,651,You're headed for the last wound-up. You're not covered for pre-existing conditions.
6626,8709,3,26,180,209,1.1531100478468899,0.027593851658624897,651,"Chest pain and belly ache take an aspirin, and cage the boa expect to feel better."
6881,8710,5,31,232,268,1.1529850746268657,0.025001428753487796,651,So second name is Kekule ?
1558,8711,2,35,218,255,1.1529411764705881,0.023912277965117457,651,Snake cuddles
2124,8711,7,25,223,255,1.1529411764705881,0.026947903501547542,651,Now that you're all warmed up.
8067,8713,7,23,212,242,1.1528925619834711,0.02788295528838727,651,And I used to believe you were the only and last hope for humanity. Oh well.
5518,8714,4,27,198,229,1.1528384279475983,0.02685351268364036,651,Take two aspirins for pain and call me in the morning.
7936,8714,2,31,196,229,1.1528384279475983,0.025387012479308586,651,"All your tests came out fine. It's a wrap. See you in a year, Mr Nagini."
7385,8714,4,27,198,229,1.1528384279475983,0.02685351268364036,651,I see you are an avid follower of animal print fashion
2882,8717,4,30,215,249,1.1526104417670682,0.025514781364780567,651,Is this a new technique for testing Blood Pressure?
3462,8718,1,34,201,236,1.152542372881356,0.0242107566763968,651,Stick to snakeskin loafers next time.
4260,8718,5,26,205,236,1.152542372881356,0.027026077140186126,651,This treatment can seem extreme. Whatever ounce of life you had for bipartisan politics will be gone. Are you ready?
7323,8720,8,21,214,243,1.1522633744855968,0.028380739356573412,651,I'm going to recommend a few tests for tropical allergies.
5705,8721,5,28,217,250,1.152,0.02604413924004823,651,I'm sorry to say your rat face has truly done you in this time
5368,8721,5,28,217,250,1.152,0.02604413924004823,651,As I see it- your cobra shirt is wound a little too tight
4853,8721,6,26,218,250,1.152,0.02665381216282663,651,I think there is a bug in my Python code.
2251,8724,3,30,204,237,1.1518987341772151,0.0255566804783229,651,"Other than being a little snake-bit, you are quite healthy..."
3255,8724,5,26,206,237,1.1518987341772151,0.026919497184053873,651,My man! There's no reason to be so constricted around me. I'm the cool doctor!
6956,8724,4,28,205,237,1.1518987341772151,0.02624693549458084,651,This should measure your blood pressure!
2981,8727,9,19,216,244,1.151639344262295,0.02886147882967363,651,I don't think TSA will buy the Siamese twins story.
3144,8727,5,27,212,244,1.151639344262295,0.02642081578128997,651,Take an aspirin and call me in the morning.
4195,8729,3,29,199,231,1.1515151515151516,0.025920642801889045,651,And what about in your workplace?
7153,8729,5,30,229,264,1.1515151515151516,0.02515632480663124,651,"How many times do I have to tell you, your childhood dream of becoming a snake charmer will never be a reality​"
7260,8729,5,25,201,231,1.1515151515151516,0.02733435119171284,651,I told him we should've used protection.
8444,8729,5,30,229,264,1.1515151515151516,0.02515632480663124,651,"Put on some pants, feed him regularly, and you’re good for the polar vortex."
8606,8733,4,25,189,218,1.151376146788991,0.02758803726912834,651,"Your muscle's are doing great and you made a good friend"""
6324,8734,5,26,207,238,1.1512605042016806,0.026813748189197344,651,I'll order an MRT and we'll go from there.
731,8734,6,24,208,238,1.1512605042016806,0.02746696766693973,651,"Normally the nurses and I like to guess why someone wouldn't list an emergency contact. Sadly for us, this doesn't leave much room for guesses."
6191,8734,6,24,208,238,1.1512605042016806,0.02746696766693973,651,"I sure can make him loosen his grip, Mr. Channing. See? Snake Oil Salesman isn't always a bad thing, sir!"
8608,8734,7,22,209,238,1.1512605042016806,0.028105009049629235,651,Oh fuck oh shit fuck oh god
3417,8738,5,29,224,258,1.1511627906976745,0.025496798557609907,651,"Mr. Anderson, some other patients of mine have responded well with using a CPAP machine. But just to be sure, I'm prescribing a small dosage of Ambien. Sometimes that mask makes it hard to get to sleep."
3776,8739,3,28,194,225,1.1511111111111112,0.026300394642997754,651,"So what is your situation?” 
“Well I’m all tied up.”"
745,8740,6,25,214,245,1.1510204081632653,0.026948101024841895,651,"No, believing you’re a slytherin does NOT give you any superpower in real life"
6194,8741,8,24,233,265,1.150943396226415,0.026723673384074637,651,I see. And when was the first day of your last period.”
6883,8741,2,36,227,265,1.150943396226415,0.02329437984831905,651,"I was cold.  I asked for a boa, not a boa constrictor!"
147,8743,4,35,246,285,1.1508771929824562,0.023450835675279662,651,It's just to help with the chaffing from the snake skin is hugging your curves.  You think you have problems?  You should have seen the lady with the alligator purse!
141,8744,6,23,203,232,1.1508620689655173,0.02790109643022363,651,But why are your pants off? I don't want to see your second snake.
4252,8744,4,27,201,232,1.1508620689655173,0.026529854434884287,651,You seem to be wrapped up with this new diagnosis.
9086,8744,4,27,201,232,1.1508620689655173,0.026529854434884287,651,"Your office is rather cold, doc"
5809,8747,5,23,191,219,1.1506849315068493,0.028222663430336407,651,It's obvious that it's the season to feel squeezed by the IRS.  We're still searching  for a cure.
5278,8748,5,26,208,239,1.1506276150627615,0.026708820563875607,651,It seems your tape worm has strong  pheromones and is attracting company.  If the snake get randy you may have a problem.
7043,8749,8,23,228,259,1.1505791505791505,0.027114538261600943,651,I told you there were no crocodiles in the sewer
2394,8750,4,23,179,206,1.1504854368932038,0.0285139693306312,651,Snake Charming is an unhealthy habit.
4272,8751,6,22,198,226,1.1504424778761062,0.028355433252384453,651,"‘’I realize it’s cold in here, but this Boa will do the trick. I’ll bet you feel warm already.”"
5842,8751,8,18,200,226,1.1504424778761062,0.029710155308588008,651,And how long have you been self conscious of your short torso?
6915,8753,5,22,186,213,1.1502347417840375,0.02869920623389809,651,IT'S A NEW TREATMENT FOR REMOVING BELLY FAT.
3725,8754,1,33,199,233,1.150214592274678,0.02423251765222348,651,"You're lucky she doesn't know how to ""kill the spare"" yet"
554,8755,6,26,221,253,1.150197628458498,0.026357518347265834,651,"Interesting case, Holmes."
3829,8755,4,30,219,253,1.150197628458498,0.025139204049700523,651,Your  obsession of playing days of snakes and ladders are over.
8023,8757,5,23,192,220,1.15,0.028102433753991272,651,"I understand your concern, however you will have to wait until your very attractive, expensive and endangered Gucci garment sees   a better snuggle buddy then you."
5405,8757,6,21,193,220,1.15,0.028831541466119673,651,"Hm. Intermittent headaches and you say the glass just disappeared? I'm going to refer you to an optometrist, Harry."
1226,8757,3,30,207,240,1.15,0.025260152687731952,651,"Usually, I prescribe  something to get it out from your intestine. This will be a challenge"
3624,8757,3,33,224,260,1.15,0.024111783040208393,651,Looks to me like your wife shouldn’t have believed Gen.3:4 after all.
3783,8761,4,32,231,267,1.149812734082397,0.0243201875986434,651,You say you had sushi last night?
4563,8761,6,28,233,267,1.149812734082397,0.025451760284033675,651,"Unfortunately, Monte, the snake doesn’t get the gag."
6369,8763,6,25,216,247,1.1497975708502024,0.026743379590218136,651,I want you to take two aspirin and call me in the morning.
6930,8764,2,30,195,227,1.1497797356828194,0.02532679435990487,651,"Clearly, Boa entanglement"
8701,8764,1,32,194,227,1.1497797356828194,0.024545094777769443,651,"I know you want to keep your diagnosis under wraps, Mr. Jones, but this is taking things a bit too far.”"
4204,8766,3,32,219,254,1.1496062992125984,0.02441783040060563,651,I think you may be getting to wrapped up in your work.
7339,8766,5,28,221,254,1.1496062992125984,0.025660779903417696,651,"What are you writing, Doctor?"
7960,8768,3,29,202,234,1.1495726495726495,0.025611968912210833,651,What did you say your name was? (I’m talking to the snake)
5944,8769,6,27,228,261,1.1494252873563218,0.025800594980397648,651,"No worries, just an 'Oh heck...'"
2234,8770,4,28,209,241,1.1493775933609958,0.025840774361910485,651,"After 2 wounds he’s having an attachment dis-Order moment, I’m afraid."
6456,8770,4,28,209,241,1.1493775933609958,0.025840774361910485,651,"Sorry, but I can't see you unless you're dressed in just the Johnny-coat."
7141,8770,1,34,206,241,1.1493775933609958,0.023748919549932065,651,"no, this isn’t what they meant by “exposure therapy”"
1235,8773,3,31,214,248,1.1491935483870968,0.024735719054459204,651,Your problem is not a snake in the GR-ass . . .
4330,8774,4,26,198,228,1.1491228070175439,0.02671211465519743,651,"Yes, we’ll have to shuffle it off—but at least it’s not mortal."
4998,8774,4,26,198,228,1.1491228070175439,0.02671211465519743,651,"Now, medical concerns such as yours say a lot about why preventive medicine is getting such good press..."
5670,8776,5,28,222,255,1.1490196078431372,0.025566683736980626,651,The humans insurance is expired.
1213,8776,7,24,224,255,1.1490196078431372,0.026747192442681908,651,This is the worst case of body-turning-into-a-huge-snake-itis I've ever seen.
4259,8776,6,26,223,255,1.1490196078431372,0.026163597046972055,651,...best you see a proctologist for this asp problem
133,8779,6,23,206,235,1.148936170212766,0.02756639360562632,651,"keepin' you warm,huh ?"
2320,8780,4,31,227,262,1.1488549618320612,0.024544237434589364,651,Compression therapy is very effective but there are still a few bugs to be worked out -- eggs!
5002,8781,7,22,213,242,1.1487603305785123,0.027667403285090864,651,Wrap a warm compress around your neck and call in the morning.
2833,8782,4,29,216,249,1.1485943775100402,0.025292052377424296,651,"Well, the good news is you can leave your coat on the chair, I will buy it from you."
5244,8782,5,27,217,249,1.1485943775100402,0.025924419539083362,651,"'So let me get this straight, shortly after watching The Human Centipede you decided you wanted a bigger penis?'"
1969,8782,5,27,217,249,1.1485943775100402,0.025924419539083362,651,"Yup, I think an annulment is your best option. These types know great lawyers...."
8891,8785,3,28,198,229,1.148471615720524,0.025873229103591962,651,Take an Advil and call me in three weeks if it doesn't get better.
1331,8786,1,33,202,236,1.1483050847457628,0.02394899392507772,651,"it would be easier if you just bought a winter coat.

Elizabeth Shaw
San Francisco"
2957,8786,5,25,206,236,1.1483050847457628,0.02679183488988779,651,Take two feathers and call me in the morning.
3104,8786,4,27,205,236,1.1483050847457628,0.026110158752506826,651,I'd lighten up on the malaria pills.
6255,8786,4,27,205,236,1.1483050847457628,0.026110158752506826,651,Viagra won't help with coiltus.
7122,8786,5,25,206,236,1.1483050847457628,0.02679183488988779,651,"This is what you get for making an asp of yourself.

I'd say you're worried about today's constrictions.

It's a wrap alright."
6170,8791,4,28,211,243,1.1481481481481481,0.025642333689777475,651,But Today’s Greek gods would recommend .5 lorazepam
7370,8791,3,34,233,270,1.1481481481481481,0.023489497500535757,651,Have you heard about this new painkiller? I highly recommend it.
3230,8793,5,27,218,250,1.148,0.025827353887600282,651,This is for your wife: Take two Aspirin and call me in the mourning.
6325,8793,3,31,216,250,1.148,0.02455188751853697,651,"You know, there are other ways of showing you are a diva!"
4539,8795,6,27,231,264,1.1477272727272727,0.025525538622246904,651,Adam and Eve you say--the play!
3606,8796,4,27,206,237,1.1476793248945147,0.02600728517188872,651,"You're being squeezed to death."" ""I'd like a second opinion"". ""You're wife is very attractive."
8325,8797,3,34,234,271,1.1476014760147601,0.023409043970482726,651,"If I take it off, it should be a fast recovery, but I am still figuring out how to do that."
3170,8798,3,30,211,244,1.1475409836065573,0.024875228203547654,651,You say you were born in the Year of the Snake...
7630,8798,3,30,211,244,1.1475409836065573,0.024875228203547654,651,"Here's a prescription for extreme skin shrinkage.
Apply topically!"
1135,8800,5,22,190,217,1.1474654377880185,0.028202502823886165,651,I believe that there are better remedies for the Polar Vertex.
3894,8801,3,31,217,251,1.1474103585657371,0.024460983399967995,651,You said you wanted a tight wrap!!?!
8632,8801,2,33,216,251,1.1474103585657371,0.023800571399303642,651,"It’s one of those ophidian possessions cases, a Standard Code 59421."
4222,8803,6,26,226,258,1.1472868217054264,0.02587797177538185,651,I can remove that Spanx.
5163,8804,4,26,201,231,1.147186147186147,0.02638794354927031,651,"Take two aspirin, and don't inhale!"
2474,8804,4,26,201,231,1.147186147186147,0.02638794354927031,651,There are better ways to stay warm; I recommend you try saran wrap.
6405,8806,7,21,210,238,1.1470588235294117,0.027882821062327305,651,"No, man, nothing is fucked here."
1588,8806,5,30,237,272,1.1470588235294117,0.024464541087149665,651,"WE FIND THAT USING ""OLD SQUEEZER"" HELP OUR PATIENTS RELAX."
239,8806,6,23,209,238,1.1470588235294117,0.02723957579571926,651,"Actually, it’s “eat an apple a day”, not “eat an Adam a day”."
6382,8809,3,30,212,245,1.146938775510204,0.024780806930600415,651,I writing you a prescription for a high blood pressure drug.
6999,8809,3,30,212,245,1.146938775510204,0.024780806930600415,651,I'm writing a prescription for Snake Off.  It should provide significant improvement in breathing.
3984,8811,2,33,217,252,1.1468253968253967,0.02371315263205013,651,Snake got your body?
4508,8811,5,27,220,252,1.1468253968253967,0.02563537142985485,651,When did you become aware of your wrap?
9069,8813,3,26,189,218,1.146788990825688,0.02653273074562298,651,You might outlive your bosom friend.
6876,8813,4,24,190,218,1.146788990825688,0.027317828170727164,651,Anaconda think you should apply snake oil to that growth twice a day until the swelling subsides.
2874,8815,2,29,194,225,1.1466666666666667,0.025260547066428284,651,I have seen this before. Has anyone in your family complained of this.
5099,8815,6,21,198,225,1.1466666666666667,0.028228095876721784,651,"I am familiar with the Hong Kong RX of blood and venom. However, I think you would be just as satisfied with a pair of shoes and two belts."
1531,8817,7,25,234,266,1.1466165413533835,0.025899057322563826,651,This prescription will make it grow feathers.
8458,8817,3,33,230,266,1.1466165413533835,0.023606564655604595,651,"Ron, Your temperature is low. Change into the coat, and  I will take it again."
6,8819,5,24,203,232,1.146551724137931,0.026982258446031793,651,I warned you not to forget the Boa Constrictor repellent.
2099,8819,7,20,205,232,1.146551724137931,0.0283316126706713,651,"So... you bought her as a baby 10 years ago
on a vacation in Florida? When did it go wrong?"
32,8821,3,30,213,246,1.146341463414634,0.024687093496750318,651,"I can help with the sore throat, but I’m gonna have to transfer you over to another docter."
8953,8821,4,28,214,246,1.146341463414634,0.025350277920108348,651,G'by snake; g'by choking feeling.
7076,8823,5,21,186,212,1.1462264150943395,0.02855227698556522,651,I wish you had put on that gown. Denise says that it really interferes with her swallowing reflex.
6769,8824,12,14,234,260,1.146153846153846,0.028952136757787104,651,you have big fuck of snake and die
5096,8825,5,29,233,267,1.146067415730337,0.024692462497358337,651,Felix is experiencing separation anxiety since starting kindergarten.  Your symptoms are normal.
5818,8826,0,33,193,226,1.1460176991150441,0.02354159728935548,651,"Well it seems that you’re severely constricted.
My advice would be to stay out of the jungle and away from belly dancers."
2898,8827,6,22,205,233,1.145922746781116,0.027553352999830406,651,How is your oil business?
232,8828,6,23,211,240,1.1458333333333333,0.02702594230392634,651,This is not the best way to reveal your inner self
4969,8828,3,29,208,240,1.1458333333333333,0.025015975834552295,651,"Thought he was my wife, doc."
45,8828,3,29,208,240,1.1458333333333333,0.025015975834552295,651,Take two pills and call me in the morning.
3204,8831,6,24,217,247,1.145748987854251,0.02652573657016817,651,I wish Bagheera was still here.
2795,8832,3,31,220,254,1.1456692913385826,0.024192230496129015,651,"A. Bose, B. boa, C. boast?"
3271,8832,2,33,219,254,1.1456692913385826,0.023540208675548784,651,"Your pet, Alpha, is conducting a beta test.  You need to stand up so he can finish it, and then he'll let go."
3300,8832,5,27,222,254,1.1456692913385826,0.025446202077259776,651,your'e rattling my brain .
4484,8832,4,29,221,254,1.1456692913385826,0.024827134515833422,651,I am afraid but I'm not good in dating advice.
1864,8836,3,32,226,261,1.1455938697318007,0.02380891886663213,651,"You say, 'you feel like Elvis Presley, all shook up""?"
445,8836,4,30,227,261,1.1455938697318007,0.024420013531188268,651,Diagnosis: High Fashion
1451,8836,5,28,228,261,1.1455938697318007,0.02501618484359605,651,"It's all about stress, I would say."
1179,8839,7,19,201,227,1.145374449339207,0.028681553970834075,651,"Before we proceed, I must offer a full and possible terminal list of side eagfects from our revolutionary ‘Blue Shield’ coverage."
7107,8839,5,23,199,227,1.145374449339207,0.027288493332967644,651,It is an FDA approved snake-hug treatment
2794,8841,3,28,203,234,1.1452991452991452,0.025358234165271134,651,"Personally, I don't care how much longer I live."
4341,8842,1,33,207,241,1.1452282157676348,0.023490754945590303,651,"Well, so far the unravelling is working nicely."
6724,8842,4,27,210,241,1.1452282157676348,0.025603710819875315,651,Now about that pain in your chest.....
4206,8844,5,26,217,248,1.1451612903225807,0.02579992081395949,651,The apple was forbidden. He's going to shed your skin in 3-4 weeks.
5686,8844,5,26,217,248,1.1451612903225807,0.02579992081395949,651,I am prescribing a ladder
3612,8846,3,31,221,255,1.1450980392156862,0.024103942402746947,651,I'm prescribing a wraparound solution!
1054,8847,3,32,227,262,1.1450381679389312,0.02372438010273635,651,"We will have to run a few exams so I can avoid possible liabilities for my diagnosis. Of course, after that, YOU will have to decide what is the best treatment. But I am here to make sure you feel no pressure."
7552,8848,4,25,199,228,1.144736842105263,0.026455498994584173,651,I asked my wife for a snake skin suit. She got a size too small.
7191,8848,3,27,198,228,1.144736842105263,0.02571479271526757,651,We have separation anxiety.
672,8850,5,24,206,235,1.1446808510638298,0.026658772380273574,651,"so mister rinaldi ,did it help with your constipation ?
BEN CRAZY"
2200,8850,2,30,203,235,1.1446808510638298,0.024527115554312893,651,Boas are out of style this season.
6642,8850,6,22,207,235,1.1446808510638298,0.027332405564813422,651,the pressures of life
4571,8853,3,29,210,242,1.1446280991735538,0.02482337612434262,651,I recommend keeping an eye on it. Come back in two to three weeks if anything progresses.
2862,8853,5,25,212,242,1.1446280991735538,0.026168392304837067,651,"When he chased your ambulance, about how fast was he going?"
1480,8855,8,20,221,249,1.144578313253012,0.027528024774644676,651,"I can assure you, nursing a snake in your bosom is not lethal."
5135,8855,5,26,218,249,1.144578313253012,0.02570271003348385,651,"Canada Goose, boa constrictor...whatever keeps you warm..."
8252,8857,3,31,222,256,1.14453125,0.02401629085771781,651,"So you'd describe your occupation as ""trendy diets guru""?"
8588,8857,3,31,222,256,1.14453125,0.02401629085771781,651,I see you were visiting the Florida Everglades.  Did you want to catch up on nature?
5604,8859,4,23,188,215,1.1441860465116278,0.02739514699062795,651,"The weight loss has been fine, but we'll need to do something about those internal organs."
6673,8859,2,27,186,215,1.1441860465116278,0.025759589600420275,651,"The woman you came with wants you to know that the snake and the swing coat look better on you, so there's no need to return them."
1155,8861,7,18,197,222,1.1441441441441442,0.029044331299172745,651,"And for the rental of the prosthesis,an additional $1,500 monthly."
8836,8861,5,22,195,222,1.1441441441441442,0.027605138784688378,651,I'm writing you a refrrral to Dr Pol.
6884,8863,4,26,206,236,1.1440677966101696,0.025864670035842426,651,You picked up the Dengu Fever during your Amazon trip.
6725,8863,7,20,209,236,1.1440677966101696,0.02787771934934248,651,Just take one tablet three times a day for shortness of breath.
863,8863,3,28,205,236,1.1440677966101696,0.02515788404013949,651,"I'll need a second opinion to be certain but you love of the 
Gadsden flag may kill you."""
1737,8863,10,14,212,236,1.1440677966101696,0.029754887265429245,651,I suggest waiting until the Polar Vortex is over.
807,8867,6,23,214,243,1.1440329218106995,0.026711664837820934,651,"If you're on a constricted timeframe, this is the diet for you!"
4349,8867,4,27,212,243,1.1440329218106995,0.025406549713953824,651,"I’m sorry, but your health plan won’t pay for anything thar’s not generic."
8244,8867,4,27,212,243,1.1440329218106995,0.025406549713953824,651,"So, I hear they call you the Snake Lady."
7219,8870,6,24,220,250,1.144,0.026226079175425028,651,We are going to squeeze that penis envy right out of your nose.
8933,8871,4,29,224,257,1.1439688715953307,0.024556236500708824,651,You seem to suffer from pet seperation
4873,8872,6,26,232,264,1.143939393939394,0.02532491448728327,651,"Look, you're both vegans. I talked to the Vet and we want to recommend a therapist."
8380,8872,7,24,233,264,1.143939393939394,0.025887380239669286,651,"I'm so sorry, Mr. Rod, it's Asclepius Disease."
8920,8874,4,24,195,223,1.1434977578475336,0.026743744810631145,651,"Sorry, you have a bad case of the snakes."
4521,8875,6,22,209,237,1.1434599156118144,0.027114953002774528,651,"Look, you're going to exercise restraint."
8932,8875,4,26,207,237,1.1434599156118144,0.025762477846113286,651,I believe the correct phrasing of the activity is 'shake... rattle and roll.'
6920,8877,5,25,214,244,1.1434426229508197,0.02596693397770346,651,Their our new eco-friendly gowns
6633,8877,3,29,212,244,1.1434426229508197,0.024633695081310712,651,It has 5 Star reviews from Amazon Essential.
2918,8879,7,22,222,251,1.1434262948207172,0.026730662932669427,651,Your reptilian brain has slipped and I prescribe stretching!
5139,8879,4,28,219,251,1.1434262948207172,0.024877918139175337,651,SO YPOU FEEL LIKE IF YOUR FREEDOM IS BEEN TAKEN AWAY.
8860,8881,3,26,195,224,1.1428571428571428,0.02586916840353326,651,They said he was casein-free.
7384,8881,5,21,191,217,1.1428571428571428,0.027932783813591096,651,Sir please don’t hiss at me! You have merely a stomach bug.
8874,8881,2,28,194,224,1.1428571428571428,0.02508336972958259,651,"Oh heck, it's up to my neck."
6749,8881,1,33,211,245,1.1428571428571428,0.02313646657654046,651,Severe anxiety is known to cause feelings of
5972,8881,4,28,220,252,1.1428571428571428,0.024785535183532693,651,"On the bright side, you won't need a heavy coat this winer."
5549,8881,4,25,202,231,1.1428571428571428,0.026133521220993855,651,We'll admit you to the vet service and consult internal medicine.
2433,8881,3,26,195,224,1.1428571428571428,0.02586916840353326,651,You've gain a lot of weight since last here!
2093,8881,6,23,216,245,1.1428571428571428,0.02650615235020311,651,Perhaps this takes the boa around your neck look abut too far.
1253,8881,3,27,201,231,1.1428571428571428,0.025403098541393544,651,"Fasten your seatbelt, it's going to be a bumpy night."
6609,8890,7,23,230,260,1.1423076923076922,0.026060692961263638,651,"You have what we call an Adam and Eve complex, and your Eve has run off with your so-called apple"
4092,8891,5,26,222,253,1.1422924901185771,0.025321036259954348,651,Doctor: So... what's got you wrapped up?
368,8891,5,26,222,253,1.1422924901185771,0.025321036259954348,651,"See, if you had been wearing sunscreen..."
3183,8893,4,27,215,246,1.1422764227642277,0.02511639577458699,651,"So how long have you been a vegetarian, Monty?"
5726,8894,4,26,209,239,1.1422594142259415,0.025560479986329876,651,Have you been bitten?
9012,8894,4,26,209,239,1.1422594142259415,0.025560479986329876,651,Wrapped up in coding? Sir?
5709,8896,2,29,201,232,1.1422413793103448,0.024552280876630094,651,When did you start noticing this weight gain?
3557,8897,4,24,197,225,1.1422222222222222,0.026520764883721532,651,Dizzy spells and numbness ARE common side effects of this medication.  See you in two weeks.
4984,8897,4,24,197,225,1.1422222222222222,0.026520764883721532,651,"I told Eve, apples were not good for her diet."
8735,8897,3,26,196,225,1.1422222222222222,0.025761762950836604,651,"well...

stand up ... and ...a...
turn your head ..and cough"
7056,8900,2,32,220,254,1.141732283464567,0.023303486209238066,651,"... the success rate with our ""Two-for-One Weight-Loss Plan"" is nearly 100%, though honestly -- we still never seem to know which way things are going to swing..."
4653,8900,4,28,222,254,1.141732283464567,0.02460279767187167,651,"Here, have a cough drop”"
3841,8902,6,23,218,247,1.1417004048582995,0.02630375997673065,651,"It seems that the anaconda wants some because you have buns, hun."
1770,8903,4,26,210,240,1.1416666666666666,0.025460655968071604,651,Haemorrhoids...
2646,8904,5,23,205,233,1.1416309012875536,0.026627219352511673,651,Have you told #MeToo
3083,8905,6,23,219,248,1.1411290322580645,0.02620371186165395,651,"My notation will state that it is it is not possible to determine, with certainty, who started this."""
3806,8906,3,28,210,241,1.1410788381742738,0.02467048381111162,651,I was thinking about the people and I hugged the snake
6816,8906,5,24,212,241,1.1410788381742738,0.02603438235674132,651,"If I weren't all wrapped up, I could perform the proced -- oh, that was a poor choice of words, wasn't it?"
3418,8908,5,23,206,234,1.141025641025641,0.026520091366144093,651,There are a lot of snakes in the garden.
3791,8908,2,29,203,234,1.141025641025641,0.024357091897861716,651,You're fine; the snake isn't wrapped too tight.
6637,8908,2,29,203,234,1.141025641025641,0.024357091897861716,651,"buddy, i can't help unless you're honest with me. 
are you sure you weren't jerking off?"
7458,8908,1,31,202,234,1.141025641025641,0.023592064038675472,651,Keep on coughing and it will only hurt more.
809,8912,5,20,188,213,1.1408450704225352,0.02814685992135948,651,I brought my lawyer with me to make sure there will be no malpractice
6330,8912,3,24,186,213,1.1408450704225352,0.02652666428587358,651,"Monty, you're not going to believe what's happened."
2263,8914,5,28,237,270,1.1407407407407408,0.024233208778621805,651,"They ARE unusual symptoms, but I do have a treatment in mind."
951,8915,2,33,228,263,1.1406844106463878,0.022791909030671617,651,"Mr. Johnson, it appears you have an acute case of Snake Body."
4453,8915,5,27,231,263,1.1406844106463878,0.024628159961988222,651,I see you are wearing mink with a boa?
5856,8917,5,26,225,256,1.140625,0.025042090792793438,651,"You really need to lose some weight, Mr. Smithers"
5080,8918,3,27,205,235,1.1404255319148937,0.024998984320814915,651,You've exfoliated your inner skin and returned to Paradise.
4071,8919,1,29,191,221,1.1402714932126696,0.024275424831055877,651,"Well, I won't contradict ancient but new methods of weight loss."
2496,8920,4,28,225,257,1.140077821011673,0.024333653212741228,651,"After the first test, I thought your intestines were constricting..."
7808,8921,3,28,212,243,1.139917695473251,0.024480730488563984,651,"Thankfully, it's winter, so we can rule out heat-stroke."
2312,8921,3,28,212,243,1.139917695473251,0.024480730488563984,651,This is your weighted snake-et. It's like an all the time hug.
167,8923,5,23,208,236,1.1398305084745763,0.026308385422389162,651,"Mr Mowgli, your results are pretty disturbing. Since when do you have appearances of huge black cats crossing your way?"
3030,8923,5,23,208,236,1.1398305084745763,0.026308385422389162,651,"I'm sorry, we don't see Slitherin patients here."
3116,8923,6,21,209,236,1.1398305084745763,0.02698505457135261,651,I'm sorry I don't have experience with Python. Why not just check on StackOverflow...
6657,8923,3,27,206,236,1.1398305084745763,0.02489994156943303,651,It appears your diet is not working for you.
8948,8923,5,23,208,236,1.1398305084745763,0.026308385422389162,651,"Don't worry, we'll get you out of this tangle."
258,8928,3,25,194,222,1.1396396396396395,0.025805348432610023,651,"Your condition has nothing do with your charming personality. 
Frank Buckley Andover, MA"
1942,8928,6,19,197,222,1.1396396396396395,0.028075082327033474,651,"Nice coat, sir..."
7659,8928,3,25,194,222,1.1396396396396395,0.025805348432610023,651,"In order for this new treatment to work, I need your utmost coooeration Mr Snerd."
8585,8931,7,22,229,258,1.1395348837209303,0.02604459404069694,651,"Doc, I’m not sure what’s wrong but I feel like I’m being strangled."
1282,8931,5,26,227,258,1.1395348837209303,0.024859495431456456,651,I'm here for a decayed tooth...
7887,8933,4,27,220,251,1.1394422310756973,0.02464715847545014,651,I'm prescribing a weight-loss regimen.
5155,8934,1,32,211,244,1.139344262295082,0.02296214098038942,651,It looks like Obama Care doesn't cover the removal of snakes.
7702,8934,4,26,214,244,1.139344262295082,0.025068984994778068,651,"And how long  Mr. Barnes, have you been undergoing  treatment  for pickpocketing?"".."
753,8934,2,30,212,244,1.139344262295082,0.02368525452312026,651,"...but at least, you are very fashionable with an actual and living feather boa"
2845,8937,3,27,207,237,1.139240506329114,0.02480167464808973,651,"Surely, Nicki Minaj had entirely something else in mind from her biggest fan."
4057,8938,2,32,225,259,1.138996138996139,0.022884969152645172,651,"Don’t worry we launder our examination gowns"""
4874,8939,2,26,188,216,1.1388888888888888,0.02534572886825975,651,"...take orally 3x a day, along with meditation and deep breathing exercises."
1416,8939,9,12,195,216,1.1388888888888888,0.030722471040200573,651,I would like to time how long it takes you to completely devour him.
7379,8939,5,25,222,252,1.1388888888888888,0.025191007779894147,651,"And I'm not crazy about how he is eying my John Thomas."""
8098,8942,2,30,213,245,1.1387755102040817,0.023595237657163936,651,You don't know how to use the washing machine? And your wife is out of town for how much longer?
719,8942,2,30,213,245,1.1387755102040817,0.023595237657163936,651,"And don't try to fob me off with that lousy snake oil again”.
“Well aren't you a real charmer”"
3448,8944,4,23,197,224,1.1383928571428572,0.026360263608868877,651,"So as expected, the mouse-ectomy was a success but we are seeing some side effects..."
5224,8944,5,21,198,224,1.1383928571428572,0.027109074761571636,651,I guess you forgot what I told youabout what grows in the sewers of this city? Do you remember now?
7220,8944,3,25,196,224,1.1383928571428572,0.02558954983249282,651,"As you can see, I am winding up my practice."
2348,8947,2,31,220,253,1.1383399209486167,0.023146553782057298,651,Never trust a left handed doctor!
3993,8948,3,28,215,246,1.1382113821138211,0.024201470681441732,651,the extra blanket was unnecessary
4530,8948,3,28,215,246,1.1382113821138211,0.024201470681441732,651,"Ok, so it's nothing serious, just poisonous snake bites. It'll take about a week."
5882,8948,6,22,218,246,1.1382113821138211,0.026177532333529957,651,This is a very unusual cancer.
813,8951,4,28,229,261,1.1379310344827587,0.02398376094885256,651,You need more potassium ! I recommend more apples in your diet
1189,8951,3,26,203,232,1.1379310344827587,0.02503401436477078,651,"I'm not happy with your acupressure progress, so I'm going to recommend acupuncture instead, the 'thousand needle cure'."
4753,8953,5,25,224,254,1.1377952755905512,0.02500417485739019,651,"You've seen one pungi accident, you've seen them all."
8990,8954,4,23,198,225,1.1377777777777778,0.026250052490079376,651,"Joe, looks  like  the  snake  got  
under  your skin!"
5583,8955,7,20,220,247,1.1376518218623481,0.026700991101215182,651,I'm going to give you a prescription for anti-snake charming
5823,8955,3,28,216,247,1.1376518218623481,0.02410978411654646,651,So exhale hurts? Maybe you two should try yoga.
8510,8957,6,21,213,240,1.1375,0.026559615582992115,651,"Perchance Oil. Extra Strength.
For both you and Mort’, ’tis."
2692,8958,5,26,231,262,1.1374045801526718,0.02450213067887651,651,New with the Sewer Department?  The snake isn't.
8659,8959,2,30,216,248,1.1370967741935485,0.0233292123661482,651,You're the third zookeeper I've seen today with these symptoms... peculiar.
2462,8960,4,29,238,271,1.136531365313653,0.02336591747112423,651,"I don’t know what to do, I’m all tied up."
741,8961,5,23,214,242,1.1363636363636365,0.02569296116622701,651,I don't understand doc I have a real knot in my stomach for some reason.
7893,8961,4,25,213,242,1.1363636363636365,0.0250167119479082,651,Im sorry Mr and Mrs Jones but the test came back positive for cancer
7564,8963,6,26,247,279,1.136200716845878,0.024039897462696788,651,Do you think I am underdressed?
921,8964,1,33,223,257,1.1361867704280155,0.022134358468838038,651,It's the third time you've been here. Try to stop showing off how much Bertie loves you.
5270,8964,3,29,225,257,1.1361867704280155,0.023467583816760344,651,"I think your problem is due to a weak nervous system, but I may be wrong."
7399,8964,2,31,224,257,1.1361867704280155,0.022810713656346814,651,You probably  feel  oppressed  ....
8928,8967,3,26,206,235,1.1361702127659574,0.024734470290998248,651,I can’t seem to wrap around what’s going with you
6453,8967,6,20,209,235,1.1361702127659574,0.026849669792846514,651,"Now, you must swallow these capsules whole and they may cause cramping..."
3093,8967,1,30,204,235,1.1361702127659574,0.023217526188288488,651,Have you been feeling all wrapped up lately?
5433,8970,2,25,186,213,1.136150234741784,0.025364576681074766,651,"Until the antiviral kicks in, stay away from the internet."
7924,8970,4,21,188,213,1.136150234741784,0.027054455372587223,651,How is that python roundup working out for you
7790,8972,1,31,211,243,1.1358024691358024,0.022780901380678387,651,"I'm writing you a prescription to listen to the song ""You knew I was a snake before you took me in"", try to listen to it before tomorrow afternoon."
2455,8973,4,22,195,221,1.1357466063348416,0.02641612457176656,651,"The prescription is for the snake.  For you, you need to Google cosplay and 'Naked Snake'."
708,8974,4,26,221,251,1.1354581673306774,0.024411617086481662,651,"Don't worry, your pet boa will go back to its normal noodle shape once its done killing and eating this man. That'll be 300$."
3647,8974,3,28,220,251,1.1354581673306774,0.02374983239555269,651,Feeling is the same
6288,8976,4,23,202,229,1.1353711790393013,0.025818217485507555,651,"I'm afraid Adam, an apple a day won't keep me away"""
4916,8977,4,25,215,244,1.1352459016393444,0.024823768393686774,651,".it was a dare ..a mongoose costume into a pet store..Jim Finegan,Rye,NY"
3623,8978,3,26,208,237,1.1350210970464134,0.02453869791406611,651,"I know you said I need to cut humans out of my diet, but this one has a vore fetish and he just won't leave me alone."
8055,8979,4,28,235,267,1.1348314606741574,0.02347727141982138,651,We call it the Tinder Trap
4599,8980,2,27,201,230,1.1347826086956523,0.024190615076968694,651,You said you were on a tight budget. Now I get it.
5910,8981,2,24,182,208,1.1346153846153846,0.025606163591401068,651,How long have you felt this cozy?
8779,8982,5,20,198,223,1.1345291479820627,0.026952920720623944,651,I hope you like chicken.
2765,8983,4,24,210,238,1.134453781512605,0.025156841980447105,651,"I suppose someone may confuse your pet with another vital organ, but it creates a definite medical risk for both of you."
5588,8984,3,28,222,253,1.134387351778656,0.02357382918706731,651,"Yeah, but my parents wanted me to give up drawing in fifth grade."
8187,8984,6,22,225,253,1.134387351778656,0.025491845996357152,651,How long had this divorce attorney?
1792,8986,6,19,206,231,1.1341991341991342,0.027037637095062503,651,"Yeah, Adam took just one look, blamed me, and threw both of us under the bus and out of the garden!"
4976,8987,4,25,217,246,1.1341463414634145,0.024633760286891463,651,You’re just not as young as you used to be George.
7833,8987,2,29,215,246,1.1341463414634145,0.023247669458531735,651,"I am recommending you visit your local department store for a blanket scarf"""
8899,8989,2,25,190,217,1.1336405529953917,0.024927109973657123,651,What a normal day at the the doctor's office looks like
1524,8990,3,25,204,232,1.1336206896551724,0.024761045890250123,651,I’m writing you a prescription for rattler removal.
7389,8991,4,28,238,270,1.1333333333333333,0.023231915074135422,651,Do you recall being near poison ivy lately?
8005,8991,4,26,225,255,1.1333333333333333,0.02405113520453093,651,this is part of a new therapy I called the “Boa Vista” club
8979,8991,4,26,225,255,1.1333333333333333,0.02405113520453093,651,"Well, at least you can be grateful boas don't have knees or feet."
7429,8994,3,29,231,263,1.1330798479087452,0.022965564181542726,651,"My old girdle was tight, but this is ridiculous"
6289,8995,4,23,206,233,1.1330472103004292,0.025400279498886503,651,"Since internet became popular, being a dietist is an everyday adventure."
3940,8996,2,30,224,256,1.1328125,0.022648060977795023,651,Are you having a hard time getting off your chest AGAIN?
558,8997,2,28,211,241,1.1327800829875518,0.023429596927356536,651,I’m going to have to refer you to a snakelist.
7841,8998,6,21,222,249,1.1325301204819278,0.02564951885445345,651,Would you consider being part of the reptile exhibit at the zoo?
8532,8998,3,27,219,249,1.1325301204819278,0.023679843169600243,651,They’re call it the Slytherin vasectomy.
1552,8998,5,23,221,249,1.1325301204819278,0.0250102019681755,651,"He's in fine shape. You, on the other hand, could use some Viagra."
2195,8998,5,23,221,249,1.1325301204819278,0.0250102019681755,651,Looks like it is your baby...he's got the nurses wrapped around his finger
1593,9002,3,23,193,219,1.1324200913242009,0.025547425857497454,651,I know your pretty tight today. Just a few more questions.
4506,9003,2,30,225,257,1.132295719844358,0.0225656823145176,651,Cap or Decap?
2477,9004,6,20,216,242,1.1322314049586777,0.02611282870686377,651,I want a pet to match my avoidant tendencies...but I feel more suffocated than ever!
2242,9005,2,29,219,250,1.132,0.02289981673345232,651,You just have a cold-blooded creature.
4006,9006,5,21,209,235,1.1319148936170214,0.025908001762679673,651,Take these two laxatives and call me in the morning.
1639,9007,6,24,243,273,1.1318681318681318,0.024134653784866806,651,I thought it was my headphones.
1646,9008,3,23,194,220,1.1318181818181818,0.025438158159778554,651,"Apply one more fresh snake before bed and the skin oil should fix that rheumatism right up."""
7785,9009,4,26,228,258,1.1317829457364341,0.02378764294251309,651,All I wanted was a wraparound that was alive with interest!
6707,9010,5,22,216,243,1.131687242798354,0.025348641401399072,651,"No, you don't have spider veins."
8468,9011,6,21,224,251,1.1314741035856575,0.0254556420946119,651,Missing Tomi Ungerer also?
8595,9012,4,23,209,236,1.13135593220339,0.025095549860916805,651,A former patient of mine used it to his advantage and made a snake skin jacket.
3412,9013,4,26,229,259,1.1312741312741312,0.023701083007700796,651,BO-Am I glad  You came to see Me...
3987,9014,3,23,195,221,1.1312217194570136,0.025329815441556297,651,I advise you detach from the meal source and start with the feet.
1265,9015,6,21,225,252,1.130952380952381,0.025359793639608944,651,"Patient: 
I couldn’t put on the gown, Doc. My boa’s jealous - she won’t let me strip in front of anyone but her... 
And Doc - don’t examine me down there. She might attack you."
2040,9015,5,23,224,252,1.130952380952381,0.024728517543751913,651,I'm putting you on a diet. Your BMI is 37.8!
1106,9017,5,24,231,260,1.1307692307692307,0.024235824779854684,651,"Yes, Mr. Archimedes, I  am very familiar with the Squeeze Theorem Disorder.  Do you have limited breathing function?"
5126,9018,3,26,216,245,1.1306122448979592,0.023785455183257746,651,"We were a bit constricted in making our diagnoses, but we’re pretty sure it’s because of your phone"
3571,9019,1,29,208,238,1.1302521008403361,0.022659640175337087,651,"Yes, you have two weeks to live... But at least you're losing six pounds."
3677,9019,3,25,210,238,1.1302521008403361,0.024173823334379854,651,"TAKE AN ASPIRIN A DAY
THEN YOUR CRAMPS SHOULD GO AWAY"
3942,9019,3,25,210,238,1.1302521008403361,0.024173823334379854,651,It is hard ti do a full exam when you are fully wrapped like that.
9095,9022,2,29,223,254,1.1299212598425197,0.02256214584687093,651,At least it's not boots.
5094,9023,2,27,210,239,1.1297071129707112,0.023337096689331434,651,"So let me guess, your name is Rod O' Asclepius?"
5045,9024,4,24,219,247,1.1295546558704452,0.02429149797570851,651,I understand you’re terrified of lizards.
180,9024,4,24,219,247,1.1295546558704452,0.02429149797570851,651,"I get that you feel like time is of the essence, but can we take a moment to appreciate that I came in here dressed as a ghost and now my costume is sticking to the chair using god knows what strength?"
1078,9026,3,23,198,224,1.1294642857142858,0.025010222011060904,651,S'nakes Alive!
2610,9027,4,23,213,240,1.1291666666666667,0.024700377940142276,651,"Well, the zoo employees tell me it was the best parcel-tongue they've ever heard."
2660,9027,3,25,212,240,1.1291666666666667,0.02398418576685723,651,That dick big
8466,9029,4,25,227,256,1.12890625,0.023725507801415947,651,"You see, it all started when I was born..."
8614,9029,4,25,227,256,1.12890625,0.023725507801415947,651,"You mean constrictcation, right?"
1400,9031,3,21,186,210,1.1285714285714286,0.025938115983158552,651,Your anaconda don't---Your anaconda don't---Your anaconda don't want to let go before you suffocate. Sorry.
6500,9032,3,26,220,249,1.1285140562248996,0.023425807652934935,651,I advise removing the forked tongue; that should straighten things out!
106,9033,4,25,228,257,1.1284046692607004,0.023638332451795464,651,"I know it's the  latest fad, but I still think it's to constricting.""  "" I'm
prescribing a nice garden variety."
6179,9034,0,34,231,265,1.1283018867924528,0.020582475687991906,651,"That Pit of Sakes you're workin""g in is really weighing you down!"
8841,9035,4,22,208,234,1.1282051282051282,0.025028447976919048,651,You know what they say: A snake wrapped around your body is better than two in the bush.
8254,9036,5,21,216,242,1.128099173553719,0.025197319996640745,651,when you wrapped up in your own problem and expecting  from somebody to resolve!!
843,9037,4,22,209,235,1.127659574468085,0.024927686929748005,651,"You will, coiled mortal, send the office a new address once
you’ve finished throwing off that mortal coil?"
1545,9037,4,22,209,235,1.127659574468085,0.024927686929748005,651,"I'd say you're free to criticize that guy, now that you've walked a mile in his moccasin."
759,9039,4,23,216,243,1.1275720164609053,0.024412028583726826,651,"voldemort. we meet again. do you not recognize me? i am harry potter, full-grown and treating magical maladies in the wizard hospital. i will admit, i find a sick satisfaction in your prognosis. the great dark wizard, brought down by prostate cancer!"
7134,9039,3,25,215,243,1.1275720164609053,0.023705210493738704,651,„Looks like you slithered yourself into some serious trouble.“
6696,9041,2,28,221,251,1.1274900398406376,0.02255416454335206,651,"Yeeeeah, Mr. Mowgli, is it? I think we might need a psych consult…"
41,9041,5,22,224,251,1.1274900398406376,0.024582674145199854,651,Wrap up keep warm Mrs Jones and you will be fine.
6861,9043,3,27,229,259,1.1274131274131274,0.022819229408171923,651,"Mr. Shmendlap, I understand that you feel ""squeezed"" in your job at the zoo!
Jeff Manly
Toronto,On"
1061,9044,4,19,189,212,1.1273584905660377,0.026562468132426444,651,live snakes don't make good footwear. They are not particularly fond of the cold floors
6618,9045,5,18,197,220,1.1272727272727272,0.026734695670644636,651,Medical  Disclaimer: Chest Tightness
7325,9045,2,24,194,220,1.1272727272727272,0.02429425757986144,651,Pokémon GO has gotten really out of hand!
5041,9047,4,22,210,236,1.1271186440677967,0.02482772981994873,651,Next time stick to urban fashion weeks.
5215,9047,4,22,210,236,1.1271186440677967,0.02482772981994873,651,I recommend the latest weight loss treatment from BoaPharm.com.
3611,9049,4,24,224,252,1.126984126984127,0.02383585887321989,651,I'm afraid you're as deaf as an adder.
6968,9050,6,17,206,229,1.1266375545851528,0.026738026593875763,651,"Oh god, put your coat back on!"
2110,9051,2,27,216,245,1.126530612244898,0.022800556060057944,651,Weight!  Weight!  Don't Tell Me
6993,9052,1,32,236,269,1.1263940520446096,0.020970265008243016,651,"Sir, you aren't really that screwed. But I would suggest next time skipping snake pit brunch."
7561,9053,4,19,191,214,1.1261682242990654,0.026327031489938327,651,I don’t think this is what they meant when they said “4/5 men report feeling constricted when their girlfriend moves in.... maybe you should stick to cat women.”
2520,9054,1,27,202,230,1.126086956521739,0.02278479996766569,651,"Well yes, I can see you made a mistake.  One can't be too careful when kissing.  But I'm afraid I'll need to bring in more medical personnel to handle this case.  The question is, how many"
4262,9054,4,21,205,230,1.126086956521739,0.025160762116295737,651,I feel a tightening in my chest.
7857,9056,2,27,217,246,1.1260162601626016,0.022713506270441466,651,Too much ink.
8537,9057,2,28,224,254,1.125984251968504,0.022304065787966253,651,"Hi, Dave. It looks like you got stuck in Boidae again..."
4241,9058,2,25,204,231,1.1255411255411256,0.023507313261215412,651,It just really feels like this burden I’ve been carrying around for weeks is really starting to squeeze me into submission. What do you recommend I do?
1144,9059,2,28,225,255,1.1254901960784314,0.022221919489835373,651,My Ghanian college will see you shortly.
7744,9060,5,23,235,263,1.1254752851711027,0.02374756328765798,651,"Sir, if you could please put away your lunch we can start the check up.."
801,9060,3,27,233,263,1.1254752851711027,0.022492146737637296,651,Before I went into Medicine I was a snake oil salesman>
2064,9062,2,26,212,240,1.125,0.022964559439211957,651,This time you should be able to breath out
6532,9062,5,22,229,256,1.125,0.02412691118102885,651,And how do you feel this particular body transformation regimen is going?
8405,9062,4,22,214,240,1.125,0.02443575243798725,651,@%$#@$! white people...
2662,9065,6,20,231,257,1.1245136186770428,0.024661979249196928,651,Learn to code.
9065,9065,3,26,228,257,1.1245136186770428,0.02273800172471946,651,Well mr. Myers it appears that you are suffering from ring snake and the only way for it to go away is to put some of this cream on but there is a chance the snake might bite but if you dont each day the snake squeezes more each day.
1084,9067,5,19,209,233,1.1244635193133048,0.025587140376081844,651,"The good news is that you've got buns, Hun'."
3910,9068,3,24,215,242,1.1239669421487604,0.023526494981428846,651,"Doctor: ""The cultures are back. Can I get a drum roll please...""
Patient: ""I can't...""
Doctor: ""Bacillus asclepius"""
3773,9068,2,26,214,242,1.1239669421487604,0.022786039351027205,651,"Squeezing the last drop, eh?"
2427,9068,3,24,215,242,1.1239669421487604,0.023526494981428846,651,The tests show that you have too much snake oil in your body!
5757,9071,6,17,211,234,1.123931623931624,0.02619296401637007,651,My anaconda don’t want none unless you got insurance hon
1932,9072,4,24,231,259,1.1235521235521235,0.023225806551020096,651,So which supplemental policy ?
2778,9073,8,14,221,243,1.123456790123457,0.02681886227912126,651,It looks like you got buns hun.
8589,9073,5,20,218,243,1.123456790123457,0.024843932234768416,651,Thou shalt not take with alcohol.
5786,9075,4,21,210,235,1.123404255319149,0.024652993289226613,651,"I can’t change, control or cure it"
8269,9076,5,22,233,260,1.123076923076923,0.02377423839722858,651,"""The Granny Smith will be a nice touch. P.E.T.A. should love it.""

Leo Sacks, Sunnyside, N.Y."
7053,9077,5,21,226,252,1.123015873015873,0.024246863491624963,651,It’s a new hybrid we’re calling a boa constrictim.
6736,9078,4,22,218,244,1.1229508196721312,0.024055902046942967,651,Have you tried drinking celery juice?
1501,9079,1,27,208,236,1.1228813559322033,0.022242005933536205,651,Your diagnosis is locked-in syndrome.
5051,9080,5,21,227,253,1.1225296442687747,0.024155730057649753,651,"Can't you see I need help?"""
5387,9081,3,24,218,245,1.1224489795918366,0.02325421016940715,651,His constructions are what is keeping you alive!
3959,9082,4,21,212,237,1.1223628691983123,0.024455552184184222,651,"It appears, sir, that he doesn't want none. Unless..."
855,9083,5,23,242,270,1.1222222222222222,0.02316266927160122,651,I think you are suffering from ring snake
1801,9084,3,21,197,221,1.1221719457013575,0.024716141454879097,651,"Thank you for bringing in your diet, Mr. Thon. I recommend your continuing to eat three a day."
6909,9084,3,21,197,221,1.1221719457013575,0.024716141454879097,651,I never said you were a bore!
1704,9086,1,30,231,262,1.1221374045801527,0.020977404991731275,651,I'm going to prescribe you with a bottle of snake repellent.
2468,9087,5,21,228,254,1.1220472440944882,0.024065276269168562,651,Looks like you've used more toothpaste than you need. Don't worry we know how to take care of that.
6327,9088,5,20,221,246,1.1219512195121952,0.02455560338195815,651,... and suddenly I felt kaampelled.
2746,9089,5,19,214,238,1.1218487394957983,0.025075281666222422,651,"Mr. Cohen, it seems you have a rare case of you-are-a-snakeitis..."
6585,9089,2,25,211,238,1.1218487394957983,0.02285602957758202,651,I’ve heard that they respond well to buns.
7255,9089,3,23,212,238,1.1218487394957983,0.02361896079242973,651,How did you get that terrible wound?
783,9092,3,22,205,230,1.1217391304347826,0.024100016405211474,651,Your eyes are bigger thqn your stomach
5830,9092,4,20,206,230,1.1217391304347826,0.02487535067022956,651,"The diagnosis isn't good.  The test results came back that you have parasites.  Visually speaking, we clearly need to run more tests.  This would seem to be more of an exterior kind of thing."
7276,9092,4,20,206,230,1.1217391304347826,0.02487535067022956,651,Being Constricted is so in these days!
551,9095,2,28,233,263,1.1216730038022813,0.021585778593636567,651,"It's time for you to remove your clothes for a check up!
Why don't you give it a try doctor?"
8872,9096,1,25,197,223,1.1210762331838564,0.02279811403683752,651,Here is an antibiotic prescription “on a  counda” it seems to be a bacteria and not a virus
3120,9097,3,26,236,265,1.120754716981132,0.022089223749161814,651,"The urban cowboys in Manhattan are jealous, you say? But how do you bathe?"
8697,9098,6,19,232,257,1.1206225680933852,0.02442825681682429,651,Snake too.
8733,9098,5,21,231,257,1.1206225680933852,0.023797917943044884,651,"Sir, this room is well-heated. You don't have to get all wrapped up.""

(Submitted for Barbara Grubman of Woodland Hills, Californi"
5032,9100,5,22,239,266,1.1203007518796992,0.023264067842943385,651,"Yes, we can remove it ... 
 but I’m afraid you’ll have to sacrifice around fourhundred-million scales."
7698,9101,3,22,208,233,1.1201716738197425,0.023806105743217006,651,"The polar vortex has really gotten to you, huh?"
7873,9102,5,21,232,258,1.12015503875969,0.023710108447223457,651,"Yeah, you know, I was watching Scrubs reruns last night, and its really not that funny. - Zgjim Terziqi, Prishtina, Kosovo"
1884,9103,2,23,200,225,1.12,0.023468993391145915,651,"Sir, your snake will never understand the command to ""slither in"""
2132,9104,3,20,194,217,1.119815668202765,0.02482434992632339,651,I’m just going to take your word  for it and give you some medicine for your achy breaky penis
1638,9105,6,18,227,251,1.1195219123505975,0.024742286859455228,651,Do you ever feel that you have a tight band around your head?
6775,9106,2,23,201,226,1.1194690265486726,0.023370949991477593,651,"1.""How are you feeling Mr. Smith?""____2.""We are going to have to up your meds Mr. Smith as your blood pressure is still dangerously high""____3.""How long have you been irregular?"""
1973,9107,2,25,216,243,1.1193415637860082,0.02241236932398078,651,"My wife's a chicken. Good news is we have plenty of eggs, sorry that was cold blooded.."
1872,9108,5,18,212,235,1.1191489361702127,0.02510709188035086,651,"I'm referring you to a specialist, a roommate in med school, who has herpetophobia."
8546,9108,5,18,212,235,1.1191489361702127,0.02510709188035086,651,For you to think that a constrictor of this type is venomous is so dumb. I'm surprised you've actually lived to whatever age you are. I should just let it crush the life out of you.
2322,9110,1,25,202,228,1.118421052631579,0.022328093833286742,651,"Based on the test ""My Anaconda wants""...you got buns hun!"
1481,9111,5,19,221,245,1.1183673469387756,0.024392020719635858,651,"I'm sorry to disappoint you, but hugging is not her thing."
425,9112,3,20,197,220,1.1181818181818182,0.024503061341287734,651,This here medicine is as Western as it gets.
6796,9113,5,18,214,237,1.1181434599156117,0.024904876285662816,651,We had so many complaints about the johnny coats we're trying these instead.
1657,9114,4,22,228,254,1.1181102362204725,0.023155793998516867,651,Did you take the nitroglycerin SL as I ordered?
4424,9115,2,23,204,229,1.1179039301310043,0.02308164782296812,651,I think its more usual for a snakeskin suit to not come with a live snake!
2294,9116,3,23,220,246,1.1178861788617886,0.02289098134482126,651,Thank you for your assistance with our internal audit on wait times.
2906,9116,1,27,218,246,1.1178861788617886,0.021392265338436536,651,"For this *particular* apple, I really do need to intervene."
8462,9118,2,24,212,238,1.1176470588235294,0.022559153471001014,651,You seem to have an acute fruit allergy
6062,9118,2,22,197,221,1.1176470588235294,0.023539693352159514,651,"Your test result has come back positive for buns, hun."
1037,9118,3,24,228,255,1.1176470588235294,0.02239020808004583,651,Savory oatmeal should do it.
1686,9118,3,24,228,255,1.1176470588235294,0.02239020808004583,651,you can’t lose weight that way. You must behind your stomach from the inside.
2891,9118,4,22,229,255,1.1176470588235294,0.02306945840277324,651,"Sir, the ball pit at the McDonald's is for children only."
5004,9123,4,25,252,281,1.1174377224199288,0.02172193219030252,651,My husband was a snake oil salesman
2627,9124,3,23,222,248,1.1169354838709677,0.022715911852603493,651,You’ve been diagnosed with a mild condition of snakeitis .
8179,9125,3,21,208,232,1.1163793103448276,0.023603620258865084,651,Constriction by boa? I would not constrict that possibility.
1183,9126,3,22,216,241,1.116182572614108,0.023056131505075593,651,It is just a dry throat. I will recommend some cold medicine.
8681,9127,2,20,185,207,1.1159420289855073,0.02431819271814364,651,Something for Anxiety and Benjamin Brafman.
6105,9128,2,26,231,259,1.1158301158301158,0.021373162511429452,651,"Good news. I have an answer to that tightness your feeling, bad news, please, no more inhaling."
8683,9129,6,14,205,225,1.1155555555555556,0.02635064061883368,651,"Boots would have been a safer path.""


Sloan Salah, Glenview, I"
1910,9130,4,20,219,243,1.1152263374485596,0.023607590818231952,651,"Unfortunately, you will have to use other persuasive means. This is not covered by the pet liability clause."
3658,9130,2,24,217,243,1.1152263374485596,0.022120083051394665,651,We can get you into sia specialist and 3 weeks.
5517,9130,1,26,216,243,1.1152263374485596,0.02133747733871934,651,"Sadly, you're carcinogenic."
4316,9133,4,20,220,244,1.1147540983606556,0.023515381579887175,651,"Mr. Hiss, You have a bad case of himarroids."
5299,9133,5,18,221,244,1.1147540983606556,0.024221984523762844,651,We're cutting edge. My assistant specializes in chills and fever..
5625,9135,3,21,212,236,1.1144067796610169,0.023223392209394594,651,"I'm not sure they take medical testimony in divorce court, but see if they accept this prescription"
8169,9136,4,21,229,254,1.1141732283464567,0.02289637813044272,651,"Please, no snakes."
9076,9137,4,18,206,228,1.1140350877192982,0.024487595150190417,651,"You might start feeling better if you stopped playing with your hose."""
4274,9138,2,23,212,237,1.1139240506329113,0.022343902824638252,651,I am constricted from examining you!
8454,9138,3,21,213,237,1.1139240506329113,0.02313023344504923,651,I can see you’re extremely tense. I’m writing a lifetime prescription of Fentenyl which will cure you within a month
5171,9140,5,20,239,264,1.1136363636363635,0.022956557449706087,651,"I've asked you to take buch time off, I need you to take boa off"
2161,9140,3,19,198,220,1.1136363636363635,0.024175525169232562,651,"This is a new prescription for worm tablets, don’t confuse them with the steroids."
8259,9142,3,20,206,229,1.1135371179039302,0.02358702755683434,651,"This is not the place where bags are made with human skin. Next door, please."
3518,9143,6,17,233,256,1.11328125,0.024036215192458778,651,Good news! The test results indicate that the angina you
6171,9144,2,26,237,265,1.1132075471698113,0.02091522734902837,651,"Have you been feeding him a daily dose of buns, hun?"
6785,9144,1,22,189,212,1.1132075471698113,0.022814475397586843,651,"Your lack of charm is a preëxisting condition, so we can't treat you; however, there are several Dale Carnegie courses online as well as self-indulgent, 12-step-recovery group programs, complete with anonymity and experienced sponsors."
6302,9146,1,29,244,274,1.1131386861313868,0.019856407045342837,651,No; antibiotics and ineffective on viruses and vipers.
6248,9147,4,17,200,221,1.1131221719457014,0.024911173212638114,651,"Yeah I don't know, you're all fucked up."
8198,9148,2,22,206,230,1.1130434782608696,0.022666747920078906,651,"I'm sorry, this is gerbil abuse, arguments are in room12A."
4179,9149,3,22,223,248,1.1129032258064515,0.022437464674882994,651,It says here you have an unhealthy obsession with Taylor Swift?
2346,9149,3,22,223,248,1.1129032258064515,0.022437464674882994,651,I'd like to do a few more tests on your lizard brain.
6242,9151,5,20,241,266,1.112781954887218,0.02279160475208473,651,Sorry we donTPCookiePolicyPropertySiteForCookies
1504,9152,1,25,214,240,1.1125,0.021274956630681473,651,No tip? What’s the matter you’re trippin’ Can’t you see you alcoholic idiots the more they try to suppress us
7176,9153,4,17,203,224,1.1116071428571428,0.024592214509989826,651,"Yes, I do think it's medically necessary for me to tickle you right now."
8943,9154,1,25,216,242,1.1115702479338843,0.021108963555932773,651,Did he hit you one more time?
2139,9155,3,22,227,252,1.1111111111111112,0.02209856189623277,651,"The test results are in. You've got buns, hun."
4750,9155,5,17,221,243,1.1111111111111112,0.02404521356411734,651,"Jim, it's a shame the snake didn't do a better job. These scenarios are getting played out."
3652,9155,4,18,212,234,1.1111111111111112,0.023887564445469918,651,"Basically you were sneaking around and he was snaking around. Peter Giessner, Peapack NJ"
1227,9158,3,22,229,254,1.110236220472441,0.02193290554176306,651,Alright then sir what seems to wrap you around in life.
8160,9159,2,23,220,245,1.110204081632653,0.021651645210309566,651,Looks like you've got a chronic case of  snake-itis.
2277,9159,3,21,221,245,1.110204081632653,0.02241092915668786,651,"I'm sorry sir, but it looks like you're permanently half man half snake now"""
5191,9159,5,17,223,245,1.110204081632653,0.02385711123275414,651,"Kid don't move, your life depend on this"
3530,9162,3,20,215,238,1.1092436974789917,0.022736761444545613,651,"...last Doctor put the squeeze on. I didn't know Witch Doctors where licensed in this state"""
6649,9163,3,22,232,257,1.1089494163424125,0.021689007919750293,651,Good morning Mr. & Mrs. Chasse !  I see you are finally getting a hang on your marriage .
5179,9164,6,14,221,241,1.107883817427386,0.02466757575619362,651,You say: You're proud to me an American?
1124,9165,1,23,208,232,1.1077586206896552,0.02129644301051138,651,I see you've been snaking around things.
142,9166,3,20,219,242,1.1074380165289257,0.02237816043773029,651,At least it didn't fall off.
1058,9167,4,20,237,261,1.10727969348659,0.02205082432160391,651,"Could you run some
tests to see if I am snakebit?"
1830,9168,5,16,222,243,1.1069958847736625,0.023767123343462173,651,"I'm writing you a prescription for antibiotics. Take one every day for a week, and you'll be fine."
6748,9168,3,20,220,243,1.1069958847736625,0.022290264286967808,651,"So,Mr. Hun,tell me again about this connection he has with your buns."
8188,9170,6,14,224,244,1.1065573770491803,0.02437559583017101,651,"Patient - What's the problem,Doc?
Doc - Seems like your pet has got snaxiety,hence him wrapping himself around you for comfort."
6285,9171,3,19,213,235,1.1063829787234043,0.022701853858461147,651,Check out my new kicks.
993,9172,0,24,202,226,1.1061946902654867,0.02053910936345629,651,"Sometimes he a squeezes too hard and the patient dies.  In that case, where do I send your body?"
418,9173,2,22,221,245,1.1061224489795918,0.021346766697083554,651,adadf
4432,9173,0,26,219,245,1.1061224489795918,0.019717313146415102,651,I can recommend an ‘Instant Weight Loss Plan ...’
6182,9175,2,22,222,246,1.1056910569105691,0.021264190460108353,651,And when did you first realize you were going to die and go to Phoenix?
5668,9176,6,13,218,237,1.1054852320675106,0.02478646169527022,651,"Unfortunately, you've got buns, hon."
6641,9177,1,24,222,247,1.105263157894737,0.020390495900685774,651,"Alright, I think a band-aid will fix this in no time!"
3559,9178,2,23,232,257,1.105058365758755,0.02068979480073268,651,"No, I told you to wrap your snake."
8009,9179,3,22,242,267,1.104868913857678,0.02091365482601644,651,This is not the most efficient body-cooling system I could recommend.
95,9180,3,20,225,248,1.1048387096774193,0.02186090580238542,651,"I'm prescribing an emetic, but I fear we're too late for that."
613,9181,2,23,234,259,1.1042471042471043,0.020537700344836905,651,A lot of people don't like our Johnnies
7477,9182,3,17,201,221,1.1040723981900453,0.02339295303679626,651,Seems you have a case of the tight spots.
3310,9183,6,12,213,231,1.103896103896104,0.025112767880222563,651,Your results have all come back fine. Youcontest?utm_campaign=aud-dev&utm_source=nl&utm_brand=tny&utm_mailing=TNY_Humor_020419&utm_medium=email&bxid=5bea12de3f92a4046968b978&user_id=33567745&utm_term=TNY_Humor#this
1603,9184,2,23,235,260,1.103846153846154,0.02046248526764742,651,Keep doing what you
3610,9185,3,22,245,270,1.1037037037037036,0.020691706558727638,651,"Well it looks like the whole ""boa-tie"" experiment was a failure"
1492,9185,2,24,244,270,1.1037037037037036,0.020015241437506673,651,"He's evidently off his food.  Get a rabbit. It will wet his appetite for you, too."
4710,9187,5,15,222,242,1.103305785123967,0.023576133752409717,651,"After he gave her the fruit, he took a bite of HER fruit... now, he thinks he's she..."
3885,9188,3,19,221,243,1.102880658436214,0.021986809210497744,651,I'm going to recommend another doctor to help you explore your need for affirmation an security
6846,9188,3,19,221,243,1.102880658436214,0.021986809210497744,651,Raise above it...
2165,9190,4,17,223,244,1.1024590163934427,0.022657591828915323,651,Times are tough. This the best I could do for a jacket.
4128,9191,2,22,230,254,1.1023622047244095,0.020625803638858218,651,"Feather, not father"
729,9192,3,17,205,225,1.1022222222222222,0.02299451663798268,651,"Well didn’t he warn you what his anaconda would do if you DID have buns, hun?"
7125,9193,1,25,239,265,1.1018867924528302,0.01937010385720041,651,Don't try to tell me that FOMO doesn't exist.
1392,9194,4,16,217,237,1.1012658227848102,0.022992844334754257,651,My name I should Monty.
1517,9195,0,25,222,247,1.1012145748987854,0.01923011957554107,651,Is your chest pain a  tightness  like that or should I light the torch?
1963,9196,3,21,244,268,1.1007462686567164,0.02057092578562628,651,"So to conclude your appointment, you need to stop playing with your “small snakes”"
1436,9197,2,24,252,278,1.1007194244604317,0.019466115260649237,651,"""Take two aspirin and go to bed.........with him"""
1745,9198,1,25,244,270,1.1,0.019029170271378838,651,Now you won't have to go to the airport to get your TSO hugs.
2111,9198,3,17,210,230,1.1,0.02251510473311118,651,Did you try playing the Pungi?
2126,9198,1,22,217,240,1.1,0.020283898568659194,651,"Snake Therapy, Better then wearing a stupid gown"
7158,9201,2,21,228,251,1.099601593625498,0.020554062484369248,651,I'm writing you a referral - we like to think this specialist is the guru of Kundalini sleep disorder
1822,9202,1,22,218,241,1.099585062240664,0.020203819029033947,651,Does this fetish have anything to do with a tail?
5164,9203,3,19,230,252,1.0992063492063493,0.02123422529494724,651,That vaccum hose you brought in last time must be jealous!
2745,9204,2,20,220,242,1.0991735537190082,0.020959067555276975,651,But this boa shawl keeps me warm doc!
496,9205,2,17,198,217,1.096774193548387,0.022136166227565052,651,"Well, your highness, you must have known it would digest that elephant eventually."
8103,9206,2,19,217,238,1.096638655462185,0.020958704466609024,651,You’ll have to submit an invoice.
443,9207,4,14,211,229,1.0960698689956332,0.023110617583755367,651,"Your complaining has finally stopped.
Other than tightness in your chest, what do you feel?
This is our new method of testing your blood pressure.
Is this a 'Therapy Snake'?"
6849,9207,1,20,208,229,1.0960698689956332,0.020473996528860387,651,"AT THE END OF A FILM PRODUCTION, WE WOULD CALL WHAT YOUY HAVE IS:   ""A WRAP"
182,9209,3,18,229,250,1.096,0.021093024028114197,651,190211_a22536_650.jpg?
4826,9210,1,21,218,240,1.0958333333333334,0.01993531788351242,651,"By the way, how do you train the python to control the strength of its coil...I just need to shed 3 kg..."
7803,9211,2,19,221,242,1.0950413223140496,0.020626836142252664,651,I just wanted to be fashionable...
7588,9212,2,19,222,243,1.0946502057613168,0.020545499764677858,651,"So this all started when you noticed you had buns, hun?"
3496,9213,1,22,232,255,1.0941176470588236,0.01914538788499914,651,Your pulse - who knows?  Your blood pressure is up a wee bit though.  Your anxiety about finding the perfect snakeskin shoes can't be helping.
5667,9214,1,20,213,234,1.0940170940170941,0.020056239447072265,651,"But aside from all this, how's that well you built out there?"
8573,9215,2,16,197,215,1.0930232558139534,0.02193603496900226,651,It every exercise trend should be followed blindly
5763,9216,2,17,207,226,1.092920353982301,0.021290089174945293,651,"If you're worried about autism,our office provides an alternative removal schedule."
8143,9216,3,15,208,226,1.092920353982301,0.02219457735218488,651,"No, my dear woman, it's not your mink"
806,9218,1,22,238,261,1.0919540229885059,0.0187248617016334,651,Another classic case of snorso.
2206,9219,2,18,222,242,1.0909090909090908,0.020285672817425503,651,"I understand that you feel a lil bit cramped lately?  That's a typical millennial problem. Just take a rofecoxib, it helps with everything."
3914,9220,0,23,232,255,1.0901960784313725,0.017974253882314085,651,The good news is that we'll have great omelettes tomorrow!
2033,9221,1,19,213,233,1.090128755364807,0.01976033708183126,651,"How many times a week do you eat sashimi?


Melissa Law/ Baltimore MD"
4322,9222,2,17,215,234,1.0897435897435896,0.02059039474986122,651,"Lemon curd, Schenectady, or shared refulgence."
2382,9222,2,17,215,234,1.0897435897435896,0.02059039474986122,651,"This leather clothing shouldn't be on the hoof.  Er, whatever."
8721,9224,2,19,236,257,1.0894941634241244,0.019470446401992313,651,"Three or four Andrew Wheeler tweets usually gets them pacing for their lives"""
3265,9225,2,19,237,258,1.0891472868217054,0.019397934428428108,651,How do you like my shoes?
5029,9226,2,18,227,247,1.0890688259109311,0.019890952936495784,651,I've been feeling really constricted by life recently.
7649,9227,2,18,229,249,1.0883534136546185,0.019737321877917678,651,I still believe in individuality.
5371,9228,0,21,219,240,1.0875,0.018277698645683682,651,Who have a blabber adder.
7675,9229,3,15,225,243,1.0864197530864197,0.02069482481996158,651,jkjk
9159,9229,2,17,224,243,1.0864197530864197,0.019856123471328983,651,"Thanks man I love the coat, no trade backs."
6728,9231,1,16,192,209,1.0861244019138756,0.020601107058014774,651,a prescription fo
812,9232,2,17,225,244,1.0860655737704918,0.019777750042115242,651,"We're getting meta here, aren't we. At least you don't have wings."
4265,9233,1,20,244,265,1.0830188679245283,0.017802994439178904,651,I don
7876,9234,1,19,235,255,1.0823529411764705,0.018121861282504936,651,"Even at my WORK, Helen?"
4037,9235,2,15,216,233,1.0815450643776825,0.019920407231198155,651,Oh! I am wearing sneakers usually on foot.
3523,9236,2,15,217,234,1.0811965811965811,0.019838155620498413,651,"At first I thought he loved, but now I'm starting to doubt that."
113,9237,2,16,229,247,1.0809716599190284,0.019191967979601394,651,T
8034,9238,1,18,232,251,1.0796812749003983,0.018033335445300787,651,"What about diamonds and gold, is that what you keep in your mouf?"
3576,9239,1,17,227,245,1.0775510204081633,0.018073180581845857,651,"I could say there’s a snake in your boot, but there’s a snake on your neck"
2804,9239,2,15,228,245,1.0775510204081633,0.01897619197038676,651,"I diagnose you with buns
 -Dr. Mix-a-Lot"
4154,9241,2,12,202,216,1.0740740740740742,0.020128150383799365,651,"Well, this is a curly medical problem!"
9082,9242,3,13,241,257,1.0739299610894941,0.018937667640011455,651,"So, you say this is because your date didn't have buns, huh?"
6508,9243,1,16,231,248,1.0725806451612903,0.01746914124110263,651,"Hey Doc, I’m having trouble with my constricting."
2921,9244,2,13,220,235,1.0723404255319149,0.01896111235890032,651,You're lucky!  Exoes are always earlier than enodoes.
4705,9244,1,15,219,235,1.0723404255319149,0.017976471643529935,651,"Well I told you George, you're not going out every nigh of the week."
1126,9246,2,15,246,263,1.0722433460076046,0.017716315252016626,651,I prescribe you two snake hatchlings to grow up on your feet.
3521,9247,1,16,235,252,1.0714285714285714,0.017200833685525337,651,"What ever may be the prescription, take it. No option
Condition is applied*"
7315,9248,2,12,220,234,1.0683760683760684,0.018621460546655023,651,DONOT WORRY DOC IT WILL NOT BITE AS OR TEMPERATURE TAKE IN MY MOUTH
9142,9249,2,10,235,247,1.05668016194332,0.016827901381796417,651,It is interest in
5201,9250,2,7,210,219,1.0502283105022832,0.017395858875165333,651,"People call me sneaky, but I can’t seem to understand why.”"
